"BBKK_ID","SubDist","Dist","SubC","Place","Unit","Housing","MVoter","FMVoter","Voter"
1,"พระบรมมหาราชวัง","เขตพระนคร",100101,"หอประชุม มหาวิทยาลัยศิลปากร ถนนมหาราช",1,179,269,336,605
2,"พระบรมมหาราชวัง","เขตพระนคร",100101,"โรงเรียนวัดมหาธาตุ ถนนพระจันทร์",2,199,356,298,654
3,"พระบรมมหาราชวัง","เขตพระนคร",100101,"อาคารวาสนะประทานวิทยาสิทธิ์ 1 โรงเรียนวัดราชบพิธ ถนนสนามไชย",3,62,277,60,337
4,"พระบรมมหาราชวัง","เขตพระนคร",100101,"โรงเรียนวัดพระเชตุพน ถนนมหาราช",4,240,388,438,826
5,"วังบูรพาภิรมย์","เขตพระนคร",100102,"ตึกสามัคยาจารย์ โรงเรียนสวนกุหลาบวิทยาลัย ถนนตรีเพชร",1,141,211,262,473
6,"วังบูรพาภิรมย์","เขตพระนคร",100102,"ตึกสามัคยาจารย์ โรงเรียนสวนกุหลาบวิทยาลัย ถนนตรีเพชร",2,195,249,344,593
7,"วังบูรพาภิรมย์","เขตพระนคร",100102,"ตึกสามัคยาจารย์ โรงเรียนสวนกุหลาบวิทยาลัย ถนนตรีเพชร",3,183,283,322,605
8,"วังบูรพาภิรมย์","เขตพระนคร",100102,"ตึกสามัคยาจารย์ โรงเรียนสวนกุหลาบวิทยาลัย ถนนตรีเพชร",4,151,259,291,550
9,"วังบูรพาภิรมย์","เขตพระนคร",100102,"ตึกจุฑาธุช 100 ปี วิทยาลัยเพาะช่างฯ ถนนตรีเพชร",5,154,240,235,475
10,"วังบูรพาภิรมย์","เขตพระนคร",100102,"โรงเรียนวัดราชบูรณะ ถนนตรีเพชร",6,223,242,246,488
11,"วังบูรพาภิรมย์","เขตพระนคร",100102,"โรงเรียนวัดราชบูรณะ ถนนตรีเพชร",7,147,210,246,456
12,"วังบูรพาภิรมย์","เขตพระนคร",100102,"เต็นท์บริเวณหน้าห้างดิโอลด์สยามพลาซ่า ถนนบูรพา",8,152,220,250,470
13,"วังบูรพาภิรมย์","เขตพระนคร",100102,"เต็นท์บริเวณศาลเจ้าแม่ทับทิม ถนนจักรเพชร",9,165,230,258,488
14,"วังบูรพาภิรมย์","เขตพระนคร",100102,"เต็นท์บริเวณริมคลองคูเมืองเดิม ถนนอัษฎางค์ (เยื้องวัดราชบพิธ)",10,162,269,262,531
15,"วังบูรพาภิรมย์","เขตพระนคร",100102,"เต็นท์บริเวณริมคลองคูเมืองเดิม ถนนอัษฎางค์ตรงข้าม บ.นัฐพงษ์เซลล์แอนด์เซอร์วิส จำกัด",11,138,219,239,458
16,"วังบูรพาภิรมย์","เขตพระนคร",100102,"เต็นท์บริเวณริมคลองคูเมืองเดิม ถนนอัษฎางค์ ตรงข้าม บ.นัฐพงษ์เซลล์แอนด์เซอร์วิส จำกัด",12,170,240,285,525
17,"วังบูรพาภิรมย์","เขตพระนคร",100102,"เต็นท์บริเวณหน้าห้างดิโอลด์สยามพลาซ่า ถนนบูรพา",13,157,229,255,484
18,"วังบูรพาภิรมย์","เขตพระนคร",100102,"เต็นท์หัวมุมสวนหย่อมเกาะกลางถนนอุณากรรณ ตรงข้ามสวนรมณีนาถ",14,270,288,330,618
19,"วัดราชบพิธ","เขตพระนคร",100103,"โรงเรียนราชบพิธ ถนนราชบพิธ",1,139,185,289,474
20,"วัดราชบพิธ","เขตพระนคร",100103,"โรงเรียนราชบพิธ ถนนราชบพิธ",2,174,247,351,598
21,"วัดราชบพิธ","เขตพระนคร",100103,"โรงเรียนราชบพิธ ถนนราชบพิธ",3,157,187,289,476
22,"วัดราชบพิธ","เขตพระนคร",100103,"โรงเรียนราชบพิธ ถนนราชบพิธ",4,162,255,316,571
23,"วัดราชบพิธ","เขตพระนคร",100103,"โรงเรียนวัดสุทัศน์ ถนนอุณากรรณ",5,116,178,182,360
24,"สำราญราษฎร์","เขตพระนคร",100104,"เต็นท์บริเวณหน้าศาลาการเปรียญ วัดเทพธิดาราม",1,208,366,457,823
25,"สำราญราษฎร์","เขตพระนคร",100104,"โรงเรียนเบญจมราชาลัย ในพระบรมราชูปถัมภ์ถนนศิริพงษ์",2,164,294,245,539
26,"สำราญราษฎร์","เขตพระนคร",100104,"โรงเรียนเบญจมราชาลัย ในพระบรมราชูปถัมภ์ถนนศิริพงษ์",3,146,222,237,459
27,"สำราญราษฎร์","เขตพระนคร",100104,"เต็นท์ภายในสวนรมณีนาถ ถนนมหาไชย",4,144,214,248,462
28,"ศาลเจ้าพ่อเสือ","เขตพระนคร",100105,"วิทยาลัยเทคโนโลยีพระนครพณิชยการ ถนนบุญศิริ",1,224,321,418,739
29,"ศาลเจ้าพ่อเสือ","เขตพระนคร",100105,"เต็นท์บริเวณบ้านตะละภัฏ ถนนแพร่งนรา",2,172,244,353,597
30,"ศาลเจ้าพ่อเสือ","เขตพระนคร",100105,"เต็นท์บริเวณบ้านตะละภัฏ ถนนแพร่งนรา",3,160,248,325,573
31,"ศาลเจ้าพ่อเสือ","เขตพระนคร",100105,"เต็นท์บริเวณสวนหย่อมหลังสถานีกาชาดที่ 2 ถนนแพร่งภูธร",4,145,186,261,447
32,"เสาชิงช้า","เขตพระนคร",100106,"โรงเรียนวัดมหรรณพาราม ถนนตะนาว",1,210,328,457,785
33,"เสาชิงช้า","เขตพระนคร",100106,"เต็นท์บริเวณลานคนเมือง หน้าศาลาว่าการกรุงเทพมหานคร",2,147,235,282,517
34,"เสาชิงช้า","เขตพระนคร",100106,"เต็นท์บริเวณลานคนเมือง หน้าศาลาว่าการกรุงเทพมหานคร",3,112,155,172,327
35,"บวรนิเวศ","เขตพระนคร",100107,"อาคารวชิรญาณวงศ์ โรงเรียนวัดบวรนิเวศ ถนนพระสุเมรุ",1,226,327,401,728
36,"บวรนิเวศ","เขตพระนคร",100107,"อาคารวชิรญาณวงศ์ โรงเรียนวัดบวรนิเวศ ถนนพระสุเมรุ",2,212,323,414,737
37,"บวรนิเวศ","เขตพระนคร",100107,"อาคารที่ทำการกลุ่มงานตกแต่ง สำนักงานออกแบบ สำนักการโยธา เชิงสะพานเฉลิมวันชาติ ถนนประชาธิปไตย",3,108,187,214,401
38,"บวรนิเวศ","เขตพระนคร",100107,"โรงเรียนวัดราชนัดดา ถนนราชดำเนินกลาง",4,126,198,267,465
39,"บวรนิเวศ","เขตพระนคร",100107,"เต็นท์บริเวณหน้าบริษัท ธนบุรีประกอบรถยนต์ จำกัด ถนนราชดำเนินกลาง",5,95,176,232,408
40,"บวรนิเวศ","เขตพระนคร",100107,"เต็นท์ข้างอนุสรณ์สถาน 14 ตุลา 16 ถนนราชดำเนินกลาง",6,98,154,168,322
41,"ตลาดยอด","เขตพระนคร",100108,"เต็นท์บริเวณทางเข้าถนนข้าวสาร ถนนจักรพงษ์",1,249,337,349,686
42,"ตลาดยอด","เขตพระนคร",100108,"เต็นท์บริเวณเกาะกลาง ถนนสิบสามห้าง",2,168,224,252,476
43,"ตลาดยอด","เขตพระนคร",100108,"เต็นท์บริเวณเกาะกลาง ถนนสิบสามห้าง",3,183,233,302,535
44,"ชนะสงคราม","เขตพระนคร",100109,"โรงเรียนวัดชนะสงคราม ถนนจักรพงษ์",1,105,152,181,333
45,"ชนะสงคราม","เขตพระนคร",100109,"อาคารกรมโรงงานอุตสาหกรรม ถนนพระสุเมรุ",2,85,181,179,360
46,"ชนะสงคราม","เขตพระนคร",100109,"เต็นท์บริเวณหน้าสวนสันติชัยปราการ ถนนพระอาทิตย์",3,223,341,416,757
47,"บ้านพานถม","เขตพระนคร",100110,"ศาลาเอนกประสงค์วัดเอี่ยมวรนุช ถนนสามเสน",1,156,213,253,466
48,"บ้านพานถม","เขตพระนคร",100110,"โรงเรียนวัดใหม่อมตรส ถนนสามเสน",2,104,235,236,471
49,"บ้านพานถม","เขตพระนคร",100110,"โรงเรียนวัดใหม่อมตรส ถนนสามเสน",3,140,259,266,525
50,"บ้านพานถม","เขตพระนคร",100110,"โรงอาหารโรงเรียนวัดตรีทศเทพ ถนนประชาธิปไตย",4,217,295,410,705
51,"บ้านพานถม","เขตพระนคร",100110,"เต็นท์ภายในโรงเรียนวัดตรีทศเทพ ถนนประชาธิปไตย",5,192,268,373,641
52,"บ้านพานถม","เขตพระนคร",100110,"เต็นท์ภายในโรงเรียนวัดตรีทศเทพ ถนนประชาธิปไตย",6,144,210,302,512
53,"บ้านพานถม","เขตพระนคร",100110,"ห้องสมุดโรงเรียนวัดตรีทศเทพ ถนนประชาธิปไตย",7,153,236,342,578
54,"บ้านพานถม","เขตพระนคร",100110,"เต็นท์บริเวณหน้าศาลาการเปรียญ วัดปรินายก ถนนปรินายก",8,219,380,467,847
55,"บางขุนพรหม","เขตพระนคร",100111,"โรงเรียนวัดมกุฏกษัตริยาราม ถนนกรุงเกษม",1,153,290,223,513
56,"บางขุนพรหม","เขตพระนคร",100111,"เต็นท์ภายในสถานบำบัดโรคผิวหนัง วัดมกุฏกษัตริยาราม ถนนประชาธิปไตย",2,189,252,235,487
57,"บางขุนพรหม","เขตพระนคร",100111,"ศูนย์เยาวชนเทเวศร์ ถนนกรุงเกษม",3,208,214,312,526
58,"บางขุนพรหม","เขตพระนคร",100111,"โรงเรียนสตรีวรนาถ ถนนกรุงเกษม",4,297,382,454,836
59,"บางขุนพรหม","เขตพระนคร",100111,"โรงเรียนวัดอินทรวิหาร ถนนวิสุทธิ์กษัตริย์",5,204,412,471,883
60,"วัดสามพระยา","เขตพระนคร",100112,"โรงเรียนวัดสังเวช ถนนลำพู",1,140,192,263,455
61,"วัดสามพระยา","เขตพระนคร",100112,"โรงเรียนวัดสังเวช ถนนลำพู",2,114,191,241,432
62,"วัดสามพระยา","เขตพระนคร",100112,"ตึกพักสงฆ์วัดสามพระยา ถนนสามเสน",3,250,393,458,851
63,"วัดสามพระยา","เขตพระนคร",100112,"ศาลาศาสตราจารย์ นพ. ชุบ โชติกเสถียรวัดนรนาถสุนทริการาม ถนนกรุงเกษม",4,119,191,230,421
64,"ดุสิต","เขตดุสิต",100201,"โรงเรียนทีปังกรวิทยาพัฒน์ (วัดโบสถ์) ถนนสามเสน",1,92,211,178,389
65,"ดุสิต","เขตดุสิต",100201,"โรงเรียนพันธะวัฒนา ถนนสุโขทัย",2,193,211,302,513
66,"ดุสิต","เขตดุสิต",100201,"โรงเรียนพันธะวัฒนา ถนนสุโขทัย",3,152,233,242,475
67,"ดุสิต","เขตดุสิต",100201,"โรงเรียนพันธะวัฒนา ถนนสุโขทัย",4,105,220,268,488
68,"ดุสิต","เขตดุสิต",100201,"เต็นท์บริเวณที่ว่างหน้าอาคารโรงเรียนพันธะวัฒนา ถนนสุโขทัย",5,147,274,237,511
69,"ดุสิต","เขตดุสิต",100201,"เต็นท์ลานกีฬาศูนย์สร้างสุขทุกวัยสวนอ้อย ถนนสุโขทัย",6,128,208,234,442
70,"ดุสิต","เขตดุสิต",100201,"เต็นท์ลานกีฬาศูนย์สร้างสุขทุกวัยสวนอ้อย ถนนสุโขทัย",7,154,211,268,479
71,"ดุสิต","เขตดุสิต",100201,"เต็นท์ลานจอดรถโรงเรียนมัธยมสาธิตมหาวิทยาลัยราชภัฏสวนสุนันทาถนนอู่ทองนอก",8,153,232,264,496
72,"ดุสิต","เขตดุสิต",100201,"เต็นท์ลานจอดรถโรงเรียนมัธยมสาธิตมหาวิทยาลัยราชภัฏสวนสุนันทาถนนอู่ทองนอก",9,167,245,256,501
73,"ดุสิต","เขตดุสิต",100201,"เต็นท์ลานกิจกรรมโรงเรียนวัดเบญจมบพิตร ถนนนครปฐม",10,12,544,3,547
74,"ดุสิต","เขตดุสิต",100201,"เต็นท์ลานกิจกรรมโรงเรียนวัดเบญจมบพิตร ถนนนครปฐม",11,51,210,165,375
75,"ดุสิต","เขตดุสิต",100201,"เต็นท์ภายในคุรุสภา ถนนนครราชสีมา",12,132,189,219,408
76,"ดุสิต","เขตดุสิต",100201,"เต็นท์ภายในคุรุสภา ถนนนครราชสีมา",13,71,197,208,405
77,"วชิรพยาบาล","เขตดุสิต",100202,"วัดประสาทบุญญาวาส ถนนดาวข่าง",1,72,119,378,497
78,"วชิรพยาบาล","เขตดุสิต",100202,"วัดประสาทบุญญาวาส ถนนดาวข่าง",2,119,261,290,551
79,"วชิรพยาบาล","เขตดุสิต",100202,"วัดประสาทบุญญาวาส ถนนดาวข่าง",3,122,245,256,501
80,"วชิรพยาบาล","เขตดุสิต",100202,"เต็นท์ลานกิจกรรมโรงเรียนวัดราชผาติการาม ถนนราชวิถี",4,128,212,210,422
81,"วชิรพยาบาล","เขตดุสิต",100202,"เต็นท์ลานกิจกรรมโรงเรียนวัดราชผาติการาม ถนนราชวิถี",5,158,218,223,441
82,"วชิรพยาบาล","เขตดุสิต",100202,"เต็นท์ลานจอดรถวัดราชผาติการาม ถนนราชวิถี",6,161,207,235,442
83,"วชิรพยาบาล","เขตดุสิต",100202,"เต็นท์ลานจอดรถวัดราชผาติการาม ถนนราชวิถี",7,2,20,353,373
84,"วชิรพยาบาล","เขตดุสิต",100202,"เต็นท์ลานกิจกรรมโรงเรียนโยนออฟอาร์ค ซอยสามเสน 13",8,121,166,232,398
85,"วชิรพยาบาล","เขตดุสิต",100202,"เต็นท์ลานกิจกรรมโรงเรียนโยนออฟอาร์ค ซอยสามเสน 13",9,95,182,227,409
86,"วชิรพยาบาล","เขตดุสิต",100202,"เต็นท์ลานกิจกรรมโรงเรียนโยนออฟอาร์ค ซอยสามเสน 13",10,135,200,241,441
87,"วชิรพยาบาล","เขตดุสิต",100202,"เต็นท์ลานกิจกรรมโรงเรียนโยนออฟอาร์ค ซอยสามเสน 13",11,109,210,228,438
88,"วชิรพยาบาล","เขตดุสิต",100202,"โรงเรียนโยนออฟอาร์ค ซอยสามเสน 13",12,101,196,249,445
89,"วชิรพยาบาล","เขตดุสิต",100202,"โรงเรียนโยนออฟอาร์ค ซอยสามเสน 13",13,119,184,250,434
90,"วชิรพยาบาล","เขตดุสิต",100202,"โรงเรียนวัดราชาธิวาส ซอยสามเสน 9",14,166,248,266,514
91,"วชิรพยาบาล","เขตดุสิต",100202,"เต็นท์หน้าหอวชิราวุธานุสรณ์ หอสมุดแห่งชาติ ถนนสามเสน",15,212,292,302,594
92,"วชิรพยาบาล","เขตดุสิต",100202,"โรงเรียนวัดเทวราชกุญชร ถนนศรีอยุธยา",16,133,284,330,614
93,"วชิรพยาบาล","เขตดุสิต",100202,"โรงเรียนวัดเทวราชกุญชร ถนนศรีอยุธยา",17,155,290,322,612
94,"สวนจิตรลดา","เขตดุสิต",100203,"เต็นท์ลานอเนกประสงค์วัดสุคันธาราม ถนนสุคันธาราม",1,70,222,184,406
95,"สวนจิตรลดา","เขตดุสิต",100203,"เต็นท์ลานอเนกประสงค์วัดสุคันธาราม ถนนสุคันธาราม",2,77,191,211,402
96,"สวนจิตรลดา","เขตดุสิต",100203,"เต็นท์ลานอเนกประสงค์วัดสุคันธาราม ถนนสุคันธาราม",3,98,201,205,406
97,"สวนจิตรลดา","เขตดุสิต",100203,"เต็นท์ลานอเนกประสงค์วัดสุคันธาราม ถนนสุคันธาราม",4,100,188,211,399
98,"สวนจิตรลดา","เขตดุสิต",100203,"เต็นท์ลานอเนกประสงค์วัดสุคันธาราม ถนนสุคันธาราม",5,102,190,205,395
99,"สวนจิตรลดา","เขตดุสิต",100203,"โรงเรียนสุโขทัย ถนนสุโขทัย",6,129,162,236,398
100,"สวนจิตรลดา","เขตดุสิต",100203,"โรงเรียนสุโขทัย ถนนสุโขทัย",7,110,196,202,398
101,"สวนจิตรลดา","เขตดุสิต",100203,"เต็นท์ลานกิจกรรมโรงเรียนสุโขทัย ถนนสุโขทัย",8,118,208,222,430
102,"สวนจิตรลดา","เขตดุสิต",100203,"เต็นท์ลานกิจกรรมโรงเรียนสุโขทัย ถนนสุโขทัย",9,115,172,266,438
103,"สวนจิตรลดา","เขตดุสิต",100203,"เต็นท์ลานจอดรถร้านคุโมะ คาเฟ่ ถนนราชวิถี",10,171,323,351,674
104,"สวนจิตรลดา","เขตดุสิต",100203,"เต็นท์ลานจอดรถร้านคุโมะ คาเฟ่ ถนนราชวิถี",11,160,290,350,640
105,"สวนจิตรลดา","เขตดุสิต",100203,"อาคารพร้อมมงคล มหาวิทยาลัยเทคโนโลยีราชมงคลพระนครถนนพิษณุโลก",12,130,235,235,470
106,"สี่แยกมหานาค","เขตดุสิต",100204,"โรงเรียนวัดสมณานัมบริหาร ถนนพิษณุโลก",1,129,263,248,511
107,"สี่แยกมหานาค","เขตดุสิต",100204,"โรงเรียนวัดสมณานัมบริหาร ถนนพิษณุโลก",2,150,260,265,525
108,"สี่แยกมหานาค","เขตดุสิต",100204,"เต็นท์ลานกิจกรรมโรงเรียนวัดสมณานัมบริหาร ถนนพิษณุโลก",3,149,230,279,509
109,"สี่แยกมหานาค","เขตดุสิต",100204,"เต็นท์ลานกิจกรรมโรงเรียนวัดสมณานัมบริหาร ถนนพิษณุโลก",4,133,254,266,520
110,"สี่แยกมหานาค","เขตดุสิต",100204,"เต็นท์ภายในบ้านมนังคศิลา ถนนหลานหลวง",5,187,245,296,541
111,"สี่แยกมหานาค","เขตดุสิต",100204,"เต็นท์ภายในบ้านมนังคศิลา ถนนหลานหลวง",6,149,263,297,560
112,"สี่แยกมหานาค","เขตดุสิต",100204,"เต็นท์ภายในบ้านมนังคศิลา ถนนหลานหลวง",7,197,290,322,612
113,"สี่แยกมหานาค","เขตดุสิต",100204,"เต็นท์ภายในบ้านมนังคศิลา ถนนหลานหลวง",8,142,322,318,640
114,"สี่แยกมหานาค","เขตดุสิต",100204,"เต็นท์ภายในบ้านมนังคศิลา ถนนหลานหลวง",9,199,311,327,638
115,"สี่แยกมหานาค","เขตดุสิต",100204,"เต็นท์ภายในบ้านมนังคศิลา ถนนหลานหลวง",10,157,258,301,559
116,"ถนนนครไชยศรี","เขตดุสิต",100206,"เต็นท์ภายในสถานีดับเพลิงและกู้ภัยดุสิต ถนนเทอดดำริห์",1,100,208,240,448
117,"ถนนนครไชยศรี","เขตดุสิต",100206,"เต็นท์ภายในสถานีดับเพลิงและกู้ภัยดุสิต ถนนเทอดดำริห์",2,170,189,244,433
118,"ถนนนครไชยศรี","เขตดุสิต",100206,"สถานีดับเพลิงและกู้ภัยดุสิต ถนนเทอดดำริห์",3,159,189,248,437
119,"ถนนนครไชยศรี","เขตดุสิต",100206,"สถานีดับเพลิงและกู้ภัยดุสิต ถนนเทอดดำริห์",4,196,217,208,425
120,"ถนนนครไชยศรี","เขตดุสิต",100206,"สถานีดับเพลิงและกู้ภัยดุสิต ถนนเทอดดำริห์",5,121,273,211,484
121,"ถนนนครไชยศรี","เขตดุสิต",100206,"สถานีดับเพลิงและกู้ภัยดุสิต ถนนเทอดดำริห์",6,246,278,213,491
122,"ถนนนครไชยศรี","เขตดุสิต",100206,"เต็นท์ภายในกรมสรรพสามิต ถนนนครไชยศรี",7,161,270,265,535
123,"ถนนนครไชยศรี","เขตดุสิต",100206,"เต็นท์ภายในกรมสรรพสามิต ถนนนครไชยศรี",8,110,253,273,526
124,"ถนนนครไชยศรี","เขตดุสิต",100206,"เต็นท์ภายในกรมสรรพสามิต ถนนนครไชยศรี",9,294,247,306,553
125,"ถนนนครไชยศรี","เขตดุสิต",100206,"โรงเรียนอัมพวันศึกษา ถนนนครไชยศรี",10,144,183,239,422
126,"ถนนนครไชยศรี","เขตดุสิต",100206,"โรงเรียนอัมพวันศึกษา ถนนนครไชยศรี",11,91,193,198,391
127,"ถนนนครไชยศรี","เขตดุสิต",100206,"โรงเรียนราชวัตรวิทยา ถนนนครไชยศรี",12,154,232,242,474
128,"ถนนนครไชยศรี","เขตดุสิต",100206,"โรงเรียนราชวัตรวิทยา ถนนนครไชยศรี",13,142,229,250,479
129,"ถนนนครไชยศรี","เขตดุสิต",100206,"เต็นท์ลานกิจกรรมโรงเรียนเศรษฐเสถียร ถนนพระราม 5",14,129,235,239,474
130,"ถนนนครไชยศรี","เขตดุสิต",100206,"เต็นท์ลานกิจกรรมโรงเรียนเศรษฐเสถียร ถนนพระราม 5",15,143,234,281,515
131,"ถนนนครไชยศรี","เขตดุสิต",100206,"เต็นท์ลานกิจกรรมโรงเรียนเศรษฐเสถียร ถนนพระราม 5",16,186,225,271,496
132,"ถนนนครไชยศรี","เขตดุสิต",100206,"เต็นท์หน้าบ้านเลขที่ 134 ถนนพิชัย",17,96,137,200,337
133,"ถนนนครไชยศรี","เขตดุสิต",100206,"เต็นท์หน้าบ้านเลขที่ 134 ถนนพิชัย",18,148,179,246,425
134,"ถนนนครไชยศรี","เขตดุสิต",100206,"เต็นท์หน้าบ้านเลขที่ 134 ถนนพิชัย",19,126,202,245,447
135,"ถนนนครไชยศรี","เขตดุสิต",100206,"เต็นท์ลานจอดรถร้านดาราดาเล ถนนพิชัย",20,111,216,231,447
136,"ถนนนครไชยศรี","เขตดุสิต",100206,"เต็นท์ลานจอดรถร้านดาราดาเล ถนนพิชัย",21,169,201,260,461
137,"ถนนนครไชยศรี","เขตดุสิต",100206,"เต็นท์ปากซอยอนุวัฒน์วิเทศ ข้างอาคารบางกอก ถนนพิชัย",22,173,235,300,535
138,"ถนนนครไชยศรี","เขตดุสิต",100206,"โรงเรียนวัดสวัสดิ์วารีสีมาราม ถนนนครไชยศรี",23,153,233,295,528
139,"ถนนนครไชยศรี","เขตดุสิต",100206,"โรงเรียนวัดสวัสดิ์วารีสีมาราม ถนนนครไชยศรี",24,97,256,234,490
140,"ถนนนครไชยศรี","เขตดุสิต",100206,"โรงเรียนวัดสวัสดิ์วารีสีมาราม ถนนนครไชยศรี",25,142,226,309,535
141,"ถนนนครไชยศรี","เขตดุสิต",100206,"วัดสวัสดิ์วารีสีมาราม ถนนนครไชยศรี",26,112,181,232,413
142,"ถนนนครไชยศรี","เขตดุสิต",100206,"วัดสวัสดิ์วารีสีมาราม ถนนนครไชยศรี",27,149,203,232,435
143,"ถนนนครไชยศรี","เขตดุสิต",100206,"วิทยาลัยเทคโนโลยีพณิชยการสามเสน ซอยสามเสน 22",28,150,254,282,536
144,"ถนนนครไชยศรี","เขตดุสิต",100206,"วิทยาลัยเทคโนโลยีพณิชยการสามเสน ซอยสามเสน 22",29,199,276,313,589
145,"ถนนนครไชยศรี","เขตดุสิต",100206,"เต็นท์จอดรถวิทยาลัยเทคโนโลยีพณิชยการสามเสน ซอยสามเสน 22",30,152,271,332,603
146,"ถนนนครไชยศรี","เขตดุสิต",100206,"วิทยาลัยเทคโนโลยีวิมลศรีย่าน ถนนนครไชยศรี",31,129,267,284,551
147,"ถนนนครไชยศรี","เขตดุสิต",100206,"วิทยาลัยเทคโนโลยีวิมลศรีย่าน ถนนนครไชยศรี",32,165,253,266,519
148,"ถนนนครไชยศรี","เขตดุสิต",100206,"วิทยาลัยเทคโนโลยีวิมลศรีย่าน ถนนนครไชยศรี",33,156,236,254,490
149,"ถนนนครไชยศรี","เขตดุสิต",100206,"วิทยาลัยเทคโนโลยีวิมลศรีย่าน ถนนนครไชยศรี",34,159,212,275,487
150,"ถนนนครไชยศรี","เขตดุสิต",100206,"วิทยาลัยอาชีวศึกษาอาชีวศิลป์ ถนนนครไชยศรี",35,129,203,237,440
151,"ถนนนครไชยศรี","เขตดุสิต",100206,"วิทยาลัยอาชีวศึกษาอาชีวศิลป์ ถนนนครไชยศรี",36,106,191,200,391
152,"ถนนนครไชยศรี","เขตดุสิต",100206,"โรงเรียนราชินีบน (ลานจอดรถใต้อาคารโรงยิม 3)ถนนท่าเขียวไข่กา",37,171,183,190,373
153,"ถนนนครไชยศรี","เขตดุสิต",100206,"เต็นท์ลานกิจกรรมโรงเรียนวัดจันทรสโมสร ถนนสามเสน",38,179,259,298,557
154,"ถนนนครไชยศรี","เขตดุสิต",100206,"เต็นท์ลานกิจกรรมโรงเรียนวัดจันทรสโมสร ถนนสามเสน",39,203,236,272,508
155,"ถนนนครไชยศรี","เขตดุสิต",100206,"เต็นท์ลานกิจกรรมโรงเรียนวัดจันทรสโมสร ถนนสามเสน",40,121,284,327,611
156,"ถนนนครไชยศรี","เขตดุสิต",100206,"เต็นท์ภายในศูนย์สร้างสุขทุกวัยเกียกกาย ถนนทหาร",41,127,261,131,392
157,"ถนนนครไชยศรี","เขตดุสิต",100206,"เต็นท์ภายในศูนย์สร้างสุขทุกวัยเกียกกาย ถนนทหาร",42,160,256,142,398
158,"ถนนนครไชยศรี","เขตดุสิต",100206,"เต็นท์ภายในศูนย์สร้างสุขทุกวัยเกียกกาย ถนนทหาร",43,16,397,17,414
159,"ถนนนครไชยศรี","เขตดุสิต",100206,"เต็นท์ภายในศูนย์สร้างสุขทุกวัยเกียกกาย ถนนทหาร",44,170,198,144,342
160,"ถนนนครไชยศรี","เขตดุสิต",100206,"เต็นท์ภายในศูนย์สร้างสุขทุกวัยเกียกกาย ถนนทหาร",45,31,325,63,388
161,"ถนนนครไชยศรี","เขตดุสิต",100206,"เต็นท์ภายในศูนย์สร้างสุขทุกวัยเกียกกาย ถนนทหาร",46,123,250,92,342
162,"ถนนนครไชยศรี","เขตดุสิต",100206,"เต็นท์ภายในศูนย์สร้างสุขทุกวัยเกียกกาย ถนนทหาร",47,194,228,108,336
163,"ถนนนครไชยศรี","เขตดุสิต",100206,"เต็นท์ภายในศูนย์สร้างสุขทุกวัยเกียกกาย ถนนทหาร",48,150,226,110,336
164,"ถนนนครไชยศรี","เขตดุสิต",100206,"เต็นท์ภายในศูนย์สร้างสุขทุกวัยเกียกกาย ถนนทหาร",49,1,470,0,470
165,"ถนนนครไชยศรี","เขตดุสิต",100206,"เต็นท์ภายในศูนย์สร้างสุขทุกวัยเกียกกาย ถนนทหาร",50,110,260,111,371
166,"ถนนนครไชยศรี","เขตดุสิต",100206,"เต็นท์ภายในศูนย์สร้างสุขทุกวัยเกียกกาย ถนนทหาร",51,195,206,160,366
167,"ถนนนครไชยศรี","เขตดุสิต",100206,"เต็นท์ภายในศูนย์สร้างสุขทุกวัยเกียกกาย ถนนทหาร",52,184,192,169,361
168,"ถนนนครไชยศรี","เขตดุสิต",100206,"เต็นท์ภายในศูนย์สร้างสุขทุกวัยเกียกกาย ถนนทหาร",53,170,200,150,350
169,"ถนนนครไชยศรี","เขตดุสิต",100206,"เต็นท์ภายในศูนย์สร้างสุขทุกวัยเกียกกาย ถนนทหาร",54,119,466,57,523
170,"ถนนนครไชยศรี","เขตดุสิต",100206,"วัดแก้วฟ้าจุฬามณี ถนนทหาร",55,185,525,76,601
171,"ถนนนครไชยศรี","เขตดุสิต",100206,"วัดแก้วฟ้าจุฬามณี ถนนทหาร",56,174,233,146,379
172,"ถนนนครไชยศรี","เขตดุสิต",100206,"วัดแก้วฟ้าจุฬามณี ถนนทหาร",57,109,182,199,381
173,"ถนนนครไชยศรี","เขตดุสิต",100206,"วัดแก้วฟ้าจุฬามณี ถนนทหาร",58,129,197,195,392
174,"ถนนนครไชยศรี","เขตดุสิต",100206,"โรงเรียนวัดประชาระบือธรรม ถนนพระราม 5",59,134,224,244,468
175,"ถนนนครไชยศรี","เขตดุสิต",100206,"โรงเรียนวัดประชาระบือธรรม ถนนพระราม 5",60,107,185,250,435
176,"ถนนนครไชยศรี","เขตดุสิต",100206,"เต็นท์ลานกิจกรรมโรงเรียนวัดประชาระบือธรรม ถนนพระราม 5",61,139,236,287,523
177,"ถนนนครไชยศรี","เขตดุสิต",100206,"เต็นท์ลานกิจกรรมโรงเรียนวัดประชาระบือธรรม ถนนพระราม 5",62,134,200,224,424
178,"ถนนนครไชยศรี","เขตดุสิต",100206,"เต็นท์ลานกิจกรรมโรงเรียนวัดประชาระบือธรรม ถนนพระราม 5",63,98,205,202,407
179,"ถนนนครไชยศรี","เขตดุสิต",100206,"เต็นท์ลานกิจกรรมโรงเรียนวัดประชาระบือธรรม ถนนพระราม 5",64,266,282,166,448
180,"ถนนนครไชยศรี","เขตดุสิต",100206,"เต็นท์ลานกิจกรรมโรงเรียนวัดประชาระบือธรรม ถนนพระราม 5",65,121,369,161,530
181,"ถนนนครไชยศรี","เขตดุสิต",100206,"วัดประชาระบือธรรม ถนนพระราม 5",66,215,295,213,508
182,"ถนนนครไชยศรี","เขตดุสิต",100206,"วัดประชาระบือธรรม ถนนพระราม 5",67,145,608,97,705
183,"ถนนนครไชยศรี","เขตดุสิต",100206,"โรงเรียนกันตะบุตร ถนนอำนวยสงคราม",68,127,235,303,538
184,"ถนนนครไชยศรี","เขตดุสิต",100206,"โรงเรียนกันตะบุตร ถนนอำนวยสงคราม",69,137,239,281,520
185,"ถนนนครไชยศรี","เขตดุสิต",100206,"เต็นท์ลานจอดรถโรงเรียนกันตะบุตร ถนนอำนวยสงคราม",70,153,226,272,498
186,"ถนนนครไชยศรี","เขตดุสิต",100206,"เต็นท์ลานจอดรถโรงเรียนกันตะบุตร ถนนอำนวยสงคราม",71,146,196,267,463
187,"ถนนนครไชยศรี","เขตดุสิต",100206,"เต็นท์ลานจอดรถโรงเรียนกันตะบุตร ถนนอำนวยสงคราม",72,174,202,235,437
188,"ถนนนครไชยศรี","เขตดุสิต",100206,"เต็นท์ลานจอดรถโรงเรียนกันตะบุตร ถนนอำนวยสงคราม",73,153,221,286,507
189,"ถนนนครไชยศรี","เขตดุสิต",100206,"โรงเรียนวัดน้อยนพคุณ ถนนพระราม 5",74,170,204,150,354
190,"ถนนนครไชยศรี","เขตดุสิต",100206,"โรงเรียนวัดน้อยนพคุณ ถนนพระราม 5",75,100,202,158,360
191,"ถนนนครไชยศรี","เขตดุสิต",100206,"โรงเรียนวัดน้อยนพคุณ ถนนพระราม 5",76,146,217,191,408
192,"ถนนนครไชยศรี","เขตดุสิต",100206,"โรงเรียนวัดน้อยนพคุณ ถนนพระราม 5",77,193,273,106,379
193,"ถนนนครไชยศรี","เขตดุสิต",100206,"บมจ.แอสเซท พระราม 5 ถนนพระราม 5",78,127,252,279,531
194,"ถนนนครไชยศรี","เขตดุสิต",100206,"วิทยาลัยเทคนิคดุสิต ถนนระนอง 2",79,170,242,272,514
195,"ถนนนครไชยศรี","เขตดุสิต",100206,"วิทยาลัยเทคนิคดุสิต ถนนระนอง 2",80,136,235,226,461
196,"ถนนนครไชยศรี","เขตดุสิต",100206,"เต็นท์ลานกีฬาวิทยาลัยเทคนิคดุสิต ถนนระนอง 2",81,153,215,231,446
197,"ถนนนครไชยศรี","เขตดุสิต",100206,"เต็นท์ลานกีฬาวิทยาลัยเทคนิคดุสิต ถนนระนอง 2",82,153,235,191,426
198,"ถนนนครไชยศรี","เขตดุสิต",100206,"โรงเรียนวัดธรรมาภิรตาราม ถนนเตชะวณิช",83,112,254,191,445
199,"ถนนนครไชยศรี","เขตดุสิต",100206,"โรงเรียนวัดธรรมาภิรตาราม ถนนเตชะวณิช",84,281,309,160,469
200,"กระทุ่มราย","เขตหนองจอก",100301,"เต็นท์บริเวณโรงสีเก่าตรงข้ามห้างสรรพสินค้า บิ๊กซีสาขาหนองจอก",1,157,363,343,706
201,"กระทุ่มราย","เขตหนองจอก",100301,"เต็นท์บริเวณโรงสีเก่าตรงข้ามห้างสรรพสินค้า บิ๊กซีสาขาหนองจอก",2,217,327,351,678
202,"กระทุ่มราย","เขตหนองจอก",100301,"เต็นท์บริเวณโรงสีเก่าตรงข้ามห้างสรรพสินค้า บิ๊กซีสาขาหนองจอก",3,430,352,459,811
203,"กระทุ่มราย","เขตหนองจอก",100301,"มหาวิทยาลัยเทคโนโลยีมหานคร",4,246,300,314,614
204,"กระทุ่มราย","เขตหนองจอก",100301,"มหาวิทยาลัยเทคโนโลยีมหานคร",5,151,274,298,572
205,"กระทุ่มราย","เขตหนองจอก",100301,"มหาวิทยาลัยเทคโนโลยีมหานคร",6,257,254,266,520
206,"กระทุ่มราย","เขตหนองจอก",100301,"แฟลตข้าราชการเขตหนองจอก ตรงข้ามสำนักงานเขตหนองจอก",7,235,276,330,606
207,"กระทุ่มราย","เขตหนองจอก",100301,"แฟลตข้าราชการเขตหนองจอก ตรงข้ามสำนักงานเขตหนองจอก",8,243,314,289,603
208,"กระทุ่มราย","เขตหนองจอก",100301,"โรงเรียนเซนต์เทเรซา",9,185,297,295,592
209,"กระทุ่มราย","เขตหนองจอก",100301,"โรงเรียนเซนต์เทเรซา",10,182,296,313,609
210,"กระทุ่มราย","เขตหนองจอก",100301,"โรงเรียนเซนต์เทเรซา",11,259,288,325,613
211,"กระทุ่มราย","เขตหนองจอก",100301,"โรงเรียนเซนต์เทเรซา",12,219,295,312,607
212,"กระทุ่มราย","เขตหนองจอก",100301,"เต็นท์ตรงข้ามบ้านเลขที่ 6/242 หมู่บ้านวัฒนา - ร่มไทร ถนนสังฆสันติสุข",13,358,392,462,854
213,"กระทุ่มราย","เขตหนองจอก",100301,"เต็นท์บริเวณทางเข้าหมู่บ้านนันทวันเซ็นต์ 1 ถนนสังฆสันติสุข",14,230,254,264,518
214,"กระทุ่มราย","เขตหนองจอก",100301,"เต็นท์บริเวณทางเข้าหมู่บ้านนันทวันเซ็นต์ 1 ถนนสังฆสันติสุข",15,224,220,284,504
215,"กระทุ่มราย","เขตหนองจอก",100301,"สนามเด็กเล่นหมู่บ้านนันทวันเซ็นต์ 2 ถนนสังฆสันติสุข",16,243,307,307,614
216,"กระทุ่มราย","เขตหนองจอก",100301,"สนามเด็กเล่นหมู่บ้านนันทวันเซ็นต์ 2 ถนนสังฆสันติสุข",17,252,256,304,560
217,"กระทุ่มราย","เขตหนองจอก",100301,"โรงเรียนสามแยกท่าไข่",18,166,264,284,548
218,"กระทุ่มราย","เขตหนองจอก",100301,"โรงเรียนสามแยกท่าไข่",19,207,277,308,585
219,"กระทุ่มราย","เขตหนองจอก",100301,"โรงเรียนสามแยกท่าไข่",20,122,283,270,553
220,"กระทุ่มราย","เขตหนองจอก",100301,"ศูนย์พัฒนาเด็กก่อนวัยเรียนชุมชนแผ่นดินทองนูรุ้ลยากีน",21,143,300,321,621
221,"กระทุ่มราย","เขตหนองจอก",100301,"ศูนย์พัฒนาเด็กก่อนวัยเรียนชุมชนแผ่นดินทองนูรุ้ลยากีน",22,144,293,322,615
222,"กระทุ่มราย","เขตหนองจอก",100301,"โรงเรียนนีลราษฎร์อุปถัมภ์",23,138,228,259,487
223,"กระทุ่มราย","เขตหนองจอก",100301,"โรงเรียนนีลราษฎร์อุปถัมภ์",24,211,228,271,499
224,"กระทุ่มราย","เขตหนองจอก",100301,"โรงเรียนนีลราษฎร์อุปถัมภ์",25,241,226,276,502
225,"กระทุ่มราย","เขตหนองจอก",100301,"โรงเรียนหลวงแพ่ง (บำรุงรัฐกิจ)",26,189,298,311,609
226,"กระทุ่มราย","เขตหนองจอก",100301,"โรงเรียนหลวงแพ่ง (บำรุงรัฐกิจ)",27,244,297,329,626
227,"กระทุ่มราย","เขตหนองจอก",100301,"เต็นท์บริเวณทางเข้าสวนเกษตร (หมอสุพจน์) ถนนสุวินทวงศ์",28,116,228,235,463
228,"กระทุ่มราย","เขตหนองจอก",100301,"เต็นท์บริเวณทางเข้าสวนเกษตร (หมอสุพจน์) ถนนสุวินทวงศ์",29,143,227,237,464
229,"กระทุ่มราย","เขตหนองจอก",100301,"เต็นท์บริเวณโรงงานมิกซ์เวลล์มาเก็ตติ้ง ถนนสุวินทวงศ์",30,209,328,346,674
230,"กระทุ่มราย","เขตหนองจอก",100301,"เต็นท์หน้าสำนักงานบริษัท บ้านอมรทรัพย์ จำกัด ซอยอยู่วิทยา 18",31,172,282,310,592
231,"กระทุ่มราย","เขตหนองจอก",100301,"เต็นท์หน้าบ้านเลขที่ 68/804 ปากทางเข้าหมู่บ้านอมรทรัพย์ ซอยอยู่วิทยา 18",32,186,296,286,582
232,"กระทุ่มราย","เขตหนองจอก",100301,"เต็นท์บริเวณตลาดนัดหมู่บ้านอมรทรัพย์ ซอยอยู่วิทยา 18",33,275,282,324,606
233,"กระทุ่มราย","เขตหนองจอก",100301,"เต็นท์บริเวณตลาดนัดหมู่บ้านอมรทรัพย์ ซอยอยู่วิทยา 18",34,251,295,313,608
234,"กระทุ่มราย","เขตหนองจอก",100301,"เต็นท์บริเวณตลาดนัดหมู่บ้านอมรทรัพย์ ซอยอยู่วิทยา 18",35,271,282,333,615
235,"กระทุ่มราย","เขตหนองจอก",100301,"เต็นท์บริเวณตลาดนัดหมู่บ้านอมรทรัพย์ ซอยอยู่วิทยา 18",36,302,280,342,622
236,"กระทุ่มราย","เขตหนองจอก",100301,"เต็นท์บริเวณตลาดนัดหมู่บ้านอมรทรัพย์ ซอยอยู่วิทยา 18",37,277,268,343,611
237,"กระทุ่มราย","เขตหนองจอก",100301,"เต็นท์บริเวณตลาดนัดหมู่บ้านอมรทรัพย์ ซอยอยู่วิทยา 18",38,268,299,313,612
238,"กระทุ่มราย","เขตหนองจอก",100301,"เต็นท์บริเวณตลาดนัดหมู่บ้านอมรทรัพย์ ซอยอยู่วิทยา 18",39,236,252,296,548
239,"กระทุ่มราย","เขตหนองจอก",100301,"เต็นท์บริเวณตลาดนัดหมู่บ้านอมรทรัพย์ ซอยอยู่วิทยา 18",40,276,276,335,611
240,"กระทุ่มราย","เขตหนองจอก",100301,"เต็นท์บริเวณตลาดนัดหมู่บ้านอมรทรัพย์ ซอยอยู่วิทยา 18",41,320,308,359,667
241,"กระทุ่มราย","เขตหนองจอก",100301,"เต็นท์บริเวณมัสยิดอุมัรอิบนุ้ลค๊อฏฏ๊อบ",42,194,340,333,673
242,"กระทุ่มราย","เขตหนองจอก",100301,"เต็นท์บริเวณมัสยิดอุมัรอิบนุ้ลค๊อฏฏ๊อบ",43,333,295,327,622
243,"กระทุ่มราย","เขตหนองจอก",100301,"เต็นท์บริเวณศูนย์พัฒนาเด็กก่อนวัยเรียนชุมชนลำสลิดทองพัฒนา",44,267,254,316,570
244,"กระทุ่มราย","เขตหนองจอก",100301,"เต็นท์บริเวณศูนย์พัฒนาเด็กก่อนวัยเรียนชุมชนสำสลิดทองพัฒนา",45,247,273,304,577
245,"กระทุ่มราย","เขตหนองจอก",100301,"โรงเรียนสุเหร่าหะยีมินา",46,232,303,352,655
246,"กระทุ่มราย","เขตหนองจอก",100301,"โรงเรียนสุเหร่าหะยีมินา",47,204,285,298,583
247,"กระทุ่มราย","เขตหนองจอก",100301,"โรงเรียนสุเหร่าหะยีมินา",48,205,304,317,621
248,"กระทุ่มราย","เขตหนองจอก",100301,"โรงเรียนสุเหร่าหะยีมินา",49,181,291,324,615
249,"กระทุ่มราย","เขตหนองจอก",100301,"โรงเรียนสุเหร่าหะยีมินา",50,268,274,357,631
250,"หนองจอก","เขตหนองจอก",100302,"โรงเรียนสุเหร่าบ้านเกาะ",1,134,265,261,526
251,"หนองจอก","เขตหนองจอก",100302,"โรงเรียนสุเหร่าบ้านเกาะ",2,152,232,278,510
252,"หนองจอก","เขตหนองจอก",100302,"โรงเรียนสุเหร่าบ้านเกาะ",3,151,232,279,511
253,"หนองจอก","เขตหนองจอก",100302,"เต็นท์บริเวณมัสยิดอิบรอฮีม (บึงเตย) ถนนประชาสำราญ",4,299,399,480,879
254,"หนองจอก","เขตหนองจอก",100302,"เต็นท์บริเวณมัสยิดอิบรอฮีม (บึงเตย) ถนนประชาสำราญ",5,293,404,450,854
255,"หนองจอก","เขตหนองจอก",100302,"โรงเรียนสุเหร่าศาลาแดง",6,154,350,308,658
256,"หนองจอก","เขตหนองจอก",100302,"โรงเรียนหนองจอกกงลิบฮัวเคียว",7,204,282,335,617
257,"หนองจอก","เขตหนองจอก",100302,"โรงเรียนหนองจอกกงลิบฮัวเคียว",8,199,304,323,627
258,"หนองจอก","เขตหนองจอก",100302,"โรงเรียนหนองจอกกงลิบฮัวเคียว",9,226,270,339,609
259,"หนองจอก","เขตหนองจอก",100302,"เต็นท์บริเวณปากซอยมิตรไมตรี 8",10,144,231,266,497
260,"หนองจอก","เขตหนองจอก",100302,"เต็นท์บริเวณปากซอยมิตรไมตรี 8",11,159,235,263,498
261,"หนองจอก","เขตหนองจอก",100302,"เต็นท์บริเวณปากซอยมิตรไมตรี 8",12,195,210,286,496
262,"หนองจอก","เขตหนองจอก",100302,"โรงเรียนสอนศาสนา บริเวณมัสยิดอัลฮุสนา (บ้านเจียรดับ)",13,233,352,356,708
263,"หนองจอก","เขตหนองจอก",100302,"โรงเรียนสอนศาสนา บริเวณมัสยิดอัลฮุสนา (บ้านเจียรดับ)",14,232,328,364,692
264,"หนองจอก","เขตหนองจอก",100302,"โรงเรียนสอนศาสนา บริเวณมัสยิดอัลฮุสนา (บ้านเจียรดับ)",15,281,316,378,694
265,"หนองจอก","เขตหนองจอก",100302,"อาคารอเนกประสงค์บริเวณมัสยิดอัรเราะห์มาน (บ้านหนองปลาหมอ)",16,200,388,379,767
266,"หนองจอก","เขตหนองจอก",100302,"โรงเรียนสุเหร่าใหม่",17,190,334,366,700
267,"หนองจอก","เขตหนองจอก",100302,"โรงเรียนสุเหร่าใหม่",18,217,325,360,685
268,"หนองจอก","เขตหนองจอก",100302,"โรงเรียนสุเหร่าใหม่",19,211,323,366,689
269,"หนองจอก","เขตหนองจอก",100302,"โรงเรียนสุเหร่าใหม่",20,272,310,376,686
270,"หนองจอก","เขตหนองจอก",100302,"โรงเรียนสุเหร่าใหม่",21,293,348,381,729
271,"หนองจอก","เขตหนองจอก",100302,"โรงเรียนหนองจอกพิทยานุสรณ์",22,178,301,320,621
272,"หนองจอก","เขตหนองจอก",100302,"โรงเรียนหนองจอกพิทยานุสรณ์",23,231,302,307,609
273,"หนองจอก","เขตหนองจอก",100302,"โรงเรียนหนองจอกพิทยานุสรณ์",24,242,274,344,618
274,"หนองจอก","เขตหนองจอก",100302,"โรงเรียนหนองจอกพิทยานุสรณ์",25,244,293,320,613
275,"หนองจอก","เขตหนองจอก",100302,"โรงเรียนหนองจอกพิทยานุสรณ์",26,292,298,339,637
276,"หนองจอก","เขตหนองจอก",100302,"โรงเรียนหนองจอกพิทยานุสรณ์",27,412,349,447,796
277,"คลองสิบ","เขตหนองจอก",100303,"เต็นท์บริเวณมูลนิธิร็อฟฮาน",1,134,248,267,515
278,"คลองสิบ","เขตหนองจอก",100303,"เต็นท์บริเวณมูลนิธิร็อฟฮาน",2,132,256,270,526
279,"คลองสิบ","เขตหนองจอก",100303,"โรงเรียนสุเหร่าคลองเก้า",3,136,255,221,476
280,"คลองสิบ","เขตหนองจอก",100303,"โรงเรียนสุเหร่าคลองเก้า",4,143,240,235,475
281,"คลองสิบ","เขตหนองจอก",100303,"เต็นท์บริเวณโรงเรียนสุเหร่าคลองเก้า",5,159,217,243,460
282,"คลองสิบ","เขตหนองจอก",100303,"โรงเรียนสุเหร่าคลองสิบ",6,187,327,377,704
283,"คลองสิบ","เขตหนองจอก",100303,"เต็นท์บริเวณลานตากข้าว ส.วรรณบุตร ถนนคู้ - คลองสิบ",7,168,236,237,473
284,"คลองสิบ","เขตหนองจอก",100303,"เต็นท์บริเวณหน้าร้าน ส.วรรณบุตร ถนนคู้ - คลองสิบ",8,182,270,273,543
285,"คลองสิบ","เขตหนองจอก",100303,"เต็นท์บริเวณหน้าร้าน ส.วรรณบุตร ถนนคู้ - คลองสิบ",9,157,261,277,538
286,"คลองสิบ","เขตหนองจอก",100303,"ศูนย์สุขภาพชุมชนคลองสิบเอ็ด",10,184,291,332,623
287,"คลองสิบ","เขตหนองจอก",100303,"โรงเรียนลำบุหรี่พวง",11,189,303,345,648
288,"คลองสิบ","เขตหนองจอก",100303,"โรงเรียนสุเหร่าคลองสิบเอ็ด",12,150,267,269,536
289,"คลองสิบ","เขตหนองจอก",100303,"โรงเรียนสุเหร่าคลองสิบเอ็ด",13,142,275,278,553
290,"คลองสิบสอง","เขตหนองจอก",100304,"โรงเรียนวัดพระยาปลา",1,247,332,364,696
291,"คลองสิบสอง","เขตหนองจอก",100304,"โรงเรียนวัดพระยาปลา",2,252,314,328,642
292,"คลองสิบสอง","เขตหนองจอก",100304,"โรงเรียนวัดพระยาปลา",3,242,294,363,657
293,"คลองสิบสอง","เขตหนองจอก",100304,"โรงเรียนวัดพระยาปลา",4,236,308,325,633
294,"คลองสิบสอง","เขตหนองจอก",100304,"โรงเรียนวัดพระยาปลา",5,232,335,336,671
295,"คลองสิบสอง","เขตหนองจอก",100304,"วัดนารีราษฎร์ประดิษฐ์ (วัดพระยาปลา)",6,193,295,339,634
296,"คลองสิบสอง","เขตหนองจอก",100304,"วัดนารีราษฎร์ประดิษฐ์ (วัดพระยาปลา)",7,236,304,335,639
297,"คลองสิบสอง","เขตหนองจอก",100304,"วัดนารีราษฎร์ประดิษฐ์ (วัดพระยาปลา)",8,306,297,350,647
298,"คลองสิบสอง","เขตหนองจอก",100304,"วัดนารีราษฎร์ประดิษฐ์ (วัดพระยาปลา)",9,286,263,334,597
299,"คลองสิบสอง","เขตหนองจอก",100304,"โรงเรียนวัดแสนเกษม",10,198,328,339,667
300,"คลองสิบสอง","เขตหนองจอก",100304,"โรงเรียนวัดแสนเกษม",11,221,342,330,672
301,"คลองสิบสอง","เขตหนองจอก",100304,"โรงเรียนวัดแสนเกษม",12,196,346,326,672
302,"คลองสิบสอง","เขตหนองจอก",100304,"เต็นท์บริเวณโรงเรียนวัดแสนเกษม",13,241,325,341,666
303,"คลองสิบสอง","เขตหนองจอก",100304,"โรงเรียนวัดใหม่เจริญราษฎร์",14,214,431,449,880
304,"โคกแฝด","เขตหนองจอก",100305,"เต็นท์บริเวณอพาร์ทเม้นท์บ้านไทเลียบวารี ตรงข้ามซอยเลียบวารี 27",1,181,278,275,553
305,"โคกแฝด","เขตหนองจอก",100305,"เต็นท์บริเวณอพาร์ทเม้นท์บ้านไทเลียบวารี ตรงข้ามซอยเลียบวารี 27",2,211,256,294,550
306,"โคกแฝด","เขตหนองจอก",100305,"เต็นท์บริเวณอพาร์ทเม้นท์บ้านไทเลียบวารี ตรงข้ามซอยเลียบวารี 27",3,223,289,277,566
307,"โคกแฝด","เขตหนองจอก",100305,"เต็นท์บริเวณอพาร์ทเม้นท์บ้านไทเลียบวารี ตรงข้ามซอยเลียบวารี 27",4,237,268,290,558
308,"โคกแฝด","เขตหนองจอก",100305,"บริเวณทางเข้าหมู่บ้านอมรทรัพย์ ซอยเลียบวารี 25",5,213,289,308,597
309,"โคกแฝด","เขตหนองจอก",100305,"บริเวณทางเข้าหมู่บ้านอมรทรัพย์ ซอยเลียบวารี 25",6,229,296,299,595
310,"โคกแฝด","เขตหนองจอก",100305,"เต็นท์บริเวณทางเข้าหมู่บ้านอมรทรัพย์ ซอยเลียบวารี 25",7,283,298,343,641
311,"โคกแฝด","เขตหนองจอก",100305,"เต็นท์บริเวณสโมสรหมู่บ้านนันทวัน 5 ซอยเลียบวารี 11",8,254,283,313,596
312,"โคกแฝด","เขตหนองจอก",100305,"เต็นท์บริเวณสโมสรหมู่บ้านนันทวัน 5 ซอยเลียบวารี 11",9,246,275,307,582
313,"โคกแฝด","เขตหนองจอก",100305,"เต็นท์บริเวณสโมสรหมู่บ้านนันทวัน 5 ซอยเลียบวารี 11",10,241,285,316,601
314,"โคกแฝด","เขตหนองจอก",100305,"เต็นท์บริเวณสโมสรหมู่บ้านนันทวัน 5 ซอยเลียบวารี 11",11,237,267,310,577
315,"โคกแฝด","เขตหนองจอก",100305,"เต็นท์ข้างบ้านเลขที่ 9/321 หมู่บ้านทรัพย์เจริญ  ซอยเลียบวารี  29",12,304,333,373,706
316,"โคกแฝด","เขตหนองจอก",100305,"เต็นท์ข้างบ้านเลขที่ 9/321 หมู่บ้านทรัพย์เจริญ ซอยเลียบวารี 29",13,236,315,308,623
317,"โคกแฝด","เขตหนองจอก",100305,"มัสยิดดารุสสะลาม ถนนเลียบวารี",14,173,284,361,645
318,"โคกแฝด","เขตหนองจอก",100305,"มัสยิดดารุสสะลาม ถนนเลียบวารี",15,246,297,338,635
319,"โคกแฝด","เขตหนองจอก",100305,"มัสยิดดารุสสะลาม ถนนเลียบวารี",16,240,306,324,630
320,"โคกแฝด","เขตหนองจอก",100305,"เต็นท์บริเวณหมู่บ้านเปรียบทอง 2 ตรงข้ามบ้านเลขที่ 104/100 ซอยเลียบวารี 59",17,345,388,473,861
321,"โคกแฝด","เขตหนองจอก",100305,"มัสยิดนูรุสสลาม (กุโบว์โต๊ะเยาะห์)",18,131,279,298,577
322,"โคกแฝด","เขตหนองจอก",100305,"มัสยิดนูรุสสลาม (กุโบว์โต๊ะเยาะห์)",19,154,266,330,596
323,"โคกแฝด","เขตหนองจอก",100305,"มัสยิดนูรุสสลาม (กุโบว์โต๊ะเยาะห์)",20,144,285,296,581
324,"โคกแฝด","เขตหนองจอก",100305,"มัสยิดนูรุสสลาม (กุโบว์โต๊ะเยาะห์)",21,145,272,322,594
325,"โคกแฝด","เขตหนองจอก",100305,"โรงเรียนวัดทรัพย์สโมสร",22,194,273,293,566
326,"โคกแฝด","เขตหนองจอก",100305,"โรงเรียนวัดทรัพย์สโมสร",23,183,279,306,585
327,"โคกแฝด","เขตหนองจอก",100305,"โรงเรียนวัดทรัพย์สโมสร",24,124,248,277,525
328,"โคกแฝด","เขตหนองจอก",100305,"โรงเรียนแสวงธรรมศึกษามัสยิดยะมิอุ้ลมุตตะกีน (ลำหินใต้)",25,118,246,229,475
329,"โคกแฝด","เขตหนองจอก",100305,"เต็นท์หน้ากองโรงงาน การไฟฟ้าฝ่ายผลิตแห่งประเทศไทยถนนสุวินทวงศ์",26,114,195,210,405
330,"โคกแฝด","เขตหนองจอก",100305,"โรงเรียนบ้านลำต้นกล้วย",27,265,301,343,644
331,"โคกแฝด","เขตหนองจอก",100305,"โรงเรียนบ้านลำต้นกล้วย",28,247,299,338,637
332,"โคกแฝด","เขตหนองจอก",100305,"โรงเรียนบ้านลำต้นกล้วย",29,224,300,328,628
333,"โคกแฝด","เขตหนองจอก",100305,"โรงเรียนบ้านลำต้นกล้วย",30,219,291,332,623
334,"โคกแฝด","เขตหนองจอก",100305,"โรงเรียนสุเหร่าอีรั้ว",31,190,288,310,598
335,"โคกแฝด","เขตหนองจอก",100305,"โรงเรียนสุเหร่าอีรั้ว",32,208,352,354,706
336,"โคกแฝด","เขตหนองจอก",100305,"ศูนย์พัฒนาเด็กก่อนวัยเรียนเนี๊ยะม่าตุ้ลมักบูลีน (แบนใหญ่)",33,239,456,464,920
337,"โคกแฝด","เขตหนองจอก",100305,"โรงเรียนสุเหร่านาตับ",34,151,314,299,613
338,"โคกแฝด","เขตหนองจอก",100305,"ศูนย์พัฒนาเด็กก่อนวัยเรียนชุมชนแผ่นดินทองนูรุ้ลเอี๊ยะซาน(ลำตาจีน)",35,147,275,255,530
339,"โคกแฝด","เขตหนองจอก",100305,"โรงเรียนอิสลามลำไทร",36,184,265,292,557
340,"โคกแฝด","เขตหนองจอก",100305,"โรงเรียนอิสลามลำไทร",37,254,294,288,582
341,"โคกแฝด","เขตหนองจอก",100305,"ศูนย์การเรียนรู้มหานคร สถาบันพัฒนาข้าราชารกรุงเทพมหานคร",38,159,283,249,532
342,"โคกแฝด","เขตหนองจอก",100305,"ศูนย์การเรียนรู้มหานคร สถาบันพัฒนาข้าราชารกรุงเทพมหานคร",39,185,267,297,564
343,"โคกแฝด","เขตหนองจอก",100305,"โรงเรียนบ้านเจียรดับ",40,236,318,325,643
344,"โคกแฝด","เขตหนองจอก",100305,"โรงเรียนบ้านเจียรดับ",41,245,318,331,649
345,"โคกแฝด","เขตหนองจอก",100305,"โรงเรียนบ้านเจียรดับ",42,273,292,362,654
346,"โคกแฝด","เขตหนองจอก",100305,"โรงเรียนบ้านเจียรดับ",43,312,311,382,693
347,"คู้ฝั่งเหนือ","เขตหนองจอก",100306,"อาคารอเนกประสงค์ชุมชนหมู่ 2 คู้ฝั่งเหนือ (สื่อสันติ)ซอยมิตรไมตรี 16",1,152,265,309,574
348,"คู้ฝั่งเหนือ","เขตหนองจอก",100306,"เต็นท์บริเวณศูนย์พัฒนาเด็กก่อนวัยเรียนหมู่ 2 คู้ฝั่งเหนือ สื่อสันติ ซอยมิตรไมตรี 16",2,118,279,298,577
349,"คู้ฝั่งเหนือ","เขตหนองจอก",100306,"เต็นท์บริเวณศูนย์พัฒนาเด็กก่อนวัยเรียนหมู่ 2 คู้ฝั่งเหนือสื่อสันติ ซอยมิตรไมตรี 16",3,205,250,306,556
350,"คู้ฝั่งเหนือ","เขตหนองจอก",100306,"เต็นท์บริเวณปากซอยมิตรไมตรี 24",4,203,308,346,654
351,"คู้ฝั่งเหนือ","เขตหนองจอก",100306,"เต็นท์บริเวณปากซอยมิตรไมตรี 24",5,210,311,358,669
352,"คู้ฝั่งเหนือ","เขตหนองจอก",100306,"เต็นท์บริเวณปากซอยมิตรไมตรี 24",6,295,278,391,669
353,"คู้ฝั่งเหนือ","เขตหนองจอก",100306,"เต็นท์บริเวณปากซอยมิตรไมตรี 24",7,193,315,347,662
354,"คู้ฝั่งเหนือ","เขตหนองจอก",100306,"เต็นท์บริเวณปากซอยมิตรไมตรี 24",8,163,307,364,671
355,"คู้ฝั่งเหนือ","เขตหนองจอก",100306,"อาคารอเนกประสงค์ บริเวณมัสยิดดารุ้ลนาอีม (แบนชะโด)",9,132,298,279,577
356,"คู้ฝั่งเหนือ","เขตหนองจอก",100306,"โรงเรียนลำเจดีย์",10,200,405,427,832
357,"คู้ฝั่งเหนือ","เขตหนองจอก",100306,"โรงเรียนวัดสามง่าม",11,173,286,285,571
358,"คู้ฝั่งเหนือ","เขตหนองจอก",100306,"โรงเรียนวัดสามง่าม",12,202,275,303,578
359,"คู้ฝั่งเหนือ","เขตหนองจอก",100306,"โรงเรียนวัดสามง่าม",13,204,276,308,584
360,"คู้ฝั่งเหนือ","เขตหนองจอก",100306,"โรงเรียนวัดสามง่าม",14,217,274,308,582
361,"คู้ฝั่งเหนือ","เขตหนองจอก",100306,"โรงเรียนวัดสามง่าม",15,200,279,307,586
362,"คู้ฝั่งเหนือ","เขตหนองจอก",100306,"โรงเรียนวัดสามง่าม",16,219,279,282,561
363,"คู้ฝั่งเหนือ","เขตหนองจอก",100306,"เต็นท์บริเวณชุมชนแผ่นดินทองบาหยัน 2 ซอยมิตรไมตรี 12",17,144,273,291,564
364,"คู้ฝั่งเหนือ","เขตหนองจอก",100306,"เต็นท์บริเวณชุมชนแผ่นดินทองบาหยัน 2 ซอยมิตรไมตรี 12",18,224,260,321,581
365,"คู้ฝั่งเหนือ","เขตหนองจอก",100306,"เต็นท์บริเวณแฟลตการเคหะ ฯ โครงการหนองจอก ถนนมิตรไมตรี",19,201,287,318,605
366,"คู้ฝั่งเหนือ","เขตหนองจอก",100306,"เต็นท์บริเวณแฟลตการเคหะ ฯ โครงการหนองจอก ถนนมิตรไมตรี",20,214,316,308,624
367,"คู้ฝั่งเหนือ","เขตหนองจอก",100306,"เต็นท์บริเวณแฟลตการเคหะ ฯ โครงการหนองจอก ถนนมิตรไมตรี",21,253,310,326,636
368,"คู้ฝั่งเหนือ","เขตหนองจอก",100306,"เต็นท์บริเวณแฟลตการเคหะ ฯ โครงการหนองจอก ถนนมิตรไมตรี",22,259,280,330,610
369,"ลำผักชี","เขตหนองจอก",100307,"โรงเรียนอิสลามศาสนศึกษา บริเวณมัสยิดดารุ้นนาซีฮะห์ (ลำแขก)",1,216,304,339,643
370,"ลำผักชี","เขตหนองจอก",100307,"โรงเรียนอิสลามศาสนศึกษา บริเวณมัสยิดดารุ้นนาซีฮะห์ (ลำแขก)",2,197,317,322,639
371,"ลำผักชี","เขตหนองจอก",100307,"เต็นท์บริเวณโรงเรียนอิสลามศาสนศึกษา บริเวณมัสยิดดารุ้นนาซีฮะห์ (ลำแขก)",3,297,293,349,642
372,"ลำผักชี","เขตหนองจอก",100307,"โรงเรียนสุเหร่าลำแขก",4,168,306,321,627
373,"ลำผักชี","เขตหนองจอก",100307,"เต็นท์บริเวณด้านหน้า บริษัทชัยเจริญไมตรี จำกัด ปากซอยสุวินทวงศ์  35",5,177,258,273,531
374,"ลำผักชี","เขตหนองจอก",100307,"เต็นท์บริเวณศูนย์บริการสาธารณสุข 44 ลำผักชี ถนนสุวินทวงศ์",6,243,389,397,786
375,"ลำผักชี","เขตหนองจอก",100307,"โรงเรียนศิริวังวิทยาคาร",7,203,312,363,675
376,"ลำผักชี","เขตหนองจอก",100307,"โรงเรียนศิริวังวิทยาคาร",8,250,313,361,674
377,"ลำผักชี","เขตหนองจอก",100307,"เต็นท์บริเวณโรงเรียนศิริวังวิทยาคาร",9,317,329,355,684
378,"ลำผักชี","เขตหนองจอก",100307,"เต็นท์บริเวณโรงเรียนศิริวังวิทยาคาร",10,303,304,366,670
379,"ลำผักชี","เขตหนองจอก",100307,"วัดลำผักชี",11,181,307,304,611
380,"ลำผักชี","เขตหนองจอก",100307,"เต็นท์บริเวณโรงเรียนสังฆประชานุสสรณ์",12,220,314,337,651
381,"ลำผักชี","เขตหนองจอก",100307,"เต็นท์บริเวณโรงเรียนสังฆประชานุสสรณ์",13,234,296,354,650
382,"ลำผักชี","เขตหนองจอก",100307,"เต็นท์บริเวณโรงเรียนสังฆประชานุสสรณ์",14,268,306,322,628
383,"ลำผักชี","เขตหนองจอก",100307,"เต็นท์บริเวณโรงเรียนสังฆประชานุสสรณ์",15,282,310,344,654
384,"ลำผักชี","เขตหนองจอก",100307,"ลานอเนกประสงค์ การเคหะฯ โครงการฉลองกรุง 1ถนนสังฆประชา",16,255,378,427,805
385,"ลำผักชี","เขตหนองจอก",100307,"ลานอเนกประสงค์ การเคหะฯ โครงการฉลองกรุง 1ถนนสังฆประชา",17,230,338,353,691
386,"ลำผักชี","เขตหนองจอก",100307,"ลานอเนกประสงค์ การเคหะฯ โครงการฉลองกรุง 1ถนนสังฆประชา",18,228,295,305,600
387,"ลำผักชี","เขตหนองจอก",100307,"ลานอเนกประสงค์ การเคหะฯ โครงการฉลองกรุง 1ถนนสังฆประชา",19,195,281,300,581
388,"ลำผักชี","เขตหนองจอก",100307,"ลานอเนกประสงค์ การเคหะฯ โครงการฉลองกรุง 1ถนนสังฆประชา",20,192,281,303,584
389,"ลำผักชี","เขตหนองจอก",100307,"ลานอเนกประสงค์ การเคหะฯ โครงการฉลองกรุง 1ถนนสังฆประชา",21,212,277,302,579
390,"ลำผักชี","เขตหนองจอก",100307,"โรงเรียนวัดอู่ตะเภา",22,282,299,332,631
391,"ลำผักชี","เขตหนองจอก",100307,"โรงเรียนวัดอู่ตะเภา",23,308,267,319,586
392,"ลำผักชี","เขตหนองจอก",100307,"เต็นท์บริเวณโรงเรียนวัดอู่ตะเภา",24,242,364,346,710
393,"ลำผักชี","เขตหนองจอก",100307,"เต็นท์บริเวณสนามบาสเก็ตบอลข้างอาคารสโมสรหมู่บ้านโรยัลปาร์ควิลล์ ถนนสุวินวงศ์",25,253,264,322,586
394,"ลำผักชี","เขตหนองจอก",100307,"เต็นท์บริเวณสนามบาสเก็ตบอลข้างอาคารสโมสรหมู่บ้านโรยัลปาร์ควิลล์ ถนนสุวินทวงศ์",26,290,295,403,698
395,"ลำผักชี","เขตหนองจอก",100307,"เต็นท์บริเวณสนามบาสเก็ตบอลข้างอาคารสโมสรหมู่บ้านโรยัลปาร์ควิลล์ ถนนสุวินทวงศ์",27,297,281,361,642
396,"ลำผักชี","เขตหนองจอก",100307,"เต็นท์บริเวณทางเข้าหมู่บ้านโรยัลปาร์ควิลล์ ถนนสุวินทวงศ์",28,218,312,331,643
397,"ลำผักชี","เขตหนองจอก",100307,"เต็นท์บริเวณทางเข้าหมู่บ้านโรยัลปาร์ควิลล์ ถนนสุวินทวงศ์",29,276,344,366,710
398,"ลำผักชี","เขตหนองจอก",100307,"เต็นท์บริเวณทางเข้าหมู่บ้านโรยัลปาร์ควิลล์ ถนนสุวินทวงศ์",30,288,370,382,752
399,"ลำผักชี","เขตหนองจอก",100307,"เต็นท์บริเวณทางเข้าหมู่บ้าน ณ ราธร ถนนสุวินทวงศ์",31,277,263,329,592
400,"ลำผักชี","เขตหนองจอก",100307,"เต็นท์บริเวณทางเข้าหมู่บ้าน ณ ราธร ถนนสุวินทวงศ์",32,238,242,290,532
401,"ลำผักชี","เขตหนองจอก",100307,"เต็นท์บริเวณสโมสรหมู่บ้านฟลอราวิลล์ ถนนสุวินทวงศ์",33,324,349,421,770
402,"ลำผักชี","เขตหนองจอก",100307,"เต็นท์บริเวณสโมสรหมู่บ้านฟลอราวิลล์ ถนนสุวินทวงศ์",34,336,332,410,742
403,"ลำผักชี","เขตหนองจอก",100307,"เต็นท์บริเวณสโมสรหมู่บ้านฟลอราวิลล์ ถนนสุวินทวงศ์",35,331,360,403,763
404,"ลำผักชี","เขตหนองจอก",100307,"เต็นท์บริเวณสโมสรหมู่บ้านฟลอราวิลล์ ถนนสุวินทวงศ์",36,456,406,482,888
405,"ลำผักชี","เขตหนองจอก",100307,"เต็นท์บริเวณสโมสรหมู่บ้านฟลอราวิลล์ ถนนสุวินทวงศ์",37,411,355,368,723
406,"ลำผักชี","เขตหนองจอก",100307,"เต็นท์บริเวณสโมสรหมู่บ้านฟลอราวิลล์ ถนนสุวินทวงศ์",38,318,341,383,724
407,"ลำต้อยติ่ง","เขตหนองจอก",100308,"โรงเรียนสอนศาสนามัสยิดนูรูลลอห์ (ลำโขล่)",1,271,435,453,888
408,"ลำต้อยติ่ง","เขตหนองจอก",100308,"โรงเรียนคลองสอง",2,160,271,263,534
409,"ลำต้อยติ่ง","เขตหนองจอก",100308,"โรงเรียนคลองสอง",3,199,239,285,524
410,"ลำต้อยติ่ง","เขตหนองจอก",100308,"โรงเรียนคารีอุปถัมภ์",4,285,457,458,915
411,"ลำต้อยติ่ง","เขตหนองจอก",100308,"เต็นท์บริเวณศูนย์พัฒนาเด็กก่อนวัยเรียนมูลนิธิสันติสุข",5,159,247,250,497
412,"ลำต้อยติ่ง","เขตหนองจอก",100308,"เต็นท์บริเวณศูนย์พัฒนาเด็กก่อนวัยเรียนมูลนิธิสันติสุข",6,180,226,267,493
413,"ลำต้อยติ่ง","เขตหนองจอก",100308,"โรงเรียนวัดใหม่กระทุ่มล้ม",7,166,277,292,569
414,"ลำต้อยติ่ง","เขตหนองจอก",100308,"โรงเรียนวัดใหม่กระทุ่มล้ม",8,246,280,297,577
415,"ลำต้อยติ่ง","เขตหนองจอก",100308,"โรงเรียนวัดใหม่กระทุ่มล้ม",9,199,275,298,573
416,"ลำต้อยติ่ง","เขตหนองจอก",100308,"โรงเรียนวัดลำต้อยติ่ง",10,178,318,341,659
417,"ลำต้อยติ่ง","เขตหนองจอก",100308,"โรงเรียนวัดลำต้อยติ่ง",11,254,333,362,695
418,"ลำต้อยติ่ง","เขตหนองจอก",100308,"โรงเรียนวัดลำต้อยติ่ง",12,169,296,298,594
419,"มหาพฤฒาราม","เขตบางรัก",100401,"เต้นท์หน้าอาคารคริสตจักรที่สองสามย่าน ถนนพระรามที่ 4",1,524,286,421,707
420,"มหาพฤฒาราม","เขตบางรัก",100401,"เต้นท์หน้าอาคารคริสตจักรที่สองสามย่าน ถนนพระรามที่ 4",2,131,187,230,417
421,"มหาพฤฒาราม","เขตบางรัก",100401,"เต้นท์บริเวณลานกีฬาตรอกห้านาย ถนนพระรามที่ 4",3,152,191,217,408
422,"มหาพฤฒาราม","เขตบางรัก",100401,"เต้นท์บริเวณลานกีฬาตรอกห้านาย ถนนพระรามที่ 4",4,159,214,324,538
423,"มหาพฤฒาราม","เขตบางรัก",100401,"โรงเรียนเยนเฮล์เม็มโมเรียล ถนนสว่าง",5,155,243,289,532
424,"มหาพฤฒาราม","เขตบางรัก",100401,"โรงเรียนเยนเฮล์เม็มโมเรียล ถนนสว่าง",6,125,210,242,452
425,"มหาพฤฒาราม","เขตบางรัก",100401,"โรงเรียนสตรีวัดมหาพฤฒาราม ถนนมหาพฤฒาราม",7,233,327,364,691
426,"มหาพฤฒาราม","เขตบางรัก",100401,"วัดมหาพฤฒาราม บริเวณศาลาปั้นเขียน ถนนสี่พระยา",8,114,160,182,342
427,"มหาพฤฒาราม","เขตบางรัก",100401,"วัดมหาพฤฒาราม บริเวณศาลาปั้นเขียน ถนนสี่พระยา",9,122,216,249,465
428,"มหาพฤฒาราม","เขตบางรัก",100401,"โรงเรียนวัดแก้วแจ่มฟ้า ถนนสี่พระยา",10,165,257,324,581
429,"มหาพฤฒาราม","เขตบางรัก",100401,"โรงเรียนวัดแก้วแจ่มฟ้า ถนนสี่พระยา",11,455,415,516,931
430,"มหาพฤฒาราม","เขตบางรัก",100401,"โรงเรียนวัดแก้วแจ่มฟ้า ถนนสี่พระยา",12,147,223,279,502
431,"มหาพฤฒาราม","เขตบางรัก",100401,"ที่จอดรถธนาคารกรุงเทพจำกัด(มหาชน) สาขาสะพานเหลือง ถนนพระรามที่ 4",13,144,183,279,462
432,"มหาพฤฒาราม","เขตบางรัก",100401,"ที่จอดรถธนาคารกรุงเทพจำกัด(มหาชน) สาขาสะพานเหลืองถนนพระรามที่ 4",14,140,209,273,482
433,"มหาพฤฒาราม","เขตบางรัก",100401,"ที่จอดรถธนาคารกรุงเทพจำกัด(มหาชน) สาขาสะพานเหลืองถนนพระรามที่ 4",15,182,306,356,662
434,"มหาพฤฒาราม","เขตบางรัก",100401,"ที่จอดรถธนาคารกรุงเทพจำกัด(มหาชน) สาขาสะพานเหลืองถนนพระรามที่ 4",16,128,183,224,407
435,"สีลม","เขตบางรัก",100402,"เต้นท์บริเวณลานจอดรถธนาคารกสิกรไทย จำกัด สาขาถนนสาทรเหนือ",1,211,213,263,476
436,"สีลม","เขตบางรัก",100402,"โรงเรียนเซนต์โยเซฟคอนแวนต์ ถนนคอนแวนต์",2,275,217,396,613
437,"สีลม","เขตบางรัก",100402,"โรงเรียนเซนต์โยเซฟคอนแวนต์ ถนนคอนแวนต์",3,296,280,393,673
438,"สีลม","เขตบางรัก",100402,"เต้นท์หน้าธนาคารกรุงเทพ จำกัด สำนักงานใหญ่ ถนนสีลม",4,126,254,312,566
439,"สีลม","เขตบางรัก",100402,"บริเวณที่จอดรถกองบังคับการตำรวจนครบาล 5 ถนนสาทรเหนือ",5,324,269,349,618
440,"สีลม","เขตบางรัก",100402,"โรงเรียนกว่างเจ้า ถนนสีลม",6,357,276,359,635
441,"สีลม","เขตบางรัก",100402,"โรงเรียนกว่างเจ้า ถนนสีลม",7,506,388,539,927
442,"สีลม","เขตบางรัก",100402,"โรงเรียนสัจจพิทยา ถนนสาทรเหนือ",8,140,202,263,465
443,"สีลม","เขตบางรัก",100402,"โรงเรียนสัจจพิทยา ถนนสาทรเหนือ",9,394,360,481,841
444,"สีลม","เขตบางรัก",100402,"ที่จอดรถอาคารบริษัท บริหารสินทรัพย์ กรุงเทพพาณิชย์ จำกัด (บสก.) ถนนสุรศักดิ์",10,154,257,300,557
445,"สีลม","เขตบางรัก",100402,"ที่จอดรถอาคารบริษัท บริหารสินทรัพย์ กรุงเทพพาณิชย์ จำกัด(บสก.) ถนนสุรศักดิ์",11,306,270,316,586
446,"สีลม","เขตบางรัก",100402,"โรงเรียนกรุงเทพคริสเตียนวิทยาลัย ถนนประมวญ",12,453,400,492,892
447,"สีลม","เขตบางรัก",100402,"โรงเรียนกรุงเทพคริสเตียนวิทยาลัย ถนนประมวญ",13,280,224,299,523
448,"สุริยวงศ์","เขตบางรัก",100403,"โรงพยาบาลกรุงเทพคริสเตียน ถนนสุรวงศ์",1,341,301,403,704
449,"สุริยวงศ์","เขตบางรัก",100403,"โรงพยาบาลกรุงเทพคริสเตียน ถนนสุรวงศ์",2,448,381,457,838
450,"สุริยวงศ์","เขตบางรัก",100403,"เต้นท์หน้าบริษัท เอไอเอ ถนนสุรวงศ์ ตัดแยกเดโช",3,232,272,354,626
451,"สุริยวงศ์","เขตบางรัก",100403,"เต้นท์หน้าอาคาร บริษัท หวั่งหลี จำกัด ถนนมเหสักข์",4,192,227,288,515
452,"สุริยวงศ์","เขตบางรัก",100403,"โรงเรียนมัธยมปัญญารัตน์ (มหาวิทยาลัยรัตนบัณฑิตเดิม) ถนนสีลม",5,152,202,235,437
453,"บางรัก","เขตบางรัก",100404,"โรงเรียนวัดม่วงแค ถนนเจริญกรุง",1,107,226,233,459
454,"บางรัก","เขตบางรัก",100404,"โรงเรียนวัดม่วงแค ถนนเจริญกรุง",2,85,132,143,275
455,"บางรัก","เขตบางรัก",100404,"โรงเรียนวัดม่วงแค ถนนเจริญกรุง",3,193,186,239,425
456,"บางรัก","เขตบางรัก",100404,"โรงเรียนวัดสวนพลู ถนนเจริญกรุง",4,114,166,216,382
457,"บางรัก","เขตบางรัก",100404,"โรงเรียนวัดสวนพลู ถนนเจริญกรุง",5,165,255,271,526
458,"สี่พระยา","เขตบางรัก",100405,"โรงเรียนวัดหัวลำโพง ถนนพระรามที่ 4",1,67,144,167,311
459,"สี่พระยา","เขตบางรัก",100405,"โรงเรียนวัดหัวลำโพง ถนนพระรามที่ 4",2,556,360,442,802
460,"สี่พระยา","เขตบางรัก",100405,"บริเวณที่จอดรถบริษัท ซีคอน จำกัด ถนนสี่พระยา",3,219,268,370,638
461,"สี่พระยา","เขตบางรัก",100405,"บริเวณที่จอดรถบริษัท ซีคอน จำกัด ถนนสี่พระยา",4,136,189,220,409
462,"สี่พระยา","เขตบางรัก",100405,"บริเวณที่จอดรถบริษัท ซีคอน จำกัด ถนนสี่พระยา",5,318,312,418,730
463,"สี่พระยา","เขตบางรัก",100405,"เต้นท์หน้าอาคารจูเวลเลอรี่เซ็นเตอร์ ถนนนเรศ",6,310,264,353,617
464,"สี่พระยา","เขตบางรัก",100405,"เต้นท์หน้าอาคารจูเวลเลอรี่เซ็นเตอร์ ถนนนเรศ",7,194,270,261,531
465,"สี่พระยา","เขตบางรัก",100405,"เต้นท์หน้าอาคารจูเวลเลอรี่เซ็นเตอร์ ถนนนเรศ",8,103,146,178,324
466,"สี่พระยา","เขตบางรัก",100405,"บริเวณที่จอดรถศูนย์บริการสาธารณสุข 23 สี่พระยา ถนนสี่พระยา",9,148,171,247,418
467,"สี่พระยา","เขตบางรัก",100405,"บริเวณที่จอดรถศูนย์บริการสาธารณสุข 23 สี่พระยา ถนนสี่พระยา",10,147,208,302,510
468,"สี่พระยา","เขตบางรัก",100405,"บริเวณที่จอดรถศูนย์บริการสาธารณสุข 23 สี่พระยา ถนนสี่พระยา",11,215,279,425,704
469,"สี่พระยา","เขตบางรัก",100405,"บริเวณที่จอดรถ ศาลเจ้าซิดเซียม้า ถนนเจริญกรุง",12,122,182,221,403
470,"สี่พระยา","เขตบางรัก",100405,"บริเวณที่จอดรถ ศาลเจ้าซิดเซียม้า ถนนเจริญกรุง",13,165,198,291,489
471,"สี่พระยา","เขตบางรัก",100405,"บริเวณที่จอดรถ ศาลเจ้าซิดเซียม้า ถนนเจริญกรุง",14,181,240,327,567
472,"สี่พระยา","เขตบางรัก",100405,"โรงเรียนยุหมินพัฒนา ถนนสุรวงศ์",15,165,221,263,484
473,"อนุสาวรีย์","เขตบางเขน",100502,"ศูนย์สร้างสุขทุกวัยบางเขน ถนนพหลโยธิน(ด้านข้างสำนักงานเขตบางเขน)",1,151,291,260,551
474,"อนุสาวรีย์","เขตบางเขน",100502,"ศูนย์สร้างสุขทุกวัยบางเขน ถนนพหลโยธิน(ด้านข้างสำนักงานเขตบางเขน)",2,227,469,86,555
475,"อนุสาวรีย์","เขตบางเขน",100502,"วัดบางบัว (ซอยพหลโยธิน 46)",3,245,265,196,461
476,"อนุสาวรีย์","เขตบางเขน",100502,"วัดบางบัว (ซอยพหลโยธิน 46)",4,210,261,194,455
477,"อนุสาวรีย์","เขตบางเขน",100502,"เต็นท์บริเวณลานจอดรถฌาปนสถานกองทัพอากาศ(วัดพระศรีมหาธาตุฯ)",5,394,383,316,699
478,"อนุสาวรีย์","เขตบางเขน",100502,"เต็นท์บริเวณลานจอดรถฌาปนสถานกองทัพอากาศ(วัดพระศรีมหาธาตุฯ)",6,313,415,300,715
479,"อนุสาวรีย์","เขตบางเขน",100502,"เต็นท์บริเวณลานจอดรถฌาปนสถานกองทัพอากาศ(วัดพระศรีมหาธาตุฯ)",7,244,338,382,720
480,"อนุสาวรีย์","เขตบางเขน",100502,"เต็นท์บริเวณลานจอดรถฌาปนสถานกองทัพอากาศ(วัดพระศรีมหาธาตุฯ)",8,173,345,366,711
481,"อนุสาวรีย์","เขตบางเขน",100502,"เต็นท์บริเวณลานจอดรถฌาปนสถานกองทัพอากาศ(วัดพระศรีมหาธาตุฯ)",9,192,340,380,720
482,"อนุสาวรีย์","เขตบางเขน",100502,"เต็นท์บริเวณลานจอดรถฌาปนสถานกองทัพอากาศ(วัดพระศรีมหาธาตุฯ)",10,228,368,374,742
483,"อนุสาวรีย์","เขตบางเขน",100502,"เต็นท์บริเวณลานจอดรถฌาปนสถานกองทัพอากาศ(วัดพระศรีมหาธาตุฯ)",11,279,327,401,728
484,"อนุสาวรีย์","เขตบางเขน",100502,"เต็นท์บริเวณลานจอดรถฌาปนสถานกองทัพอากาศ(วัดพระศรีมหาธาตุฯ)",12,249,314,390,704
485,"อนุสาวรีย์","เขตบางเขน",100502,"เต็นท์บริเวณหน้าสำนักงานบริษัท อิออน จำกัด (แม็กซ์แวลู)ถนนแจ้งวัฒนะ",13,500,253,380,633
486,"อนุสาวรีย์","เขตบางเขน",100502,"เต็นท์บริเวณหน้าสำนักงานบริษัท อิออน จำกัด (แม็กซ์แวลู)ถนนแจ้งวัฒนะ",14,456,282,371,653
487,"อนุสาวรีย์","เขตบางเขน",100502,"เต็นท์บริเวณหน้าสำนักงานบริษัท อิออน จำกัด (แม็กซ์แวลู)ถนนแจ้งวัฒนะ",15,245,268,383,651
488,"อนุสาวรีย์","เขตบางเขน",100502,"เต็นท์บริเวณลานจอดรถแฟมิลี่มาร์ท (ซอยพหลโยธิน 57)",16,521,284,427,711
489,"อนุสาวรีย์","เขตบางเขน",100502,"เต็นท์บริเวณลานจอดรถแฟมิลี่มาร์ท (ซอยพหลโยธิน 57)",17,252,313,363,676
490,"อนุสาวรีย์","เขตบางเขน",100502,"เต็นท์บริเวณลานจอดรถด้านหน้ามูลนิธิโพธิภาวนาสงเคราะห์สะพานใหม่ ถนนพหลโยธิน",18,337,324,432,756
491,"อนุสาวรีย์","เขตบางเขน",100502,"เต็นท์บริเวณลานจอดรถด้านหน้ามูลนิธิโพธิภาวนาสงเคราะห์สะพานใหม่ ถนนพหลโยธิน",19,329,312,445,757
492,"อนุสาวรีย์","เขตบางเขน",100502,"เต็นท์บริเวณลานจอดรถด้านหน้ามูลนิธิโพธิภาวนาสงเคราะห์สะพานใหม่ ถนนพหลโยธิน",20,299,301,459,760
493,"อนุสาวรีย์","เขตบางเขน",100502,"เต็นท์บริเวณลานจอดรถด้านหน้ามูลนิธิโพธิภาวนาสงเคราะห์สะพานใหม่ ถนนพหลโยธิน",21,341,323,428,751
494,"อนุสาวรีย์","เขตบางเขน",100502,"เต็นท์บริเวณลานจอดรถด้านหน้ามูลนิธิโพธิภาวนาสงเคราะห์สะพานใหม่ ถนนพหลโยธิน",22,279,341,424,765
495,"อนุสาวรีย์","เขตบางเขน",100502,"เต็นท์บริเวณลานจอดรถด้านหน้ามูลนิธิโพธิภาวนาสงเคราะห์สะพานใหม่ ถนนพหลโยธิน",23,531,254,498,752
496,"อนุสาวรีย์","เขตบางเขน",100502,"เต็นท์บริเวณลานจอดรถด้านหน้ามูลนิธิโพธิภาวนาสงเคราะห์สะพานใหม่ ถนนพหลโยธิน",24,482,313,432,745
497,"อนุสาวรีย์","เขตบางเขน",100502,"เต็นท์บริเวณลานจอดรถด้านหน้ามูลนิธิโพธิภาวนาสงเคราะห์สะพานใหม่ ถนนพหลโยธิน",25,322,329,414,743
498,"อนุสาวรีย์","เขตบางเขน",100502,"เต็นท์บริเวณลานจอดรถด้านหน้ามูลนิธิโพธิภาวนาสงเคราะห์สะพานใหม่ ถนนพหลโยธิน",26,248,342,419,761
499,"อนุสาวรีย์","เขตบางเขน",100502,"เต็นท์บริเวณลานจอดรถด้านหน้ามูลนิธิโพธิภาวนาสงเคราะห์สะพานใหม่ ถนนพหลโยธิน",27,226,366,401,767
500,"อนุสาวรีย์","เขตบางเขน",100502,"เต็นท์บริเวณลานจอดรถด้านหน้ามูลนิธิโพธิภาวนาสงเคราะห์สะพานใหม่ ถนนพหลโยธิน",28,224,351,417,768
501,"อนุสาวรีย์","เขตบางเขน",100502,"เต็นท์บริเวณลานจอดรถด้านหน้ามูลนิธิโพธิภาวนาสงเคราะห์สะพานใหม่ ถนนพหลโยธิน",29,277,370,396,766
502,"อนุสาวรีย์","เขตบางเขน",100502,"เต็นท์บริเวณลานจอดรถด้านหน้ามูลนิธิโพธิภาวนาสงเคราะห์สะพานใหม่ ถนนพหลโยธิน",30,369,331,429,760
503,"อนุสาวรีย์","เขตบางเขน",100502,"อาคารอเนกประสงค์หมู่บ้านอยู่เจริญ (ซอยพหลโยธิน 50)",31,270,286,403,689
504,"อนุสาวรีย์","เขตบางเขน",100502,"เต็นท์บริเวณทางเท้าหน้าโรงเรียนนิเวศน์วารินทร์(ซอยเทพรักษ์ 10)",32,196,239,276,515
505,"อนุสาวรีย์","เขตบางเขน",100502,"เต็นท์บริเวณทางเท้าหน้าโรงเรียนนิเวศน์วารินทร์(ซอยเทพรักษ์ 10)",33,180,228,292,520
506,"อนุสาวรีย์","เขตบางเขน",100502,"เต็นท์บริเวณทางเท้าหน้าโรงเรียนนิเวศน์วารินทร์(ซอยเทพรักษ์ 10)",34,175,237,279,516
507,"อนุสาวรีย์","เขตบางเขน",100502,"เต็นท์บริเวณทางเท้าหน้าโรงเรียนนิเวศน์วารินทร์(ซอยเทพรักษ์ 10)",35,337,234,293,527
508,"อนุสาวรีย์","เขตบางเขน",100502,"อาคารอเนกประสงค์ชุมชนหมู่บ้านสินทรัพย์นคร (ซอยเทพรักษ์ 20)",36,224,253,326,579
509,"อนุสาวรีย์","เขตบางเขน",100502,"อาคารอเนกประสงค์ชุมชนหมู่บ้านสินทรัพย์นคร (ซอยเทพรักษ์ 20)",37,228,254,325,579
510,"อนุสาวรีย์","เขตบางเขน",100502,"เต็นท์บริเวณลานอเนกประสงค์ชุมชนหมู่บ้านสินทรัพย์นคร(ซอยเทพรักษ์ 20)",38,230,247,328,575
511,"อนุสาวรีย์","เขตบางเขน",100502,"บริเวณใต้อาคารแฟลต 258 ศรภ. (ตรงข้ามธนาคารกรุงไทยสาขาสะพานใหม่)",39,438,323,358,681
512,"อนุสาวรีย์","เขตบางเขน",100502,"บริเวณใต้อาคารแฟลต 258 ศรภ. (ตรงข้ามธนาคารกรุงไทยสาขาสะพานใหม่)",40,237,302,378,680
513,"อนุสาวรีย์","เขตบางเขน",100502,"อาคารอเนกประสงค์ชุมชนอยู่รวย (ซอยพหลโยธิน 48 แยก 2)",41,226,280,375,655
514,"อนุสาวรีย์","เขตบางเขน",100502,"อาคารอเนกประสงค์ชุมชนอยู่รวย (ซอยพหลโยธิน 48 แยก 2)",42,215,293,360,653
515,"อนุสาวรีย์","เขตบางเขน",100502,"เต็นท์บริเวณลานอเนกประสงค์หมู่บ้านเจษฎา 3(ซอยพหลโยธิน 48 แยก 20)",43,217,315,360,675
516,"อนุสาวรีย์","เขตบางเขน",100502,"เต็นท์บริเวณลานอเนกประสงค์หมู่บ้านเจษฎา 3(ซอยพหลโยธิน 48 แยก 20)",44,205,272,315,587
517,"อนุสาวรีย์","เขตบางเขน",100502,"เต็นท์บริเวณลานอเนกประสงค์หมู่บ้านเจษฎา 3(ซอยพหลโยธิน 48 แยก 20)",45,217,288,337,625
518,"อนุสาวรีย์","เขตบางเขน",100502,"เต็นท์บริเวณตลาดนัด เจ.ปาร์ค คอนโดบ้านสวนบางเขน(ซอยพหลโยธิน 48 แยก 17/1)",46,213,358,396,754
519,"อนุสาวรีย์","เขตบางเขน",100502,"เต็นท์บริเวณตลาดนัด เจ.ปาร์ค คอนโดบ้านสวนบางเขน(ซอยพหลโยธิน 48 แยก 17/1)",47,382,353,428,781
520,"อนุสาวรีย์","เขตบางเขน",100502,"เต็นท์บริเวณตลาดนัด เจ.ปาร์ค คอนโดบ้านสวนบางเขน(ซอยพหลโยธิน 48 แยก 17/1)",48,415,341,419,760
521,"อนุสาวรีย์","เขตบางเขน",100502,"เต็นท์บริเวณตลาดนัด เจ.ปาร์ค คอนโดบ้านสวนบางเขน(ซอยพหลโยธิน 48 แยก 17/1)",49,420,326,443,769
522,"อนุสาวรีย์","เขตบางเขน",100502,"เต็นท์บริเวณตลาดนัด เจ.ปาร์ค คอนโดบ้านสวนบางเขน(ซอยพหลโยธิน 48 แยก 17/1)",50,274,305,445,750
523,"อนุสาวรีย์","เขตบางเขน",100502,"เต็นท์บริเวณตลาดนัด เจ.ปาร์ค คอนโดบ้านสวนบางเขน(ซอยพหลโยธิน 48 แยก 17/1)",51,377,303,433,736
524,"อนุสาวรีย์","เขตบางเขน",100502,"เต็นท์บริเวณลานอเนกประสงค์ชุมชนร่วมพัฒนา 33(ซอยพหลโยธิน 48 แยก 21)",52,210,328,387,715
525,"อนุสาวรีย์","เขตบางเขน",100502,"เต็นท์บริเวณลานอเนกประสงค์ชุมชนร่วมพัฒนา 33(ซอยพหลโยธิน 48 แยก 21)",53,223,326,387,713
526,"อนุสาวรีย์","เขตบางเขน",100502,"เต็นท์บริเวณที่ว่างหน้าชุมชนหมู่บ้านไปรษณีย์นิเวศน์(ซอยพหลโยธิน 48 แยก 56)",54,212,302,352,654
527,"อนุสาวรีย์","เขตบางเขน",100502,"เต็นท์บริเวณที่ว่างหน้าชุมชนหมู่บ้านไปรษณีย์นิเวศน์(ซอยพหลโยธิน 48 แยก 56)",55,192,291,365,656
528,"อนุสาวรีย์","เขตบางเขน",100502,"โรงเรียนไทยนิยมสงเคราะห์ ถนนพหลโยธิน",56,202,211,300,511
529,"อนุสาวรีย์","เขตบางเขน",100502,"โรงเรียนไทยนิยมสงเคราะห์ ถนนพหลโยธิน",57,139,349,145,494
530,"อนุสาวรีย์","เขตบางเขน",100502,"โรงเรียนไทยนิยมสงเคราะห์ ถนนพหลโยธิน",58,226,262,211,473
531,"อนุสาวรีย์","เขตบางเขน",100502,"โรงเรียนไทยนิยมสงเคราะห์ ถนนพหลโยธิน",59,214,184,292,476
532,"อนุสาวรีย์","เขตบางเขน",100502,"โรงเรียนไทยนิยมสงเคราะห์ ถนนพหลโยธิน",60,195,349,149,498
533,"อนุสาวรีย์","เขตบางเขน",100502,"เต็นท์บริเวณลานตลาดนัดหมู่บ้านอัมรินทร์นิเวศน์ ถนนพหลโยธิน",61,239,310,318,628
534,"อนุสาวรีย์","เขตบางเขน",100502,"เต็นท์บริเวณลานตลาดนัดหมู่บ้านอัมรินทร์นิเวศน์ ถนนพหลโยธิน",62,276,270,353,623
535,"อนุสาวรีย์","เขตบางเขน",100502,"โรงเรียนปราโมชวิทยารามอินทรา ประตู 3(ซอยรามอินทรา 5 แยกแรกขวามือ)",63,548,239,444,683
536,"อนุสาวรีย์","เขตบางเขน",100502,"โรงเรียนปราโมชวิทยารามอินทรา ประตู 3(ซอยรามอินทรา 5 แยกแรกขวามือ)",64,574,249,448,697
537,"อนุสาวรีย์","เขตบางเขน",100502,"โรงเรียนปราโมชวิทยารามอินทรา ประตู 3(ซอยรามอินทรา 5 แยกแรกขวามือ)",65,266,300,389,689
538,"อนุสาวรีย์","เขตบางเขน",100502,"โรงเรียนปราโมชวิทยารามอินทรา ประตู 3(ซอยรามอินทรา 5 แยกแรกขวามือ)",66,245,313,395,708
539,"อนุสาวรีย์","เขตบางเขน",100502,"โรงเรียนปราโมชวิทยารามอินทรา ประตู 3(ซอยรามอินทรา 5 แยกแรกขวามือ)",67,290,327,400,727
540,"อนุสาวรีย์","เขตบางเขน",100502,"เต็นท์บริเวณริมบึงลานอเนกประสงค์หมู่บ้านเธียรสวน(ซอยรามอินทรา 5 แยก 3)",68,252,339,404,743
541,"อนุสาวรีย์","เขตบางเขน",100502,"เต็นท์บริเวณริมบึงลานอเนกประสงค์หมู่บ้านเธียรสวน(ซอยรามอินทรา 5 แยก 3)",69,248,331,411,742
542,"อนุสาวรีย์","เขตบางเขน",100502,"เต็นท์บริเวณสวนกีฬารามอินทรา (ซอยรามอินทรา 5)",70,340,341,417,758
543,"อนุสาวรีย์","เขตบางเขน",100502,"เต็นท์บริเวณโรงเรียนนานาชาติเกาหลีกรุงเทพ(ซอยรามอินทรา 13 แยก 4)",71,277,326,441,767
544,"อนุสาวรีย์","เขตบางเขน",100502,"เต็นท์บริเวณโรงเรียนนานาชาติเกาหลีกรุงเทพ(ซอยรามอินทรา 13 แยก 4)",72,261,337,429,766
545,"อนุสาวรีย์","เขตบางเขน",100502,"เต็นท์บริเวณโรงเรียนนานาชาติเกาหลีกรุงเทพ(ซอยรามอินทรา 13 แยก 4)",73,299,338,430,768
546,"อนุสาวรีย์","เขตบางเขน",100502,"เต็นท์หน้าอาคารกองกำกับการ 1 กองบังคับการตำรวจสันติบาล 2(ซอยรามอินทรา 21)",74,291,314,343,657
547,"อนุสาวรีย์","เขตบางเขน",100502,"เต็นท์หน้าอาคารกองกำกับการ 1 กองบังคับการตำรวจสันติบาล 2(ซอยรามอินทรา 21)",75,347,350,296,646
548,"อนุสาวรีย์","เขตบางเขน",100502,"เต็นท์หน้าอาคารกองกำกับการ 1 กองบังคับการตำรวจสันติบาล 2(ซอยรามอินทรา 21)",76,315,308,336,644
549,"อนุสาวรีย์","เขตบางเขน",100502,"เต็นท์หน้าอาคารกองกำกับการ 1 กองบังคับการตำรวจสันติบาล 2(ซอยรามอินทรา 21)",77,263,295,364,659
550,"อนุสาวรีย์","เขตบางเขน",100502,"อาคารอเนกประสงค์หมู่บ้านทหารผ่านศึก (ซอยรามอินทรา 25 )",78,290,262,319,581
551,"อนุสาวรีย์","เขตบางเขน",100502,"อาคารอเนกประสงค์หมู่บ้านทหารผ่านศึก (ซอยรามอินทรา 25)",79,197,245,330,575
552,"อนุสาวรีย์","เขตบางเขน",100502,"บริเวณใต้อาคารสงเคราะห์ข้าราชการกรุงเทพมหานคร (ซอยรามอินทรา 39)",80,240,293,383,676
553,"อนุสาวรีย์","เขตบางเขน",100502,"บริเวณใต้อาคารสงเคราะห์ข้าราชการกรุงเทพมหานคร(ซอยรามอินทรา 39)",81,288,332,356,688
554,"อนุสาวรีย์","เขตบางเขน",100502,"บริเวณใต้อาคารสงเคราะห์ข้าราชการกรุงเทพมหานคร(ซอยรามอินทรา 39)",82,245,302,383,685
555,"อนุสาวรีย์","เขตบางเขน",100502,"อาคารอเนกประสงค์ชุมชนหมู่บ้านพร้อมสุข(ซอยรามอินทรา 8 แยก 2)",83,284,340,417,757
556,"อนุสาวรีย์","เขตบางเขน",100502,"อาคารอเนกประสงค์ชุมชนหมู่บ้านพร้อมสุข (ซอยรามอินทรา 8 แยก 2)",84,243,323,433,756
557,"อนุสาวรีย์","เขตบางเขน",100502,"โรงเรียนวัดไตรรัตนาราม (ซอยรามอินทรา 8)",85,311,333,424,757
558,"อนุสาวรีย์","เขตบางเขน",100502,"โรงเรียนวัดไตรรัตนาราม (ซอยรามอินทรา 8)",86,289,323,418,741
559,"อนุสาวรีย์","เขตบางเขน",100502,"โรงเรียนวัดไตรรัตนาราม (ซอยรามอินทรา 8)",87,288,340,423,763
560,"อนุสาวรีย์","เขตบางเขน",100502,"โรงเรียนวัดไตรรัตนาราม (ซอยรามอินทรา 8)",88,312,322,411,733
561,"อนุสาวรีย์","เขตบางเขน",100502,"โรงเรียนวัดไตรรัตนาราม (ซอยรามอินทรา 8)",89,274,353,404,757
562,"อนุสาวรีย์","เขตบางเขน",100502,"โรงเรียนวัดไตรรัตนาราม (ซอยรามอินทรา 8)",90,226,309,346,655
563,"อนุสาวรีย์","เขตบางเขน",100502,"โรงเรียนวัดไตรรัตนาราม (ซอยรามอินทรา 8)",91,197,310,344,654
564,"อนุสาวรีย์","เขตบางเขน",100502,"เต็นท์บริเวณริมสระว่ายน้ำศูนย์การค้ารามอินทรา (ตลาดก.ม.2)",92,302,295,393,688
565,"อนุสาวรีย์","เขตบางเขน",100502,"เต็นท์บริเวณริมสระว่ายน้ำศูนย์การค้ารามอินทรา (ตลาดก.ม.2)",93,266,300,382,682
566,"อนุสาวรีย์","เขตบางเขน",100502,"เต็นท์บริเวณริมสระว่ายน้ำศูนย์การค้ารามอินทรา (ตลาดก.ม.2)",94,277,297,410,707
567,"อนุสาวรีย์","เขตบางเขน",100502,"เต็นท์บริเวณริมสระว่ายน้ำศูนย์การค้ารามอินทรา (ตลาดก.ม.2)",95,456,296,418,714
568,"อนุสาวรีย์","เขตบางเขน",100502,"เต็นท์บริเวณบ้านพักหน่วยบัญชาการทหารพัฒนา (ซอยลาดปลาเค้า 63)",96,260,275,231,506
569,"อนุสาวรีย์","เขตบางเขน",100502,"เต็นท์บริเวณตลาดลาดปลาเค้า 71 (หน้าสนามแบดมินตัน)",97,85,580,75,655
570,"อนุสาวรีย์","เขตบางเขน",100502,"เต็นท์บริเวณตลาดลาดปลาเค้า 71 (หน้าสนามแบดมินตัน)",98,221,310,282,592
571,"อนุสาวรีย์","เขตบางเขน",100502,"เต็นท์บริเวณภายในซอยลาดปลาเค้า 60",99,312,333,423,756
572,"อนุสาวรีย์","เขตบางเขน",100502,"เต็นท์บริเวณภายในซอยลาดปลาเค้า 60",100,384,323,437,760
573,"อนุสาวรีย์","เขตบางเขน",100502,"เต็นท์บริเวณภายในซอยลาดปลาเค้า 60",101,399,320,438,758
574,"อนุสาวรีย์","เขตบางเขน",100502,"เต็นท์บริเวณภายในซอยลาดปลาเค้า 60",102,354,368,398,766
575,"อนุสาวรีย์","เขตบางเขน",100502,"เต็นท์หน้าบ้านพักศูนย์รักษาความปลอดภัย (ซอยลาดปลาเค้า 68)",103,433,462,283,745
576,"อนุสาวรีย์","เขตบางเขน",100502,"เต็นท์หน้าบ้านพักศูนย์รักษาความปลอดภัย (ซอยลาดปลาเค้า 68)",104,463,447,282,729
577,"อนุสาวรีย์","เขตบางเขน",100502,"เต็นท์หน้าบ้านพักศูนย์รักษาความปลอดภัย (ซอยลาดปลาเค้า 68)",105,506,496,251,747
578,"อนุสาวรีย์","เขตบางเขน",100502,"อาคารอเนกประสงค์ชุมชนหมู่บ้านปั้นทอง 3  (ซอยลาดปลาเค้า 76 แยก 3-14)",106,245,279,389,668
579,"อนุสาวรีย์","เขตบางเขน",100502,"อาคารอเนกประสงค์ชุมชนหมู่บ้านปั้นทอง 3 (ซอยลาดปลาเค้า 76 แยก 3-14)",107,244,304,376,680
580,"ท่าแร้ง","เขตบางเขน",100508,"อาคารอเนกประสงค์ชุมชนหมู่บ้านเพชรสยาม ซอยเทพรักษ์ 49(ซอยรามอินทรา 5 แยก 47-3)",1,221,314,397,711
581,"ท่าแร้ง","เขตบางเขน",100508,"เต็นท์บริเวณลานกีฬาชุมชนหมู่บ้านเพชรสยาม ซอยเทพรักษ์ 49(ซอยรามอินทรา 5 แยก 47-3)",2,189,324,401,725
582,"ท่าแร้ง","เขตบางเขน",100508,"เต็นท์บริเวณลานกีฬาชุมชนหมู่บ้านเพชรสยาม ซอยเทพรักษ์ 49(ซอยรามอินทรา 5 แยก 47-3)",3,173,324,366,690
583,"ท่าแร้ง","เขตบางเขน",100508,"เต็นท์บริเวณลานกีฬาชุมชนหมู่บ้านเพชรสยาม ซอยเทพรักษ์ 49(ซอยรามอินทรา 5 แยก 47-3)",4,189,314,369,683
584,"ท่าแร้ง","เขตบางเขน",100508,"อาคารอเนกประสงค์ชุมชนหมู่บ้านอนันต์สุขสันต์ รุ่น 18-20ซอยเทพรักษ์ 49 (ซอยรามอินทรา 5 แยก 67)",5,167,295,344,639
585,"ท่าแร้ง","เขตบางเขน",100508,"อาคารอเนกประสงค์ชุมชนหมู่บ้านอนันต์สุขสันต์ รุ่น 18-20ซอยเทพรักษ์ 49 (ซอยรามอินทรา 5 แยก 67)",6,146,301,330,631
586,"ท่าแร้ง","เขตบางเขน",100508,"อาคารอเนกประสงค์ชุมชนหมู่บ้านอนันต์สุขสันต์ รุ่น 18-20ซอยเทพรักษ์ 49 (ซอยรามอินทรา 5 แยก 67)",7,166,303,336,639
587,"ท่าแร้ง","เขตบางเขน",100508,"เต็นท์บริเวณลานจอดรถร้านเซเว่นอีเลฟเว่น สาขารามอินทรา 21 ท้ายซอย",8,362,358,450,808
588,"ท่าแร้ง","เขตบางเขน",100508,"เต็นท์บริเวณลานจอดรถร้านเซเว่นอีเลฟเว่น สาขารามอินทรา 21 ท้ายซอย",9,302,342,437,779
589,"ท่าแร้ง","เขตบางเขน",100508,"บริเวณใต้อาคารแฟลตการเคหะรามอินทรา หลังที่ 2(ถนนรามอินทรา ก.ม.4)",10,281,280,389,669
590,"ท่าแร้ง","เขตบางเขน",100508,"บริเวณใต้อาคารแฟลตการเคหะรามอินทรา หลังที่ 2(ถนนรามอินทรา ก.ม.4)",11,278,265,364,629
591,"ท่าแร้ง","เขตบางเขน",100508,"บริเวณใต้อาคารแฟลตการเคหะรามอินทรา หลังที่ 3(ถนนรามอินทรา ก.ม.4)",12,210,293,358,651
592,"ท่าแร้ง","เขตบางเขน",100508,"บริเวณใต้อาคารแฟลตการเคหะรามอินทรา หลังที่ 3(ถนนรามอินทรา ก.ม.4)",13,206,264,334,598
593,"ท่าแร้ง","เขตบางเขน",100508,"เต็นท์บริเวณลานจอดรถบริษัท ซีเอส ออโต้แม็กซ์ (2555) จำกัด(ระหว่างปากซอยรามอินทรา 41-43)",14,223,250,315,565
594,"ท่าแร้ง","เขตบางเขน",100508,"เต็นท์บริเวณด้านหน้าอาคารสโมสรสมาคมหมู่บ้านสวัสดิการนายทหาร(ปากซอยรามอินทรา 57)",15,203,241,316,557
595,"ท่าแร้ง","เขตบางเขน",100508,"เต็นท์บริเวณด้านหน้าอาคารสโมสรสมาคมหมู่บ้านสวัสดิการนายทหาร(ปากซอยรามอินทรา 57)",16,224,259,319,578
596,"ท่าแร้ง","เขตบางเขน",100508,"เต็นท์บริเวณด้านหน้าอาคารสโมสรสมาคมหมู่บ้านสวัสดิการนายทหาร(ปากซอยรามอินทรา 57)",17,250,245,312,557
597,"ท่าแร้ง","เขตบางเขน",100508,"เต็นท์บริเวณลานจอดรถโลตัส โก เฟรซ (ซอยรามอินทรา 65)",18,270,240,313,553
598,"ท่าแร้ง","เขตบางเขน",100508,"เต็นท์บริเวณลานจอดรถโลตัส โก เฟรซ (ซอยรามอินทรา 65)",19,263,249,310,559
599,"ท่าแร้ง","เขตบางเขน",100508,"เต็นท์บริเวณโรงเรียนอนุบาลบ้านแสนรัก(ซอยรามอินทรา 65 แยก 2)",20,307,300,428,728
600,"ท่าแร้ง","เขตบางเขน",100508,"เต็นท์บริเวณโรงเรียนอนุบาลบ้านแสนรัก(ซอยรามอินทรา 65 แยก 2)",21,284,316,390,706
601,"ท่าแร้ง","เขตบางเขน",100508,"อาคารอเนกประสงค์ชุมชนหมู่บ้านไปรษณีย์(ซอยรามอินทรา 65 แยก 2-16)",22,234,302,357,659
602,"ท่าแร้ง","เขตบางเขน",100508,"อาคารอเนกประสงค์ชุมชนหมู่บ้านไปรษณีย์(ซอยรามอินทรา 65 แยก 2-16)",23,231,314,354,668
603,"ท่าแร้ง","เขตบางเขน",100508,"อาคารอเนกประสงค์ชุมชนหมู่บ้านไปรษณีย์(ซอยรามอินทรา 65 แยก 2-16)",24,192,300,365,665
604,"ท่าแร้ง","เขตบางเขน",100508,"อาคารอเนกประสงค์หมู่บ้านสุขใจวิลเลจ (ซอยรามอินทรา 65 แยก 4)",25,212,220,304,524
605,"ท่าแร้ง","เขตบางเขน",100508,"อาคารอเนกประสงค์หมู่บ้านสุขใจวิลเลจ (ซอยรามอินทรา 65 แยก 4)",26,208,224,298,522
606,"ท่าแร้ง","เขตบางเขน",100508,"เต็นท์บริเวณลานจอดรถตลาดศิริผล (ซอยรามอินทรา 67)",27,169,200,254,454
607,"ท่าแร้ง","เขตบางเขน",100508,"เต็นท์บริเวณลานจอดรถตลาดศิริผล (ซอยรามอินทรา 67)",28,176,191,257,448
608,"ท่าแร้ง","เขตบางเขน",100508,"เต็นท์บริเวณลานกีฬาอเนกประสงค์หมู่บ้านสวยริมบึง(ซอยรามอินทรา 67 แยก 12)",29,216,305,344,649
609,"ท่าแร้ง","เขตบางเขน",100508,"เต็นท์บริเวณลานกีฬาอเนกประสงค์หมู่บ้านสวยริมบึง(ซอยรามอินทรา 67 แยก 12)",30,232,280,372,652
610,"ท่าแร้ง","เขตบางเขน",100508,"เต็นท์บริเวณลานอเนกประสงค์ชุมชนเฉลิมสุขนิเวศน์ 9(ซอยรามอินทรา 14 แยก 10)",31,327,317,407,724
611,"ท่าแร้ง","เขตบางเขน",100508,"เต็นท์บริเวณลานอเนกประสงค์ชุมชนเฉลิมสุขนิเวศน์ 9(ซอยรามอินทรา 14 แยก 10)",32,260,298,388,686
612,"ท่าแร้ง","เขตบางเขน",100508,"เต็นท์บริเวณลานอเนกประสงค์ชุมชนเฉลิมสุขนิเวศน์ 9(ซอยรามอินทรา 14 แยก 10)",33,299,312,376,688
613,"ท่าแร้ง","เขตบางเขน",100508,"เต็นท์บริเวณลานอเนกประสงค์ชุมชนเฉลิมสุขนิเวศน์ 9(ซอยรามอินทรา 14 แยก 10)",34,227,292,364,656
614,"ท่าแร้ง","เขตบางเขน",100508,"เต็นท์บริเวณลานอเนกประสงค์ชุมชนเฉลิมสุขนิเวศน์ 9(ซอยรามอินทรา 14 แยก 10)",35,251,288,374,662
615,"ท่าแร้ง","เขตบางเขน",100508,"เต็นท์บริเวณลานอเนกประสงค์ชุมชนเฉลิมสุขนิเวศน์ 9(ซอยรามอินทรา 14 แยก 10)",36,264,305,380,685
616,"ท่าแร้ง","เขตบางเขน",100508,"เต็นท์บริเวณสมาคมหมู่บ้านสวัสดิการทหารบกพัฒนา(ซอยรามอินทรา 34 แยก 9)",37,229,301,374,675
617,"ท่าแร้ง","เขตบางเขน",100508,"เต็นท์บริเวณสมาคมหมู่บ้านสวัสดิการทหารบกพัฒนา(ซอยรามอินทรา 34 แยก 9)",38,270,303,376,679
618,"ท่าแร้ง","เขตบางเขน",100508,"เต็นท์บริเวณสมาคมหมู่บ้านสวัสดิการทหารบกพัฒนา(ซอยรามอินทรา 34 แยก 9)",39,336,303,364,667
619,"ท่าแร้ง","เขตบางเขน",100508,"เต็นท์บริเวณสมาคมหมู่บ้านสวัสดิการทหารบกพัฒนา(ซอยรามอินทรา 34 แยก 9)",40,247,308,373,681
620,"ท่าแร้ง","เขตบางเขน",100508,"เต็นท์บริเวณสมาคมหมู่บ้านสวัสดิการทหารบกพัฒนา(ซอยรามอินทรา 34 แยก 9)",41,269,287,378,665
621,"ท่าแร้ง","เขตบางเขน",100508,"เต็นท์บริเวณสมาคมหมู่บ้านสวัสดิการทหารบกพัฒนา(ซอยรามอินทรา 34 แยก 9)",42,276,288,381,669
622,"ท่าแร้ง","เขตบางเขน",100508,"เต็นท์บริเวณลานจอดรถซูเปอร์มาร์เก็ตโลตัส โก เฟรชถนนวัชรพล",43,310,148,300,448
623,"ท่าแร้ง","เขตบางเขน",100508,"เต็นท์บริเวณลานจอดรถซูเปอร์มาร์เก็ตโลตัส โก เฟรช ถนนวัชรพล",44,144,198,245,443
624,"ท่าแร้ง","เขตบางเขน",100508,"เต็นท์บริเวณสวนสุขภาพด้านหลังตลาดถนอมมิตร (ถนนวัชรพล)",45,382,273,380,653
625,"ท่าแร้ง","เขตบางเขน",100508,"เต็นท์บริเวณสวนสุขภาพด้านหลังตลาดถนอมมิตร (ถนนวัชรพล)",46,375,286,372,658
626,"ท่าแร้ง","เขตบางเขน",100508,"เต็นท์บริเวณสวนสุขภาพด้านหลังตลาดถนอมมิตร (ถนนวัชรพล)",47,388,364,278,642
627,"ท่าแร้ง","เขตบางเขน",100508,"เต็นท์บริเวณสวนสุขภาพด้านหลังตลาดถนอมมิตร (ถนนวัชรพล)",48,483,364,278,642
628,"ท่าแร้ง","เขตบางเขน",100508,"เต็นท์บริเวณสวนสุขภาพด้านหลังตลาดถนอมมิตร (ถนนวัชรพล)",49,410,299,356,655
629,"ท่าแร้ง","เขตบางเขน",100508,"โรงเรียนรัตนโกสินทร์สมโภชบางเขน (ถนนวัชรพล)",50,288,309,401,710
630,"ท่าแร้ง","เขตบางเขน",100508,"โรงเรียนรัตนโกสินทร์สมโภชบางเขน (ถนนวัชรพล)",51,340,344,422,766
631,"ท่าแร้ง","เขตบางเขน",100508,"โรงเรียนรัตนโกสินทร์สมโภชบางเขน (ถนนวัชรพล)",52,355,365,389,754
632,"ท่าแร้ง","เขตบางเขน",100508,"โรงเรียนรัตนโกสินทร์สมโภชบางเขน (ถนนวัชรพล)",53,347,343,422,765
633,"ท่าแร้ง","เขตบางเขน",100508,"เต็นท์บริเวณลานจอดรถร้านเซเว่นอีเลฟเว่น หน้าหมู่บ้านทิมาพร(ซอยสุขาภิบาล 5 ซอย 5)",54,263,314,378,692
634,"ท่าแร้ง","เขตบางเขน",100508,"เต็นท์บริเวณลานจอดรถร้านเซเว่นอีเลฟเว่น หน้าหมู่บ้านทิมาพร(ซอยสุขาภิบาล 5 ซอย 5)",55,278,301,407,708
635,"ท่าแร้ง","เขตบางเขน",100508,"เต็นท์บริเวณลานจอดรถร้านเซเว่นอีเลฟเว่น หน้าหมู่บ้านทิมาพร(ซอยสุขาภิบาล 5 ซอย 5)",56,308,338,423,761
636,"ท่าแร้ง","เขตบางเขน",100508,"เต็นท์บริเวณลานจอดรถร้านเซเว่นอีเลฟเว่น หน้าหมู่บ้านทิมาพร(ซอยสุขาภิบาล 5 ซอย 5)",57,291,333,415,748
637,"ท่าแร้ง","เขตบางเขน",100508,"เต็นท์บริเวณโรงจอดรถกองบินตำรวจ (ถนนสุขาภิบาล 5)",58,186,188,258,446
638,"ท่าแร้ง","เขตบางเขน",100508,"เต็นท์บริเวณโรงจอดรถกองบินตำรวจ (ถนนสุขาภิบาล 5)",59,197,273,216,489
639,"ท่าแร้ง","เขตบางเขน",100508,"ศาลาอเนกประสงค์หน้าสำนักงานหมู่บ้านชัยพฤกษ์ (ถนนสุขาภิบาล 5)",60,230,249,315,564
640,"ท่าแร้ง","เขตบางเขน",100508,"เต็นท์บริเวณหน้าสำนักงานหมู่บ้านชัยพฤกษ์ (ถนนสุขาภิบาล 5)",61,230,223,330,553
641,"ท่าแร้ง","เขตบางเขน",100508,"เต็นท์บริเวณหน้าสำนักงานหมู่บ้านชัยพฤกษ์(ถนนสุขาภิบาล 5 )",62,226,243,321,564
642,"ท่าแร้ง","เขตบางเขน",100508,"โรงเรียนบ้านคลองบัว (ถนนสุขาภิบาล 5)",63,277,367,421,788
643,"ท่าแร้ง","เขตบางเขน",100508,"โรงเรียนบ้านคลองบัว (ถนนสุขาภิบาล 5)",64,268,342,393,735
644,"ท่าแร้ง","เขตบางเขน",100508,"โรงเรียนบ้านคลองบัว (ถนนสุขาภิบาล 5)",65,318,313,428,741
645,"ท่าแร้ง","เขตบางเขน",100508,"โรงเรียนบ้านบัวมล (ซอยสุขาภิบาล 5 ซอย 24)",66,308,354,410,764
646,"ท่าแร้ง","เขตบางเขน",100508,"โรงเรียนบ้านบัวมล (ซอยสุขาภิบาล 5 ซอย 24)",67,342,342,425,767
647,"ท่าแร้ง","เขตบางเขน",100508,"โรงเรียนบ้านบัวมล (ซอยสุขาภิบาล 5 ซอย 24)",68,246,336,386,722
648,"ท่าแร้ง","เขตบางเขน",100508,"โรงเรียนบ้านบัวมล (ซอยสุขาภิบาล 5 ซอย 24)",69,271,333,421,754
649,"ท่าแร้ง","เขตบางเขน",100508,"โรงเรียนบ้านบัวมล (ซอยสุขาภิบาล 5 ซอย 24 )",70,323,355,426,781
650,"ท่าแร้ง","เขตบางเขน",100508,"เต็นท์บริเวณลานกีฬาท้ายหมู่บ้านเลิศอุบล(ถนนร่วมมิตรพัฒนา แยก 1)",71,320,362,418,780
651,"ท่าแร้ง","เขตบางเขน",100508,"เต็นท์บริเวณลานกีฬาท้ายหมู่บ้านเลิศอุบล(ถนนร่วมมิตรพัฒนา แยก 1)",72,333,360,403,763
652,"ท่าแร้ง","เขตบางเขน",100508,"อาคารชุมชนวัชรปราณี (ถนนร่วมมิตรพัฒนา แยก 4)",73,145,202,247,449
653,"ท่าแร้ง","เขตบางเขน",100508,"อาคารชุมชนวัชรปราณี (ถนนร่วมมิตรพัฒนา แยก 4)",74,138,224,233,457
654,"ท่าแร้ง","เขตบางเขน",100508,"เต็นท์หน้าหมู่บ้านโนเบิล วานา (ถนนร่วมมิตรพัฒนา แยก 8)",75,416,368,448,816
655,"ท่าแร้ง","เขตบางเขน",100508,"เต็นท์หน้าหมู่บ้านโนเบิล วานา (ถนนร่วมมิตรพัฒนา แยก 8)",76,397,336,481,817
656,"ท่าแร้ง","เขตบางเขน",100508,"เต็นท์หน้าหมู่บ้านโนเบิล วานา (ถนนร่วมมิตรพัฒนา แยก 8)",77,364,379,422,801
657,"ท่าแร้ง","เขตบางเขน",100508,"เต็นท์หน้าหมู่บ้านโนเบิล วานา (ถนนร่วมมิตรพัฒนา แยก 8)",78,365,353,454,807
658,"ท่าแร้ง","เขตบางเขน",100508,"เต็นท์หน้าหมู่บ้านโนเบิล วานา (ถนนร่วมมิตรพัฒนา แยก 8)",79,415,340,475,815
659,"ท่าแร้ง","เขตบางเขน",100508,"เต็นท์บริเวณลานกีฬาภายในหมู่บ้านเสนาวิลล่า โครงการ 3(ซอยคู้บอน 27 แยก 10)",80,356,286,407,693
660,"ท่าแร้ง","เขตบางเขน",100508,"เต็นท์บริเวณลานกีฬาภายในหมู่บ้านเสนาวิลล่า โครงการ 3(ซอยคู้บอน 27 แยก 10)",81,260,302,366,668
661,"ท่าแร้ง","เขตบางเขน",100508,"เต็นท์บริเวณลานกีฬาภายในหมู่บ้านเสนาวิลล่า โครงการ 3(ซอยคู้บอน 27 แยก 10)",82,281,305,369,674
662,"ท่าแร้ง","เขตบางเขน",100508,"เต็นท์บริเวณลานกีฬาภายในหมู่บ้านเสนาวิลล่า โครงการ 3(ซอยคู้บอน 27 แยก 10)",83,293,307,367,674
663,"ท่าแร้ง","เขตบางเขน",100508,"เต็นท์บริเวณลานจอดรถร้านเซเว่นอีเลฟเว่น (ปากซอย 01 กาญจนาภิเษก 6/1)",84,576,419,545,964
664,"ท่าแร้ง","เขตบางเขน",100508,"เต็นท์บริเวณลานจอดรถร้านเซเว่นอีเลฟเว่น (ปากซอย 01 กาญจนาภิเษก 6/1)",85,569,418,546,964
665,"ท่าแร้ง","เขตบางเขน",100508,"เต็นท์บริเวณสนามกีฬาหมู่บ้านอารีน่าพาร์ค 1(ซอยคู้บอน 27 แยก 11)",86,307,276,373,649
666,"ท่าแร้ง","เขตบางเขน",100508,"เต็นท์บริเวณสนามกีฬาหมู่บ้านอารีน่าพาร์ค 1(ซอยคู้บอน 27 แยก 11)",87,295,279,369,648
667,"ท่าแร้ง","เขตบางเขน",100508,"เต็นท์บริเวณสนามกีฬาหมู่บ้านอารีน่าพาร์ค 1(ซอยคู้บอน 27 แยก 11)",88,287,279,371,650
668,"ท่าแร้ง","เขตบางเขน",100508,"เต็นท์บริเวณสนามกีฬาหมู่บ้านอารีน่าพาร์ค 1(ซอยคู้บอน 27 แยก 11)",89,352,281,401,682
669,"ท่าแร้ง","เขตบางเขน",100508,"เต็นท์บริเวณปากซอยคู้บอน 27 แยก 17(หมู่บ้าน ตชด. ซอย 2)",90,318,354,426,780
670,"ท่าแร้ง","เขตบางเขน",100508,"เต็นท์บริเวณปากซอยคู้บอน 27 แยก 17(หมู่บ้าน ตชด. ซอย 2)",91,363,324,452,776
671,"ท่าแร้ง","เขตบางเขน",100508,"เต็นท์บริเวณสนามเด็กเล่นหมู่บ้านบดินทรรักษา 3(ซอยคู้บอน 27 แยก 21)",92,332,379,490,869
672,"ท่าแร้ง","เขตบางเขน",100508,"เต็นท์บริเวณลานกีฬาหน้าหมู่บ้านบดินทรรักษา 2(ซอยคู้บอน 27 แยก 20)",93,394,366,478,844
673,"ท่าแร้ง","เขตบางเขน",100508,"เต็นท์บริเวณสวนหย่อมหน้าหมู่บ้านบดินทรรักษา 2(ซอยคู้บอน 27 แยก 23)",94,279,362,398,760
674,"ท่าแร้ง","เขตบางเขน",100508,"เต็นท์บริเวณสวนหย่อมหน้าหมู่บ้านบดินทรรักษา 2(ซอยคู้บอน 27 แยก 23)",95,298,359,422,781
675,"ท่าแร้ง","เขตบางเขน",100508,"ศาลาอเนกประสงค์หมู่บ้านพัชรัฐ (ซอยคู้บอน 27 แยก 31)",96,253,326,355,681
676,"ท่าแร้ง","เขตบางเขน",100508,"ศาลาอเนกประสงค์หมู่บ้านพัชรัฐ (ซอยคู้บอน 27 แยก 31)",97,285,314,351,665
677,"ท่าแร้ง","เขตบางเขน",100508,"เต็นท์ข้างศาลาอเนกประสงค์หมู่บ้านพัชรัฐ (ซอยคู้บอน 27 แยก 31)",98,216,313,365,678
678,"ท่าแร้ง","เขตบางเขน",100508,"เต็นท์บริเวณลานอเนกประสงค์หมู่บ้านรามอินทรา 71 โครงการ 1(ซอยคู้บอน 27 แยก 35)",99,258,285,365,650
679,"ท่าแร้ง","เขตบางเขน",100508,"เต็นท์บริเวณลานอเนกประสงค์หมู่บ้านรามอินทรา 71 โครงการ 1(ซอยคู้บอน 27 แยก 35)",100,263,291,354,645
680,"ท่าแร้ง","เขตบางเขน",100508,"เต็นท์บริเวณลานกีฬาชุมชนหมู่บ้านเสนาวิลล่า 1(ซอยคู้บอน 27 แยก 48)",101,305,323,407,730
681,"ท่าแร้ง","เขตบางเขน",100508,"เต็นท์บริเวณลานกีฬาชุมชนหมู่บ้านเสนาวิลล่า 1(ซอยคู้บอน 27 แยก 48)",102,298,305,412,717
682,"ท่าแร้ง","เขตบางเขน",100508,"เต็นท์บริเวณลานกีฬาชุมชนหมู่บ้านเสนาวิลล่า 2(ซอยคู้บอน 27 แยก 54)",103,278,325,359,684
683,"ท่าแร้ง","เขตบางเขน",100508,"เต็นท์บริเวณลานกีฬาชุมชนหมู่บ้านเสนาวิลล่า 2(ซอยคู้บอน 27 แยก 54)",104,262,314,376,690
684,"ท่าแร้ง","เขตบางเขน",100508,"เต็นท์บริเวณหน้าสโมสรสำนักงานก่อสร้างหมู่บ้านเสนาวิลล่า โครงการ 9 (ซอยคู้บอน 27 แยก 60)",105,443,396,479,875
685,"ท่าแร้ง","เขตบางเขน",100508,"เต็นท์บริเวณหน้าสโมสรสำนักงานก่อสร้างหมู่บ้านเสนาวิลล่า โครงการ 9 (ซอยคู้บอน 27 แยก 60)",106,371,389,482,871
686,"ท่าแร้ง","เขตบางเขน",100508,"เต็นท์บริเวณหน้าสโมสรสำนักงานก่อสร้างหมู่บ้านเสนาวิลล่า โครงการ 9 (ซอยคู้บอน 27 แยก 60)",107,364,382,487,869
687,"ท่าแร้ง","เขตบางเขน",100508,"เต็นท์บริเวณสนามกีฬาบ้านเอื้ออาทรรามอินทรา(ซอยคู้บอน 27 แยก 37)",108,405,340,401,741
688,"ท่าแร้ง","เขตบางเขน",100508,"เต็นท์บริเวณสนามกีฬาบ้านเอื้ออาทรรามอินทรา(ซอยคู้บอน 27 แยก 37)",109,384,316,427,743
689,"ท่าแร้ง","เขตบางเขน",100508,"เต็นท์บริเวณสนามกีฬาบ้านเอื้ออาทรรามอินทรา(ซอยคู้บอน 27 แยก 37)",110,383,310,433,743
690,"ท่าแร้ง","เขตบางเขน",100508,"เต็นท์บริเวณสนามกีฬาบ้านเอื้ออาทรรามอินทรา(ซอยคู้บอน 27 แยก 37)",111,395,334,403,737
691,"ท่าแร้ง","เขตบางเขน",100508,"เต็นท์บริเวณสนามกีฬาบ้านเอื้ออาทรรามอินทรา(ซอยคู้บอน 27 แยก 37)",112,381,334,400,734
692,"ท่าแร้ง","เขตบางเขน",100508,"เต็นท์บริเวณสนามกีฬาบ้านเอื้ออาทรรามอินทรา(ซอยคู้บอน 27 แยก 37)",113,403,346,396,742
693,"ท่าแร้ง","เขตบางเขน",100508,"เต็นท์บริเวณทางเข้าหมู่บ้าน เดอะแพล้นท์ 1 รามอินทรา-วงแหวน(ซอย 01 กาญจนาภิเษก 5/7)",114,360,346,406,752
694,"ท่าแร้ง","เขตบางเขน",100508,"เต็นท์บริเวณทางเข้าหมู่บ้าน เดอะแพล้นท์ 1 รามอินทรา-วงแหวน(ซอย 01 กาญจนาภิเษก 5/7)",115,304,336,401,737
695,"ท่าแร้ง","เขตบางเขน",100508,"เต็นท์บริเวณทางเข้าหมู่บ้าน เดอะแพล้นท์ 1 รามอินทรา-วงแหวน(ซอย 01 กาญจนาภิเษก 5/7)",116,376,327,411,738
696,"คลองจั่น","เขตบางกะปิ",100601,"เต็นท์บริเวณลานจอดรถบริษัทธนาเทพการพิมพ์ จำกัดใกล้ซอยลาดพร้าว 132",1,231,311,350,661
697,"คลองจั่น","เขตบางกะปิ",100601,"เต็นท์บริเวณลานจอดรถบริษัทธนาเทพการพิมพ์ จำกัดใกล้ซอยลาดพร้าว 132",2,213,331,365,696
698,"คลองจั่น","เขตบางกะปิ",100601,"เต็นท์บริเวณลานจอดรถบริษัทธนาเทพการพิมพ์ จำกัดใกล้ซอยลาดพร้าว 132",3,292,269,342,611
699,"คลองจั่น","เขตบางกะปิ",100601,"เต็นท์บริเวณโรงเรียนไขศรีปราโมชอนุสรณ์ ซอยลาดพร้าว 134 (เทพทวี)",4,228,356,437,793
700,"คลองจั่น","เขตบางกะปิ",100601,"เต็นท์บริเวณโรงเรียนไขศรีปราโมชอนุสรณ์ ซอยลาดพร้าว 134 (เทพทวี)",5,337,302,432,734
701,"คลองจั่น","เขตบางกะปิ",100601,"เต็นท์บริเวณซอยลาดพร้าว 130 (ใกล้โลตัส โกเฟรช)",6,367,299,362,661
702,"คลองจั่น","เขตบางกะปิ",100601,"เต็นท์บริเวณซอยลาดพร้าว 130 (ใกล้โลตัส โกเฟรช)",7,371,349,458,807
703,"คลองจั่น","เขตบางกะปิ",100601,"เต็นท์บริเวณซอยลาดพร้าว 130 (ใกล้โลตัส โกเฟรช)",8,377,379,438,817
704,"คลองจั่น","เขตบางกะปิ",100601,"เต็นท์บริเวณซอยลาดพร้าว 130 (ใกล้โลตัส โกเฟรช)",9,465,303,444,747
705,"คลองจั่น","เขตบางกะปิ",100601,"เต็นท์บริเวณลานจอดรถคริสตัลดีไซน์ เซ็นเตอร์ (ซีดีซี)ใกล้แม็กซ์ แวลู",10,198,273,336,609
706,"คลองจั่น","เขตบางกะปิ",100601,"เต็นท์บริเวณลานจอดรถคริสตัลดีไซน์ เซ็นเตอร์ (ซีดีซี)ใกล้แม็กซ์ แวลู",11,290,307,384,691
707,"คลองจั่น","เขตบางกะปิ",100601,"เต็นท์บริเวณลานจอดรถคริสตัลดีไซน์ เซ็นเตอร์ (ซีดีซี)ใกล้แม็กซ์ แวลู",12,249,277,353,630
708,"คลองจั่น","เขตบางกะปิ",100601,"ศาลาพักผู้ปกครองสุจิตวิมล โรงเรียนวัดบึงทองหลางซอยลาดพร้าว 101 ซอย 41",13,209,345,402,747
709,"คลองจั่น","เขตบางกะปิ",100601,"โรงอาหาร 7 และ 8 โรงเรียนวัดบึงทองหลาง ซอยลาดพร้าว 101 ซอย 41",14,336,360,451,811
710,"คลองจั่น","เขตบางกะปิ",100601,"โรงอาหาร 7 และ 8 โรงเรียนวัดบึงทองหลางซอยลาดพร้าว 101 ซอย 41",15,283,352,447,799
711,"คลองจั่น","เขตบางกะปิ",100601,"โรงอาหาร 7 และ 8 โรงเรียนวัดบึงทองหลางซอยลาดพร้าว 101 ซอย 41",16,299,403,472,875
712,"คลองจั่น","เขตบางกะปิ",100601,"โรงอาหาร 7 และ 8 โรงเรียนวัดบึงทองหลางซอยลาดพร้าว 101 ซอย 41",17,310,406,445,851
713,"คลองจั่น","เขตบางกะปิ",100601,"โรงอาหาร 7 และ 8 โรงเรียนวัดบึงทองหลางซอยลาดพร้าว 101 ซอย 41",18,288,401,419,820
714,"คลองจั่น","เขตบางกะปิ",100601,"ห้องประชุมอาคาร 6 โรงเรียนวัดบึงทองหลาง ซอยลาดพร้าว 101 ซอย 41",19,375,396,516,912
715,"คลองจั่น","เขตบางกะปิ",100601,"ห้องประชุมอาคาร 6 โรงเรียนวัดบึงทองหลางซอยลาดพร้าว 101 ซอย 41",20,298,331,422,753
716,"คลองจั่น","เขตบางกะปิ",100601,"ห้องประชุมอาคาร 4 โรงเรียนวัดบึงทองหลางซอยลาดพร้าว 101 ซอย 41",21,256,426,467,893
717,"คลองจั่น","เขตบางกะปิ",100601,"ห้องประชุมอาคาร 4 โรงเรียนวัดบึงทองหลาง ซอยลาดพร้าว 101 ซอย 41",22,324,431,537,968
718,"คลองจั่น","เขตบางกะปิ",100601,"ห้องประชุมอาคาร 4 โรงเรียนวัดบึงทองหลางซอยลาดพร้าว 101 ซอย 41",23,228,406,458,864
719,"คลองจั่น","เขตบางกะปิ",100601,"บริเวณโรงเรียนวัดบึงทองหลาง ซอยลาดพร้าว 101 ซอย 41",24,214,392,457,849
720,"คลองจั่น","เขตบางกะปิ",100601,"เต็นท์บริเวณวัดบึงทองหลาง ถนนลาดพร้าว 101",25,365,349,433,782
721,"คลองจั่น","เขตบางกะปิ",100601,"เต็นท์บริเวณวัดบึงทองหลาง ถนนลาดพร้าว 101",26,233,365,444,809
722,"คลองจั่น","เขตบางกะปิ",100601,"เต็นท์บริเวณวัดบึงทองหลาง ถนนลาดพร้าว 101",27,330,327,398,725
723,"คลองจั่น","เขตบางกะปิ",100601,"เต็นท์บริเวณโรงแรมอุ่นโฮเทล แบงค๊อก(ลานจอดรถคาร์วอช) ซอยโยธินพัฒนา",28,394,416,485,901
724,"คลองจั่น","เขตบางกะปิ",100601,"เต็นท์บริเวณโรงแรมอุ่นโฮเทล แบงค๊อก(ลานจอดรถคาร์วอช) ซอยโยธินพัฒนา",29,391,361,457,818
725,"คลองจั่น","เขตบางกะปิ",100601,"วิทยาลัยศิลปหัตถกรรมกรุงเทพถนนลาดพร้าว 101 (ใกล้ซอย 39)",30,329,317,420,737
726,"คลองจั่น","เขตบางกะปิ",100601,"วิทยาลัยศิลปหัตถกรรมกรุงเทพถนนลาดพร้าว 101 (ใกล้ซอย 39)",31,428,303,403,706
727,"คลองจั่น","เขตบางกะปิ",100601,"วิทยาลัยศิลปหัตถกรรมกรุงเทพถนนลาดพร้าว 101 (ใกล้ซอย 39)",32,390,336,418,754
728,"คลองจั่น","เขตบางกะปิ",100601,"วิทยาลัยศิลปหัตถกรรมกรุงเทพถนนลาดพร้าว 101 (ใกล้ซอย 39)",33,393,296,403,699
729,"คลองจั่น","เขตบางกะปิ",100601,"วิทยาลัยศิลปหัตถกรรมกรุงเทพถนนลาดพร้าว 101 (ใกล้ซอย 39)",34,317,365,404,769
730,"คลองจั่น","เขตบางกะปิ",100601,"วิทยาลัยศิลปหัตถกรรมกรุงเทพถนนลาดพร้าว 101 (ใกล้ซอย 39)",35,331,373,390,763
731,"คลองจั่น","เขตบางกะปิ",100601,"เต็นท์บริเวณท้ายหมู่บ้านนครไทย สุดซอยลาดพร้าว 101/1",36,200,231,293,524
732,"คลองจั่น","เขตบางกะปิ",100601,"เต็นท์บริเวณท้ายหมู่บ้านนครไทย สุดซอยลาดพร้าว 101/1",37,230,249,326,575
733,"คลองจั่น","เขตบางกะปิ",100601,"เต็นท์บริเวณลานจอดรถหน้าโรงพยาบาลเวชธานี ซอยลาดพร้าว 111",38,301,223,294,517
734,"คลองจั่น","เขตบางกะปิ",100601,"เต็นท์บริเวณลานจอดรถหน้าโรงพยาบาลเวชธานี ซอยลาดพร้าว 111",39,376,259,387,646
735,"คลองจั่น","เขตบางกะปิ",100601,"มหาวิทยาลัยรัตนบัณฑิต ซอยลาดพร้าว 107 (ดีสมโชค)",40,273,353,416,769
736,"คลองจั่น","เขตบางกะปิ",100601,"มหาวิทยาลัยรัตนบัณฑิต ซอยลาดพร้าว 107 (ดีสมโชค)",41,348,365,416,781
737,"คลองจั่น","เขตบางกะปิ",100601,"เต็นท์บริเวณโรงเรียนอนุบาลภัทรบุตรซอยลาดพร้าว 109 แยก 1",42,276,314,410,724
738,"คลองจั่น","เขตบางกะปิ",100601,"เต็นท์บริเวณโรงเรียนอนุบาลภัทรบุตรซอยลาดพร้าว 109 แยก 1",43,272,337,427,764
739,"คลองจั่น","เขตบางกะปิ",100601,"เต็นท์บริเวณทางเข้าหมู่บ้านศานตินิเวศน์ ปากซอยลาดพร้าว 115",44,247,227,309,536
740,"คลองจั่น","เขตบางกะปิ",100601,"เต็นท์บริเวณทางเข้าหมู่บ้านศานตินิเวศน์ ปากซอยลาดพร้าว 115",45,183,230,303,533
741,"คลองจั่น","เขตบางกะปิ",100601,"โรงเรียนณัฏฐวุฒิวิทยา ซอยหมู่บ้านสินธร",46,296,281,374,655
742,"คลองจั่น","เขตบางกะปิ",100601,"โรงเรียนณัฏฐวุฒิวิทยา ซอยหมู่บ้านสินธร",47,316,297,405,702
743,"คลองจั่น","เขตบางกะปิ",100601,"โรงเรียนณัฏฐวุฒิวิทยา ซอยหมู่บ้านสินธร",48,243,283,373,656
744,"คลองจั่น","เขตบางกะปิ",100601,"โรงเรียนนราธิปพิทยา หมู่บ้านเสนาวิลล่า ซอย 16",49,234,281,342,623
745,"คลองจั่น","เขตบางกะปิ",100601,"โรงเรียนนราธิปพิทยา หมู่บ้านเสนาวิลล่า ซอย 16",50,289,280,403,683
746,"คลองจั่น","เขตบางกะปิ",100601,"โรงเรียนนราธิปพิทยา หมู่บ้านเสนาวิลล่า ซอย 16",51,316,364,438,802
747,"คลองจั่น","เขตบางกะปิ",100601,"โรงเรียนนราธิปพิทยา หมู่บ้านเสนาวิลล่า ซอย 16",52,280,314,422,736
748,"คลองจั่น","เขตบางกะปิ",100601,"เต็นท์บริเวณสนามเด็กเล่นหมู่บ้านฉัตรแก้ว (ซอย 4)",53,269,297,370,667
749,"คลองจั่น","เขตบางกะปิ",100601,"เต็นท์บริเวณสนามเด็กเล่นหมู่บ้านฉัตรแก้ว (ซอย 4)",54,274,327,417,744
750,"คลองจั่น","เขตบางกะปิ",100601,"เต็นท์บริเวณศาลเจ้าพ่อเสือ ซอยศูนย์บันเทิงการค้า",55,275,343,416,759
751,"คลองจั่น","เขตบางกะปิ",100601,"เต็นท์บริเวณศาลเจ้าพ่อเสือ ซอยศูนย์บันเทิงการค้า",56,345,334,430,764
752,"คลองจั่น","เขตบางกะปิ",100601,"เต็นท์บริเวณศาลเจ้าพ่อเสือ ซอยศูนย์บันเทิงการค้า",57,430,314,416,730
753,"คลองจั่น","เขตบางกะปิ",100601,"เต็นท์บริเวณศาลเจ้าพ่อเสือ ซอยศูนย์บันเทิงการค้า",58,515,329,494,823
754,"คลองจั่น","เขตบางกะปิ",100601,"เต็นท์บริเวณลานจอดรถตลาดกลางแฮปปี้แลนด์",59,373,297,418,715
755,"คลองจั่น","เขตบางกะปิ",100601,"เต็นท์บริเวณลานจอดรถตลาดกลางแฮปปี้แลนด์",60,447,246,438,684
756,"คลองจั่น","เขตบางกะปิ",100601,"เต็นท์บริเวณลานจอดรถตลาดกลางแฮปปี้แลนด์",61,413,345,446,791
757,"คลองจั่น","เขตบางกะปิ",100601,"ใต้แฟลตการเคหะคลองจั่น หลังที่ 3",62,228,198,249,447
758,"คลองจั่น","เขตบางกะปิ",100601,"ใต้แฟลตการเคหะคลองจั่น หลังที่ 5",63,266,273,351,624
759,"คลองจั่น","เขตบางกะปิ",100601,"ใต้แฟลตการเคหะคลองจั่น หลังที่ 8",64,195,191,270,461
760,"คลองจั่น","เขตบางกะปิ",100601,"ใต้แฟลตการเคหะคลองจั่น หลังที่ 11",65,273,273,359,632
761,"คลองจั่น","เขตบางกะปิ",100601,"ใต้แฟลตการเคหะคลองจั่น หลังที่ 14",66,312,322,401,723
762,"คลองจั่น","เขตบางกะปิ",100601,"โรงเรียนอนุบาลวรรณทิพย์  ตรงข้ามแฟลตการเคหะคลองจั่น หลังที่ 17",67,256,252,366,618
763,"คลองจั่น","เขตบางกะปิ",100601,"ใต้แฟลตการเคหะคลองจั่น หลังที่ 19",68,274,252,338,590
764,"คลองจั่น","เขตบางกะปิ",100601,"ใต้แฟลตการเคหะคลองจั่น หลังที่ 21",69,333,317,447,764
765,"คลองจั่น","เขตบางกะปิ",100601,"ใต้แฟลตการเคหะคลองจั่น หลังที่ 25",70,310,313,391,704
766,"คลองจั่น","เขตบางกะปิ",100601,"ใต้แฟลตการเคหะคลองจั่น หลังที่ 26",71,291,268,356,624
767,"คลองจั่น","เขตบางกะปิ",100601,"ใต้แฟลตการเคหะคลองจั่น หลังที่ 30",72,215,166,259,425
768,"คลองจั่น","เขตบางกะปิ",100601,"เต็นท์บริเวณลานแอโรบิค สวนพฤกษชาติคลองจั่น ซอยนวมินทร์ 8",73,251,267,358,625
769,"คลองจั่น","เขตบางกะปิ",100601,"เต็นท์บริเวณลานแอโรบิค สวนพฤกษชาติคลองจั่น ซอยนวมินทร์ 8",74,259,267,381,648
770,"คลองจั่น","เขตบางกะปิ",100601,"เต็นท์บริเวณลานแอโรบิค สวนพฤกษชาติคลองจั่น ซอยนวมินทร์ 8",75,197,224,318,542
771,"คลองจั่น","เขตบางกะปิ",100601,"เต็นท์บริเวณลานแอโรบิค สวนพฤกษชาติคลองจั่น ซอยนวมินทร์ 8",76,202,251,291,542
772,"คลองจั่น","เขตบางกะปิ",100601,"เต็นท์บริเวณลานแอโรบิค สวนพฤกษชาติคลองจั่น ซอยนวมินทร์ 8",77,220,274,358,632
773,"คลองจั่น","เขตบางกะปิ",100601,"โรงเรียนบ้านบางกะปิ ถนนนวมินทร์",78,227,311,372,683
774,"คลองจั่น","เขตบางกะปิ",100601,"โรงเรียนบ้านบางกะปิ ถนนนวมินทร์",79,291,321,426,747
775,"คลองจั่น","เขตบางกะปิ",100601,"โรงเรียนบ้านบางกะปิ ถนนนวมินทร์",80,286,296,397,693
776,"คลองจั่น","เขตบางกะปิ",100601,"โรงเรียนบ้านบางกะปิ ถนนนวมินทร์",81,325,290,373,663
777,"คลองจั่น","เขตบางกะปิ",100601,"โรงเรียนบ้านบางกะปิ ถนนนวมินทร์",82,299,283,362,645
778,"คลองจั่น","เขตบางกะปิ",100601,"โรงเรียนบ้านบางกะปิ  ถนนนวมินทร์",83,187,253,314,567
779,"คลองจั่น","เขตบางกะปิ",100601,"เต็นท์บริเวณสวนหย่อมฝั่งตรงข้ามสำนักงานเขตบางกะปิ",84,235,340,332,672
780,"คลองจั่น","เขตบางกะปิ",100601,"โรงเรียนบางกะปิ ถนนเสรีไทย (ใกล้ซอยเสรีไทย 7)",85,482,331,503,834
781,"คลองจั่น","เขตบางกะปิ",100601,"โรงเรียนบางกะปิ ถนนเสรีไทย (ใกล้ซอยเสรีไทย 7)",86,363,370,417,787
782,"หัวหมาก","เขตบางกะปิ",100608,"เต็นท์บริเวณที่จอดรถร้านแก่นไม้ไทยอีสานซอยรามคำแหง 72",1,333,388,443,831
783,"หัวหมาก","เขตบางกะปิ",100608,"เต็นท์บริเวณที่จอดรถร้านแก่นไม้ไทยอีสาน ซอยรามคำแหง 72",2,303,339,438,777
784,"หัวหมาก","เขตบางกะปิ",100608,"เต็นท์บริเวณที่จอดรถร้านแก่นไม้ไทยอีสาน ซอยรามคำแหง 72",3,350,394,486,880
785,"หัวหมาก","เขตบางกะปิ",100608,"เต็นท์บริเวณที่จอดรถร้านแก่นไม้ไทยอีสานซอยรามคำแหง 72",4,290,344,420,764
786,"หัวหมาก","เขตบางกะปิ",100608,"โรงเรียนเพ็ญสมิทธ์ (บริเวณโรงยิมส์) ซอยรามคำแหง 68",5,316,348,441,789
787,"หัวหมาก","เขตบางกะปิ",100608,"โรงเรียนเพ็ญสมิทธ์ (บริเวณโรงยิมส์) ซอยรามคำแหง 68",6,306,327,387,714
788,"หัวหมาก","เขตบางกะปิ",100608,"โรงเรียนเพ็ญสมิทธ์ (บริเวณโรงยิมส์) ซอยรามคำแหง 68",7,237,284,381,665
789,"หัวหมาก","เขตบางกะปิ",100608,"โรงเรียนเพ็ญสมิทธ์ (บริเวณโรงยิมส์) ซอยรามคำแหง 68",8,239,273,338,611
790,"หัวหมาก","เขตบางกะปิ",100608,"โรงเรียนเพ็ญสมิทธ์ (บริเวณโรงยิมส์) ซอยรามคำแหง 68",9,234,287,350,637
791,"หัวหมาก","เขตบางกะปิ",100608,"โรงเรียนเพ็ญสมิทธ์ (บริเวณโรงยิมส์) ซอยรามคำแหง 68",10,263,332,398,730
792,"หัวหมาก","เขตบางกะปิ",100608,"เต็นท์บริเวณปากซอยรามคำแหง 60/5",11,413,346,450,796
793,"หัวหมาก","เขตบางกะปิ",100608,"เต็นท์บริเวณปากซอยรามคำแหง 60/5",12,307,357,461,818
794,"หัวหมาก","เขตบางกะปิ",100608,"เต็นท์บริเวณปากซอยรามคำแหง 60/5",13,545,332,455,787
795,"หัวหมาก","เขตบางกะปิ",100608,"เต็นท์บริเวณปากซอยรามคำแหง 60/5",14,407,346,436,782
796,"หัวหมาก","เขตบางกะปิ",100608,"เต็นท์บริเวณปากซอยรามคำแหง 60/5",15,499,338,473,811
797,"หัวหมาก","เขตบางกะปิ",100608,"เต็นท์บริเวณลานจอดรถซอยรามคำแหง 58/5  (ปากทางเข้าเทพมงคลคอนโด)",16,529,370,531,901
798,"หัวหมาก","เขตบางกะปิ",100608,"เต็นท์บริเวณลานจอดรถซอยรามคำแหง 58/5(ปากทางเข้าเทพมงคลคอนโด)",17,425,353,493,846
799,"หัวหมาก","เขตบางกะปิ",100608,"เต็นท์บริเวณลานจอดรถซอยรามคำแหง 58/5 (ปากทางเข้าเทพมงคลคอนโด)",18,305,349,446,795
800,"หัวหมาก","เขตบางกะปิ",100608,"โรงเรียนหัวหมากวิทยานุสรณ์ ซอยรามคำแหง 97/1",19,179,239,291,530
801,"หัวหมาก","เขตบางกะปิ",100608,"เต็นท์บริเวณสวนเฉลิมพระเกียรติหน้าสโมสรหมู่บ้านสวนสนซอยรามคำแหง 60",20,265,302,396,698
802,"หัวหมาก","เขตบางกะปิ",100608,"เต็นท์บริเวณสวนเฉลิมพระเกียรติหน้าสโมสรหมู่บ้านสวนสนซอยรามคำแหง 60",21,279,308,391,699
803,"หัวหมาก","เขตบางกะปิ",100608,"โรงเรียนวัดศรีบุญเรือง ซอยรามคำแหง 107",22,277,194,293,487
804,"หัวหมาก","เขตบางกะปิ",100608,"โรงเรียนวัดศรีบุญเรือง ซอยรามคำแหง 107",23,312,207,320,527
805,"หัวหมาก","เขตบางกะปิ",100608,"อาคารเรียนโรงเรียนสอนศาสนาสุเหร่าหัวหมากน้อย",24,198,445,477,922
806,"หัวหมาก","เขตบางกะปิ",100608,"อาคารเรียนโรงเรียนสอนศาสนาสุเหร่าหัวหมากน้อย",25,205,455,491,946
807,"หัวหมาก","เขตบางกะปิ",100608,"เต็นท์บริเวณศูนย์การเรียนรู้ชุมชนสามัคคีพัฒนาซอยสามัคคีพัฒนา",26,214,437,465,902
808,"หัวหมาก","เขตบางกะปิ",100608,"โรงเรียนนูรุ้ลอิสลามวังใหญ่ (สุเหร่าวังใหญ่)ถนนศรีนครินทร์-ร่มเกล้า",27,133,254,285,539
809,"หัวหมาก","เขตบางกะปิ",100608,"โรงเรียนนูรุ้ลอิสลามวังใหญ่ (สุเหร่าวังใหญ่)ถนนศรีนครินทร์-ร่มเกล้า",28,317,278,351,629
810,"หัวหมาก","เขตบางกะปิ",100608,"โรงเรียนอนุบาลทับแก้ว ซอยกรุงเทพกรีฑา 8",29,196,263,319,582
811,"หัวหมาก","เขตบางกะปิ",100608,"โรงเรียนอนุบาลทับแก้ว ซอยกรุงเทพกรีฑา 8",30,136,246,268,514
812,"หัวหมาก","เขตบางกะปิ",100608,"โรงเรียนลำสาลี (ราษฎร์บำรุง) ถนนศรีนครินทร์-ร่มเกล้า",31,355,425,451,876
813,"หัวหมาก","เขตบางกะปิ",100608,"โรงเรียนลำสาลี (ราษฎร์บำรุง) ถนนศรีนครินทร์-ร่มเกล้า",32,340,314,404,718
814,"หัวหมาก","เขตบางกะปิ",100608,"โรงเรียนสอนศาสนากันซุสซอลีฮีนถนนศรีนครินทร์-ร่มเกล้า",33,197,348,395,743
815,"หัวหมาก","เขตบางกะปิ",100608,"โรงเรียนสอนศาสนากันซุสซอลีฮีนถนนศรีนครินทร์-ร่มเกล้า",34,218,363,443,806
816,"หัวหมาก","เขตบางกะปิ",100608,"เต็นท์บริเวณบ้านเอื้ออาทรหัวหมาก ซอยกรุงเทพกรีฑา 7",35,380,348,450,798
817,"หัวหมาก","เขตบางกะปิ",100608,"เต็นท์บริเวณบ้านเอื้ออาทรหัวหมาก ซอยกรุงเทพกรีฑา 7",36,465,381,507,888
818,"หัวหมาก","เขตบางกะปิ",100608,"เต็นท์บริเวณลานจอดรถหน้าเซเว่นอีเลฟเว่นซอยกรุงเทพกรีฑา 7",37,434,347,475,822
819,"หัวหมาก","เขตบางกะปิ",100608,"เต็นท์บริเวณลานจอดรถหน้าเซเว่นอีเลฟเว่นซอยกรุงเทพกรีฑา 7",38,465,353,457,810
820,"หัวหมาก","เขตบางกะปิ",100608,"เต็นท์บริเวณลานจอดรถหน้าเซ่เว่นอีเลฟเว่นซอยกรุงเทพกรีฑา 7",39,433,338,459,797
821,"หัวหมาก","เขตบางกะปิ",100608,"บริเวณใต้อาคารหอประชุมพ่อขุนรามคำแหงมหาราชมหาวิทยาลัยรามคำแหง (ใก้ลลานพ่อขุนรามคำแหง)",40,253,205,247,452
822,"หัวหมาก","เขตบางกะปิ",100608,"บริเวณใต้อาคารหอประชุมพ่อขุนรามคำแหงมหาราชมหาวิทยาลัยรามคำแหง (ใกล้ลานพ่อขุนรามคำแหง)",41,243,251,285,536
823,"หัวหมาก","เขตบางกะปิ",100608,"เต็นท์บริเวณหน้าร้านรสเด็ด บุฟเฟ่ต์ ปากซอยรามคำแหง 69",42,278,320,373,693
824,"หัวหมาก","เขตบางกะปิ",100608,"เต็นท์บริเวณลานเอนกประสงค์หมู่บ้านเดชาซอยรามคำแหง 26/1",43,346,315,387,702
825,"หัวหมาก","เขตบางกะปิ",100608,"เต็นท์บริเวณลานเอนกประสงค์หมู่บ้านเดชาซอยรามคำแหง 26/1",44,277,294,370,664
826,"หัวหมาก","เขตบางกะปิ",100608,"เต็นท์บริเวณลานเอนกประสงค์หมู่บ้านเดชาซอยรามคำแหง 26/1",45,430,301,444,745
827,"หัวหมาก","เขตบางกะปิ",100608,"เต็นท์บริเวณลานเอนกประสงค์หมู่บ้านเดชาซอยรามคำแหง 26/1",46,388,348,446,794
828,"หัวหมาก","เขตบางกะปิ",100608,"เต็นท์บริเวณลานเอนกประสงค์หมู่บ้านเดชาซอยรามคำแหง 26/1",47,350,347,471,818
829,"หัวหมาก","เขตบางกะปิ",100608,"บริเวณอาคารศิลาบาตร (เอสบีบี) มหาวิทยาลัยรามคำแหง(ใกล้ลานพ่อขุนรามคำแหง)",48,393,343,462,805
830,"หัวหมาก","เขตบางกะปิ",100608,"บริเวณอาคารศิลาบาตร (เอสบีบี) มหาวิทยาลัยรามคำแหง(ใกล้ลานพ่อขุนรามคำแหง)",49,255,277,323,600
831,"หัวหมาก","เขตบางกะปิ",100608,"บริเวณอาคารศิลาบาตร (เอสบีบี) มหาวิทยาลัยรามคำแหง(ใกล้ลานพ่อขุนรามคำแหง)",50,242,203,311,514
832,"หัวหมาก","เขตบางกะปิ",100608,"บริเวณอาคารศิลาบาตร (เอสบีบี) มหาวิทยาลัยรามคำแหง(ใกล้ลานพ่อขุนรามคำแหง)",51,197,256,343,599
833,"หัวหมาก","เขตบางกะปิ",100608,"บริเวณอาคารศิลาบาตร (เอสบีบี) มหาวิทยาลัยรามคำแหง(ใกล้ลานพ่อขุนรามคำแหง)",52,262,282,377,659
834,"หัวหมาก","เขตบางกะปิ",100608,"บริเวณอาคารศิลาบาตร (เอสบีบี) มหาวิทยาลัยรามคำแหง(ใกล้ลานพ่อขุนรามคำแหง)",53,267,316,384,700
835,"หัวหมาก","เขตบางกะปิ",100608,"เต็นท์บริเวณสนามบาสเก็ตบอล มหาวิทยาลัยอัสสัมชัญ",54,352,322,470,792
836,"หัวหมาก","เขตบางกะปิ",100608,"เต็นท์บริเวณสนามบาสเก็ตบอล มหาวิทยาลัยอัสสัมชัญ",55,531,388,554,942
837,"หัวหมาก","เขตบางกะปิ",100608,"เต็นท์บริเวณสนามบาสเก็ตบอล มหาวิทยาลัยอัสสัมชัญ",56,733,392,551,943
838,"หัวหมาก","เขตบางกะปิ",100608,"เต็นท์บริเวณสนามบาสเก็ตบอล มหาวิทยาลัยอัสสัมชัญ",57,332,353,463,816
839,"หัวหมาก","เขตบางกะปิ",100608,"เต็นท์บริเวณสนามบาสเก็ตบอล มหาวิทยาลัยอัสสัมชัญ",58,475,412,525,937
840,"หัวหมาก","เขตบางกะปิ",100608,"เต็นท์บริเวณสนามบาสเก็ตบอล มหาวิทยาลัยอัสสัมชัญ",59,304,354,430,784
841,"หัวหมาก","เขตบางกะปิ",100608,"เต็นท์บริเวณปั๊มน้ำมันเอสโซ่ ใกล้ซอยรามคำแหง 14",60,470,309,434,743
842,"หัวหมาก","เขตบางกะปิ",100608,"เต็นท์บริเวณปั๊มน้ำมันเอสโซ่ ใกล้ซอยรามคำแหง 14",61,225,280,358,638
843,"หัวหมาก","เขตบางกะปิ",100608,"เต็นท์บริเวณปั๊มน้ำมันเอสโซ่ ใกล้ซอยรามคำแหง 14",62,337,337,410,747
844,"หัวหมาก","เขตบางกะปิ",100608,"เต็นท์บริเวณปั๊มน้ำมันเอสโซ่ ใกล้ซอยรามคำแหง 14",63,221,273,348,621
845,"หัวหมาก","เขตบางกะปิ",100608,"บริเวณโรงเรียนเทพลีลา ซอยรามคำแหง 39",64,569,253,417,670
846,"หัวหมาก","เขตบางกะปิ",100608,"บริเวณโรงเรียนเทพลีลา ซอยรามคำแหง 39",65,496,280,431,711
847,"หัวหมาก","เขตบางกะปิ",100608,"บริเวณโรงเรียนเทพลีลา ซอยรามคำแหง 39",66,277,327,363,690
848,"หัวหมาก","เขตบางกะปิ",100608,"บริเวณโรงเรียนเทพลีลา ซอยรามคำแหง 39",67,264,345,435,780
849,"หัวหมาก","เขตบางกะปิ",100608,"เต็นท์บริเวณเดอะรามวิลล่า(ใกล้ศูนย์ฮอนด้าหัวหมาก ซอยรามคำแหง 85)",68,350,243,281,524
850,"หัวหมาก","เขตบางกะปิ",100608,"เต็นท์บริเวณที่จอดรถบริษัทรอแยลเฮ้าส์ จำกัดถนนศรีนครินทร์ (ใกล้แยกลำสาลี)",69,401,308,448,756
851,"หัวหมาก","เขตบางกะปิ",100608,"เต็นท์บริเวณที่จอดรถบริษัทรอแยลเฮ้าส์ จำกัดถนนศรีนครินทร์ (ใกล้แยกลำสาลี)",70,350,354,464,818
852,"หัวหมาก","เขตบางกะปิ",100608,"เต็นท์บริเวณหน้าบริษัทเมืองไทยแคปปิตอล จำกัด (มหาชน)(ติดกับบริษัทรอแยลเฮ้าส์ จำกัด) ถนนศรีนครินทร์",71,410,296,396,692
853,"หัวหมาก","เขตบางกะปิ",100608,"บริเวณศูนย์บริการสาธารณสุข 35 หัวหมากซอยรามคำแหง 40",72,573,350,476,826
854,"หัวหมาก","เขตบางกะปิ",100608,"บริเวณศูนย์บริการสาธารณสุข 35 หัวหมากซอยรามคำแหง 40",73,521,276,491,767
855,"หัวหมาก","เขตบางกะปิ",100608,"เต็นท์บริเวณศูนย์บริการสาธารณสุข 35 หัวหมากซอยรามคำแหง 40",74,310,341,473,814
856,"รองเมือง","เขตปทุมวัน",100701,"อาคารโรงเรียนวัดบรมนิวาส",1,156,190,258,448
857,"รองเมือง","เขตปทุมวัน",100701,"อาคารโรงเรียนวัดบรมนิวาส",2,137,235,289,524
858,"รองเมือง","เขตปทุมวัน",100701,"อาคารโรงเรียนวัดบรมนิวาส",3,148,282,315,597
859,"รองเมือง","เขตปทุมวัน",100701,"อาคารโรงเรียนวัดบรมนิวาส",4,167,278,318,596
860,"รองเมือง","เขตปทุมวัน",100701,"อาคารโรงเรียนวัดชัยมงคล",5,129,367,383,750
861,"รองเมือง","เขตปทุมวัน",100701,"อาคารโรงเรียนวัดชัยมงคล",6,172,343,388,731
862,"รองเมือง","เขตปทุมวัน",100701,"อาคารโรงเรียนวัดชัยมงคล",7,154,318,353,671
863,"รองเมือง","เขตปทุมวัน",100701,"ศาลาบุญญนิธิ (วัดชำนิหัตถการ)",8,226,337,420,757
864,"รองเมือง","เขตปทุมวัน",100701,"อาคารโรงเรียนวัดสระบัว",9,145,220,273,493
865,"รองเมือง","เขตปทุมวัน",100701,"อาคารโรงเรียนวัดสระบัว",10,132,189,218,407
866,"รองเมือง","เขตปทุมวัน",100701,"บริเวณอาคารโรงเรียนสีตบุตรบำรุง",11,208,264,314,578
867,"รองเมือง","เขตปทุมวัน",100701,"บริเวณอาคารโรงเรียนสีตบุตรบำรุง",12,176,259,281,540
868,"รองเมือง","เขตปทุมวัน",100701,"เต็นท์บริเวณโรงเรียนสีตบุตรบำรุง",13,182,263,293,556
869,"รองเมือง","เขตปทุมวัน",100701,"อาคารโรงเรียนวัดดวงแข",14,176,276,303,579
870,"รองเมือง","เขตปทุมวัน",100701,"อาคารโรงเรียนวัดดวงแข",15,173,269,294,563
871,"รองเมือง","เขตปทุมวัน",100701,"อาคารโรงเรียนวัดดวงแข",16,179,260,347,607
872,"รองเมือง","เขตปทุมวัน",100701,"เต็นท์บริเวณลานจอดรถ ศาลแรงงานกลาง (แยกมหานคร)",17,179,255,329,584
873,"รองเมือง","เขตปทุมวัน",100701,"เต็นท์บริเวณลานจอดรถ ศาลแรงงานกลาง (แยกมหานคร)",18,192,277,334,611
874,"รองเมือง","เขตปทุมวัน",100701,"บริเวณโรงเรียนประเสริฐธรรมวิทยา",19,280,325,375,700
875,"รองเมือง","เขตปทุมวัน",100701,"บริเวณโรงเรียนประเสริฐธรรมวิทยา",20,172,281,343,624
876,"รองเมือง","เขตปทุมวัน",100701,"บริเวณโรงเรียนประเสริฐธรรมวิทยา",21,215,275,352,627
877,"วังใหม่","เขตปทุมวัน",100702,"เต็นท์บริเวณตึกอำนวยการ สถาบันเทคโนโลยีปทุมวัน",1,282,258,342,600
878,"วังใหม่","เขตปทุมวัน",100702,"เต็นท์บริเวณตึกอำนวยการ สถาบันเทคโนโลยีปทุมวัน",2,388,280,352,632
879,"วังใหม่","เขตปทุมวัน",100702,"เต็นท์บริเวณหอพักจุฬานิวาส จุฬาลงกรณ์มหาวิทยาลัย",3,237,323,395,718
880,"วังใหม่","เขตปทุมวัน",100702,"เต็นท์บริเวณลานจอดรถศูนย์บริการสาธารณสุข 5 (จุฬาลงกรณ์)",4,166,205,241,446
881,"วังใหม่","เขตปทุมวัน",100702,"เต็นท์บริเวณลานจอดรถศูนย์บริการสาธารณสุข 5 (จุฬาลงกรณ์)",5,186,249,176,425
882,"ปทุมวัน","เขตปทุมวัน",100703,"อาคารโรงเรียนวัดปทุมวนารามฯ",1,164,310,326,636
883,"ปทุมวัน","เขตปทุมวัน",100703,"บริเวณอาคารเภสัชกรรม โรงพยาบาลตำรวจ",2,2,86,252,338
884,"ปทุมวัน","เขตปทุมวัน",100703,"อาคารมหาวิทยาลัยเทคโนโลยีราชมงคลตะวันออก วิทยาเขตอุเทนถวาย",3,73,81,92,173
885,"ปทุมวัน","เขตปทุมวัน",100703,"บริเวณอาคารอานันทมหิดล คณะแพทยศาสตร์ โรงพยาบาลจุฬาลงกรณ์",4,2,174,275,449
886,"ลุมพินี","เขตปทุมวัน",100704,"โรงเรียนมาแตร์เดอี (อาคารอนุสรณ์ 50 ปี)",1,532,289,367,656
887,"ลุมพินี","เขตปทุมวัน",100704,"โรงเรียนมาแตร์เดอี (อาคารอนุสรณ์ 50 ปี)",2,397,256,393,649
888,"ลุมพินี","เขตปทุมวัน",100704,"โรงเรียนมาแตร์เดอี (อาคารอนุสรณ์ 50 ปี)",3,362,260,396,656
889,"ลุมพินี","เขตปทุมวัน",100704,"โรงเรียนมาแตร์เดอี (อาคารอนุสรณ์ 50 ปี)",4,535,323,401,724
890,"ลุมพินี","เขตปทุมวัน",100704,"โรงเรียนมาแตร์เดอี (อาคารอนุสรณ์ 50 ปี)",5,461,269,408,677
891,"ลุมพินี","เขตปทุมวัน",100704,"เต็นท์บริเวณลานกิจกรรมของโรงเรียนสวนลุมพินี",6,167,247,309,556
892,"ลุมพินี","เขตปทุมวัน",100704,"เต็นท์บริเวณลานกิจกรรมของโรงเรียนสวนลุมพินี",7,195,317,255,572
893,"ลุมพินี","เขตปทุมวัน",100704,"อาคารโรงเรียนพระมหาไถ่ศึกษา",8,376,290,394,684
894,"ลุมพินี","เขตปทุมวัน",100704,"อาคารโรงเรียนพระมหาไถ่ศึกษา",9,199,333,365,698
895,"ลุมพินี","เขตปทุมวัน",100704,"เต็นท์บริเวณสนามฟุตบอลโปโลปาร์ค",10,146,243,271,514
896,"ลุมพินี","เขตปทุมวัน",100704,"เต็นท์บริเวณสนามฟุตบอลโปโลปาร์ค",11,125,229,294,523
897,"ลุมพินี","เขตปทุมวัน",100704,"เต็นท์บริเวณสนามฟุตบอลโปโลปาร์ค",12,121,239,290,529
898,"ลุมพินี","เขตปทุมวัน",100704,"เต็นท์บริเวณโรงเรียนปลูกจิต",13,240,322,368,690
899,"ลุมพินี","เขตปทุมวัน",100704,"เต็นท์บริเวณโรงเรียนปลูกจิต",14,232,303,386,689
900,"ลุมพินี","เขตปทุมวัน",100704,"ศาลาประชาคมการเคหะชุมชนบ่อนไก่",15,212,267,336,603
901,"ลุมพินี","เขตปทุมวัน",100704,"อาคารศูนย์เยาวชนบ่อนไก่",16,162,247,296,543
902,"ลุมพินี","เขตปทุมวัน",100704,"อาคารศูนย์เยาวชนบ่อนไก่",17,134,236,278,514
903,"ลุมพินี","เขตปทุมวัน",100704,"อาคารศูนย์เยาวชนบ่อนไก่",18,171,222,304,526
904,"ลุมพินี","เขตปทุมวัน",100704,"อาคารศูนย์เยาวชนบ่อนไก่",19,158,251,259,510
905,"ลุมพินี","เขตปทุมวัน",100704,"เต็นท์บริเวณศูนย์บริการสาธารณสุข 16 (ลุมพินี)",20,144,243,284,527
906,"ลุมพินี","เขตปทุมวัน",100704,"อาคารโรงเรียนสุนีพิทยา",21,232,287,390,677
907,"ลุมพินี","เขตปทุมวัน",100704,"อาคารโรงเรียนสุนีพิทยา",22,263,283,398,681
908,"ลุมพินี","เขตปทุมวัน",100704,"อาคารโรงเรียนสุนีพิทยา",23,297,302,352,654
909,"ป้อมปราบ","เขตป้อมปราบศัตรูพ่าย",100801,"เต็นท์หน้าตึกเอื้อประชา โรงพยาบาลกลาง",1,279,368,415,783
910,"ป้อมปราบ","เขตป้อมปราบศัตรูพ่าย",100801,"เต็นท์หน้าตึกเอื้อประชา โรงพยาบาลกลาง",2,203,269,377,646
911,"ป้อมปราบ","เขตป้อมปราบศัตรูพ่าย",100801,"โรงเรียนวัดคณิกาผล",3,190,263,352,615
912,"ป้อมปราบ","เขตป้อมปราบศัตรูพ่าย",100801,"โรงเรียนวัดคณิกาผล",4,177,211,273,484
913,"ป้อมปราบ","เขตป้อมปราบศัตรูพ่าย",100801,"เต็นท์ลานกิจกรรมโรงเรียนวัดคณิกาผล",5,172,278,295,573
914,"ป้อมปราบ","เขตป้อมปราบศัตรูพ่าย",100801,"มูลนิธิฮั่วเคี้ยวป่อเต็กตึ๊ง(ป่อเต็กตึ๊ง) ลานจอดรถ",6,168,283,253,536
915,"ป้อมปราบ","เขตป้อมปราบศัตรูพ่าย",100801,"มูลนิธิฮั่วเคี้ยวป่อเต็กตึ๊ง(ป่อเต็กตึ๊ง) ลานจอดรถ",7,147,260,301,561
916,"ป้อมปราบ","เขตป้อมปราบศัตรูพ่าย",100801,"อาคารโรงเรียนวัดพลับพลาชัย",8,243,359,405,764
917,"ป้อมปราบ","เขตป้อมปราบศัตรูพ่าย",100801,"อาคารโรงเรียนวัดพลับพลาชัย",9,209,343,426,769
918,"ป้อมปราบ","เขตป้อมปราบศัตรูพ่าย",100801,"อาคารโรงเรียนวัดพลับพลาชัย",10,211,321,414,735
919,"ป้อมปราบ","เขตป้อมปราบศัตรูพ่าย",100801,"เต็นท์บริเวณลานกิจกรรม โรงเรียนสายปัญญา ในพระบรมราชินูปถัมภ์",11,285,382,431,813
920,"ป้อมปราบ","เขตป้อมปราบศัตรูพ่าย",100801,"เต็นท์บริเวณลานกิจกรรม โรงเรียนสายปัญญา ในพระบรมราชินูปถัมภ์",12,245,376,433,809
921,"ป้อมปราบ","เขตป้อมปราบศัตรูพ่าย",100801,"ศาลเจ้าซินเฮงตั้ว",13,204,274,300,574
922,"ป้อมปราบ","เขตป้อมปราบศัตรูพ่าย",100801,"ศาลเจ้าซิดเซี้ยม้า",14,188,237,307,544
923,"ป้อมปราบ","เขตป้อมปราบศัตรูพ่าย",100801,"เต็นท์ลานจอดรถศาลเจ้ากวางตุ้ง",15,221,335,377,712
924,"วัดเทพศิรินทร์","เขตป้อมปราบศัตรูพ่าย",100802,"โรงเรียนวัดดิสานุการาม",1,242,380,391,771
925,"วัดเทพศิรินทร์","เขตป้อมปราบศัตรูพ่าย",100802,"โรงเรียนวัดดิสานุการาม",2,218,347,346,693
926,"วัดเทพศิรินทร์","เขตป้อมปราบศัตรูพ่าย",100802,"โรงเรียนวัดดิสานุการาม",3,229,341,371,712
927,"วัดเทพศิรินทร์","เขตป้อมปราบศัตรูพ่าย",100802,"โรงเรียนเทพศิรินทร์ (โรงอาหาร)",4,171,258,328,586
928,"วัดเทพศิรินทร์","เขตป้อมปราบศัตรูพ่าย",100802,"โรงเรียนเทพศิรินทร์ (โรงอาหาร)",5,197,287,277,564
929,"วัดเทพศิรินทร์","เขตป้อมปราบศัตรูพ่าย",100802,"โรงเรียนเทพศิรินทร์ (โรงอาหาร)",6,153,266,290,556
930,"วัดเทพศิรินทร์","เขตป้อมปราบศัตรูพ่าย",100802,"โรงเรียนเทพศิรินทร์ (โรงอาหาร)",7,178,273,336,609
931,"วัดเทพศิรินทร์","เขตป้อมปราบศัตรูพ่าย",100802,"โรงเรียนเทพศิรินทร์ (โรงอาหาร)",8,159,302,305,607
932,"คลองมหานาค","เขตป้อมปราบศัตรูพ่าย",100803,"โรงเรียนวัดสิตาราม",1,227,345,413,758
933,"คลองมหานาค","เขตป้อมปราบศัตรูพ่าย",100803,"หน้าอาคารกรมพัฒนาสังคมและสวัสดิการ ชั้น ๑",2,239,230,320,550
934,"คลองมหานาค","เขตป้อมปราบศัตรูพ่าย",100803,"หน้าอาคารกรมพัฒนาสังคมและสวัสดิการ ชั้น ๑",3,136,194,195,389
935,"คลองมหานาค","เขตป้อมปราบศัตรูพ่าย",100803,"ใต้อาคารสมาคมจีนเตี้ยอันในประเทศไทย",4,134,305,348,653
936,"คลองมหานาค","เขตป้อมปราบศัตรูพ่าย",100803,"ใต้อาคารสมาคมจีนเตี้ยอันในประเทศไทย",5,170,329,340,669
937,"คลองมหานาค","เขตป้อมปราบศัตรูพ่าย",100803,"ใต้อาคารสมาคมจีนเตี้ยอันในประเทศไทย",6,161,252,277,529
938,"คลองมหานาค","เขตป้อมปราบศัตรูพ่าย",100803,"ใต้อาคารสมาคมจีนเตี้ยอันในประเทศไทย",7,161,264,261,525
939,"คลองมหานาค","เขตป้อมปราบศัตรูพ่าย",100803,"ใต้อาคารสมาคมจีนเตี้ยอันในประเทศไทย",8,155,228,293,521
940,"คลองมหานาค","เขตป้อมปราบศัตรูพ่าย",100803,"ใต้อาคารสมาคมจีนเตี้ยอันในประเทศไทย",9,203,272,341,613
941,"คลองมหานาค","เขตป้อมปราบศัตรูพ่าย",100803,"ใต้อาคารสมาคมจีนเตี้ยอันในประเทศไทย",10,170,244,283,527
942,"คลองมหานาค","เขตป้อมปราบศัตรูพ่าย",100803,"ใต้อาคารสมาคมจีนเตี้ยอันในประเทศไทย",11,173,262,343,605
943,"คลองมหานาค","เขตป้อมปราบศัตรูพ่าย",100803,"ใต้อาคารสมาคมจีนเตี้ยอันในประเทศไทย",12,170,236,296,532
944,"บ้านบาตร","เขตป้อมปราบศัตรูพ่าย",100804,"โรงเรียนวัดสระเกศ (ห้องประชุมชั้นล่าง อาคาร ๒)",1,169,294,341,635
945,"บ้านบาตร","เขตป้อมปราบศัตรูพ่าย",100804,"โรงเรียนวัดสระเกศ (ห้องประชุมชั้นล่าง อาคาร ๒)",2,144,322,272,594
946,"บ้านบาตร","เขตป้อมปราบศัตรูพ่าย",100804,"เต็นท์ในวิทยาลัยสารพัดช่างพระนคร",3,259,368,440,808
947,"บ้านบาตร","เขตป้อมปราบศัตรูพ่าย",100804,"เต็นท์ในวิทยาลัยสารพัดช่างพระนคร",4,235,410,427,837
948,"บ้านบาตร","เขตป้อมปราบศัตรูพ่าย",100804,"เต็นท์ในวิทยาลัยสารพัดช่างพระนคร",5,238,373,429,802
949,"บ้านบาตร","เขตป้อมปราบศัตรูพ่าย",100804,"โรงเรียนวัดพระพิเรนทร์",6,209,333,330,663
950,"บ้านบาตร","เขตป้อมปราบศัตรูพ่าย",100804,"โรงเรียนวัดพระพิเรนทร์",7,211,324,347,671
951,"วัดโสมนัส","เขตป้อมปราบศัตรูพ่าย",100805,"โรงเรียนวัดโสมนัส",1,129,288,340,628
952,"วัดโสมนัส","เขตป้อมปราบศัตรูพ่าย",100805,"โรงเรียนวัดโสมนัส",2,181,304,297,601
953,"วัดโสมนัส","เขตป้อมปราบศัตรูพ่าย",100805,"โรงเรียนสตรีจุลนาค",3,195,283,309,592
954,"วัดโสมนัส","เขตป้อมปราบศัตรูพ่าย",100805,"โรงเรียนสตรีจุลนาค",4,246,298,328,626
955,"วัดโสมนัส","เขตป้อมปราบศัตรูพ่าย",100805,"วัดสุนทรธรรมทาน (ศาลา ๓)",5,177,311,360,671
956,"วัดโสมนัส","เขตป้อมปราบศัตรูพ่าย",100805,"วัดสุนทรธรรมทาน (ศาลา ๓)",6,177,336,387,723
957,"วัดโสมนัส","เขตป้อมปราบศัตรูพ่าย",100805,"วัดสุนทรธรรมทาน (ศาลา ๓)",7,181,301,361,662
958,"วัดโสมนัส","เขตป้อมปราบศัตรูพ่าย",100805,"วัดสุนทรธรรมทาน (ศาลา ๓)",8,186,330,344,674
959,"บางจาก","เขตพระโขนง",100905,"เต็นท์บริเวณพื้นที่ว่างบ้านเลขที่ 15 ซอยสุขุมวิท 89",1,459,251,405,656
960,"บางจาก","เขตพระโขนง",100905,"เต็นท์บริเวณพื้นที่ว่างบ้านเลขที่ 15 ซอยสุขุมวิท 89",2,326,268,376,644
961,"บางจาก","เขตพระโขนง",100905,"เต็นท์บริเวณพื้นที่ว่างบ้านเลขที่ 15 ซอยสุขุมวิท 89",3,231,276,365,641
962,"บางจาก","เขตพระโขนง",100905,"เต็นท์บริเวณลานจอดรถยนต์บริษัท เอส.เลอสันต์ จำกัด",4,318,325,449,774
963,"บางจาก","เขตพระโขนง",100905,"เต็นท์บริเวณลานจอดรถยนต์บริษัท เอส.เลอสันต์ จำกัด",5,299,308,440,748
964,"บางจาก","เขตพระโขนง",100905,"เต็นท์บริเวณด้านข้างเซเว่นอีเลฟเว่น ซอยพึ่งมี 1",6,365,285,426,711
965,"บางจาก","เขตพระโขนง",100905,"เต็นท์บริเวณด้านข้างเซเว่นอีเลฟเว่น ซอยพึ่งมี 1",7,239,296,393,689
966,"บางจาก","เขตพระโขนง",100905,"เต็นท์บริเวณด้านข้างเซเว่นอีเลฟเว่น ซอยพึ่งมี 1",8,261,292,378,670
967,"บางจาก","เขตพระโขนง",100905,"เต็นท์ข้างอู่เอส พี คาร์แคร์ ปากซอยพึ่งมี 17",9,142,228,272,500
968,"บางจาก","เขตพระโขนง",100905,"เต็นท์ข้างอู่เอส พี คาร์แคร์ ปากซอยพึ่งมี 17",10,127,225,263,488
969,"บางจาก","เขตพระโขนง",100905,"เต็นท์ข้างอู่เอส พี คาร์แคร์ ปากซอยพึ่งมี 17",11,162,244,273,517
970,"บางจาก","เขตพระโขนง",100905,"เต็นท์ข้างอู่เอส พี คาร์แคร์ ปากซอยพึ่งมี 17",12,127,221,262,483
971,"บางจาก","เขตพระโขนง",100905,"โรงเรียนมูลนิธิวัดราษฎร์ศรัทธาธรรมสงเคราะห์",13,150,250,284,534
972,"บางจาก","เขตพระโขนง",100905,"โรงเรียนมูลนิธิวัดราษฎร์ศรัทธาธรรมสงเคราะห์",14,171,223,268,491
973,"บางจาก","เขตพระโขนง",100905,"โรงเรียนมูลนิธิวัดราษฎร์ศรัทธาธรรมสงเคราะห์",15,180,239,318,557
974,"บางจาก","เขตพระโขนง",100905,"โรงเรียนวัดราษฎร์ศรัทธาธรรม",16,214,320,370,690
975,"บางจาก","เขตพระโขนง",100905,"โรงเรียนวัดราษฎร์ศรัทธาธรรม",17,222,312,364,676
976,"บางจาก","เขตพระโขนง",100905,"โรงเรียนวัดราษฎร์ศรัทธาธรรม",18,182,307,357,664
977,"บางจาก","เขตพระโขนง",100905,"โรงจอดรถยนต์นิรันดร์คอนโดมิเนียม",19,281,281,350,631
978,"บางจาก","เขตพระโขนง",100905,"โรงจอดรถยนต์นิรันดร์คอนโดมิเนียม",20,263,259,336,595
979,"บางจาก","เขตพระโขนง",100905,"โรงจอดรถยนต์นิรันดร์คอนโดมิเนียม",21,289,279,332,611
980,"บางจาก","เขตพระโขนง",100905,"โรงจอดรถยนต์นิรันดร์คอนโดมิเนียม",22,297,258,332,590
981,"บางจาก","เขตพระโขนง",100905,"โรงจอดรถยนต์นิรันดร์คอนโดมิเนียม",23,304,266,367,633
982,"บางจาก","เขตพระโขนง",100905,"เต็นท์บริเวณลานอเนกประสงค์ศูนย์พัฒนาเด็กก่อนวัยเรียนหมู่บ้านนิรันดร์วิลล่า",24,180,230,262,492
983,"บางจาก","เขตพระโขนง",100905,"เต็นท์บริเวณลานอเนกประสงค์ศูนย์พัฒนาเด็กก่อนวัยเรียนหมู่บ้านนิรันดร์วิลล่า",25,160,200,261,461
984,"บางจาก","เขตพระโขนง",100905,"เต็นท์บริเวณลานอเนกประสงค์ศูนย์พัฒนาเด็กก่อนวัยเรียนหมู่บ้านนิรันดร์วิลล่า",26,149,232,278,510
985,"บางจาก","เขตพระโขนง",100905,"เต็นท์บริเวณลานอเนกประสงค์ศูนย์พัฒนาเด็กก่อนวัยเรียนหมู่บ้านนิรันดร์วิลล่า",27,227,205,260,465
986,"บางจาก","เขตพระโขนง",100905,"เต็นท์บริเวณลานอเนกประสงค์ศูนย์พัฒนาเด็กก่อนวัยเรียนหมู่บ้านนิรันดร์วิลล่า",28,162,223,244,467
987,"บางจาก","เขตพระโขนง",100905,"เต็นท์บริเวณลานอเนกประสงค์ศูนย์พัฒนาเด็กก่อนวัยเรียนหมู่บ้านนิรันดร์วิลล่า",29,175,229,286,515
988,"บางจาก","เขตพระโขนง",100905,"เต็นท์ลานจอดรถยนต์ปากซอยเกตุไพเราะ 3-5",30,172,266,321,587
989,"บางจาก","เขตพระโขนง",100905,"เต็นท์ลานจอดรถยนต์ปากซอยเกตุไพเราะ 3-5",31,158,247,331,578
990,"บางจาก","เขตพระโขนง",100905,"เต็นท์ลานจอดรถยนต์ปากซอยเกตุไพเราะ 3-5",32,259,278,394,672
991,"บางจาก","เขตพระโขนง",100905,"เต็นท์ลานจอดรถยนต์ปากซอยเกตุไพเราะ 3-5",33,200,258,344,602
992,"บางจาก","เขตพระโขนง",100905,"เต็นท์ลานจอดรถยนต์ปากซอยเกตุไพเราะ 3-5",34,240,301,335,636
993,"บางจาก","เขตพระโขนง",100905,"เต็นท์ลานจอดรถยนต์ปากซอยเกตุไพเราะ 3-5",35,224,256,349,605
994,"บางจาก","เขตพระโขนง",100905,"โรงเรียนวชิรธรรมสาธิต",36,139,183,229,412
995,"บางจาก","เขตพระโขนง",100905,"โรงเรียนวชิรธรรมสาธิต",37,112,206,241,447
996,"บางจาก","เขตพระโขนง",100905,"โรงเรียนวชิรธรรมสาธิต",38,163,225,278,503
997,"บางจาก","เขตพระโขนง",100905,"โรงเรียนวชิรธรรมสาธิต",39,142,218,247,465
998,"บางจาก","เขตพระโขนง",100905,"โรงเรียนวชิรธรรมสาธิต",40,167,197,258,455
999,"บางจาก","เขตพระโขนง",100905,"เต็นท์บริเวณลานจอดรถวัดวชิรธรรมสาธิตวรวิหาร",41,252,304,409,713
1000,"บางจาก","เขตพระโขนง",100905,"เต็นท์บริเวณลานจอดรถวัดวชิรธรรมสาธิตวรวิหาร",42,245,300,403,703
1001,"บางจาก","เขตพระโขนง",100905,"เต็นท์บริเวณลานจอดรถวัดวชิรธรรมสาธิตวรวิหาร",43,463,273,444,717
1002,"บางจาก","เขตพระโขนง",100905,"เต็นท์บริเวณลานจอดรถวัดวชิรธรรมสาธิตวรวิหาร",44,255,301,414,715
1003,"บางจาก","เขตพระโขนง",100905,"เต็นท์บริเวณลานจอดรถวัดวชิรธรรมสาธิตวรวิหาร",45,233,315,370,685
1004,"บางจาก","เขตพระโขนง",100905,"เต็นท์บริเวณลานจอดรถวัดวชิรธรรมสาธิตวรวิหาร",46,198,316,371,687
1005,"บางจาก","เขตพระโขนง",100905,"เต็นท์บริเวณลานจอดรถวัดวชิรธรรมสาธิตวรวิหาร",47,224,284,388,672
1006,"บางจาก","เขตพระโขนง",100905,"โรงเรียนนวลวรรณศึกษา",48,226,295,346,641
1007,"บางจาก","เขตพระโขนง",100905,"โรงเรียนนวลวรรณศึกษา",49,235,269,383,652
1008,"บางจาก","เขตพระโขนง",100905,"โรงเรียนนวลวรรณศึกษา",50,181,290,334,624
1009,"บางจาก","เขตพระโขนง",100905,"เต็นท์บริเวณปั๊มน้ำมันบางจาก ปากซอยอุดมสุข 45",51,421,315,450,765
1010,"บางจาก","เขตพระโขนง",100905,"เต็นท์บริเวณปั๊มน้ำมันบางจาก ปากซอยอุดมสุข 45",52,253,270,361,631
1011,"บางจาก","เขตพระโขนง",100905,"เต็นท์บริเวณที่ทำการชุมชนเฉลียง 5 ซอยอุดมสุข 45",53,120,229,262,491
1012,"บางจาก","เขตพระโขนง",100905,"เต็นท์บริเวณปั๊มน้ำมันเชลล์ ปากซอยวชิรธรรมสาธิต 57",54,232,294,396,690
1013,"บางจาก","เขตพระโขนง",100905,"เต็นท์บริเวณปั๊มน้ำมันเชลล์ ปากซอยวชิรธรรมสาธิต 57",55,385,270,429,699
1014,"บางจาก","เขตพระโขนง",100905,"เต็นท์บริเวณปั๊มน้ำมันเชลล์ ปากซอยวชิรธรรมสาธิต 57",56,248,302,400,702
1015,"บางจาก","เขตพระโขนง",100905,"เต็นท์บริเวณลานจอดรถบ้านเลขที่ 21/8 ชุมชนร่วมสามัคคี",57,254,339,388,727
1016,"บางจาก","เขตพระโขนง",100905,"เต็นท์บริเวณชุมชนหมู่บ้านสุขใจ ซอยวชิรธรรมสาธิต 43",58,197,223,314,537
1017,"บางจาก","เขตพระโขนง",100905,"เต็นท์บริเวณชุมชนหมู่บ้านสุขใจ ซอยวชิรธรรมสาธิต 43",59,166,247,260,507
1018,"บางจาก","เขตพระโขนง",100905,"เต็นท์บริเวณชุมชนหมู่บ้านสุขใจ ซอยวชิรธรรมสาธิต 43",60,210,230,316,546
1019,"บางจาก","เขตพระโขนง",100905,"เต็นท์บริเวณพื้นที่ว่างปากซอยวชิรธรรมสาธิต 34",61,302,281,351,632
1020,"บางจาก","เขตพระโขนง",100905,"เต็นท์บริเวณพื้นที่ว่างปากซอยวชิรธรรมสาธิต 34",62,183,261,356,617
1021,"บางจาก","เขตพระโขนง",100905,"เต็นท์บริเวณพื้นที่ว่างปากซอยวชิรธรรมสาธิต 34",63,217,299,366,665
1022,"บางจาก","เขตพระโขนง",100905,"เต็นท์บริเวณพื้นที่ว่างปากซอยวชิรธรรมสาธิต 34",64,182,257,347,604
1023,"บางจาก","เขตพระโขนง",100905,"เต็นท์บริเวณสนามเด็กเล่นหมู่บ้านรุ่งเจริญ",65,160,189,258,447
1024,"บางจาก","เขตพระโขนง",100905,"เต็นท์บริเวณสนามเด็กเล่นหมู่บ้านรุ่งเจริญ",66,187,178,302,480
1025,"บางจาก","เขตพระโขนง",100905,"โรงจอดรถบริเวณลานกีฬาชุมชนบุญกุศล",67,450,353,523,876
1026,"บางจาก","เขตพระโขนง",100905,"วิทยาลัยเทคโนโนลีกรุงเทพ",68,561,261,422,683
1027,"บางจาก","เขตพระโขนง",100905,"วิทยาลัยเทคโนโนลีกรุงเทพ",69,256,287,338,625
1028,"บางจาก","เขตพระโขนง",100905,"วิทยาลัยเทคโนโนลีกรุงเทพ",70,250,260,366,626
1029,"บางจาก","เขตพระโขนง",100905,"วิทยาลัยเทคโนโนลีกรุงเทพ",71,308,248,380,628
1030,"บางจาก","เขตพระโขนง",100905,"วิทยาลัยเทคโนโลยีสหะพาณิชย์บริหารธุรกิจ",72,174,197,277,474
1031,"บางจาก","เขตพระโขนง",100905,"วิทยาลัยเทคโนโลยีสหะพาณิชย์บริหารธุรกิจ",73,270,224,288,512
1032,"บางจาก","เขตพระโขนง",100905,"วิทยาลัยเทคโนโลยีสหะพาณิชย์บริหารธุรกิจ",74,187,238,293,531
1033,"บางจาก","เขตพระโขนง",100905,"วิทยาลัยเทคโนโลยีสหะพาณิชย์บริหารธุรกิจ",75,162,221,265,486
1034,"บางจาก","เขตพระโขนง",100905,"โรงเรียนวัดธรรมมงคล (หลวงพ่อวิริยังค์อุปถัมภ์)",76,242,251,343,594
1035,"บางจาก","เขตพระโขนง",100905,"โรงเรียนวัดธรรมมงคล (หลวงพ่อวิริยังค์อุปถัมภ์)",77,201,253,329,582
1036,"บางจาก","เขตพระโขนง",100905,"โรงเรียนวัดธรรมมงคล (หลวงพ่อวิริยังค์อุปถัมภ์)",78,156,266,305,571
1037,"บางจาก","เขตพระโขนง",100905,"โรงเรียนวัดธรรมมงคล (หลวงพ่อวิริยังค์อุปถัมภ์)",79,273,265,322,587
1038,"บางจาก","เขตพระโขนง",100905,"เต็นท์ภายในโรงเรียนพระกุมารเยซูวิทยา",80,238,334,394,728
1039,"บางจาก","เขตพระโขนง",100905,"เต็นท์ภายในโรงเรียนพระกุมารเยซูวิทยา",81,249,324,443,767
1040,"บางจาก","เขตพระโขนง",100905,"เต็นท์ภายในโรงเรียนพระกุมารเยซูวิทยา",82,258,291,394,685
1041,"บางจาก","เขตพระโขนง",100905,"เต็นท์ภายในโรงเรียนพระกุมารเยซูวิทยา",83,262,314,430,744
1042,"บางจาก","เขตพระโขนง",100905,"บริเวณลานอเนกประสงค์หมู่บ้านทับแก้ว ซอยวชิรธรรมสาธิต 29",84,210,267,319,586
1043,"บางจาก","เขตพระโขนง",100905,"เต็นท์บริเวณลานอเนกประสงค์หมู่บ้านทับแก้ว ซอยวชิรธรรมสาธิต 29",85,311,214,382,596
1044,"บางจาก","เขตพระโขนง",100905,"เต็นท์บริเวณสระน้ำภายในหมู่บ้านเมืองทอง 4",86,219,256,331,587
1045,"บางจาก","เขตพระโขนง",100905,"เต็นท์บริเวณสระน้ำภายในหมู่บ้านเมืองทอง 4",87,195,247,317,564
1046,"บางจาก","เขตพระโขนง",100905,"เต็นท์บริเวณสระน้ำภายในหมู่บ้านเมืองทอง 4",88,202,258,313,571
1047,"บางจาก","เขตพระโขนง",100905,"เต็นท์บริเวณสระน้ำภายในหมู่บ้านเมืองทอง 4",89,203,247,340,587
1048,"บางจาก","เขตพระโขนง",100905,"เต็นท์บริเวณสระน้ำภายในหมู่บ้านเมืองทอง 4",90,223,265,325,590
1049,"บางจาก","เขตพระโขนง",100905,"บริเวณชั้น 1 อาคาร ทรู ดิจิทัล พาร์ค (101 สแควร์)",91,286,207,290,497
1050,"บางจาก","เขตพระโขนง",100905,"บริเวณชั้น 1 อาคาร ทรู ดิจิทัล พาร์ค (101 สแควร์)",92,320,229,254,483
1051,"พระโขนงใต้","เขตพระโขนง",100910,"โรงจอดรถ บริษัท เมโทรแมชชีนเนอรี่ จำกัด",1,341,217,343,560
1052,"พระโขนงใต้","เขตพระโขนง",100910,"โรงจอดรถ บริษัท เมโทรแมชชีนเนอรี่ จำกัด",2,226,249,318,567
1053,"พระโขนงใต้","เขตพระโขนง",100910,"โรงจอดรถ บริษัท เมโทรแมชชีนเนอรี่ จำกัด",3,146,262,300,562
1054,"พระโขนงใต้","เขตพระโขนง",100910,"โรงเรียนบางจาก (นาคเผื่อนอุปถัมภ์)",4,187,235,307,542
1055,"พระโขนงใต้","เขตพระโขนง",100910,"โรงเรียนบางจาก (นาคเผื่อนอุปถัมภ์)",5,154,247,268,515
1056,"พระโขนงใต้","เขตพระโขนง",100910,"โรงเรียนบางจาก (นาคเผื่อนอุปถัมภ์)",6,159,246,256,502
1057,"พระโขนงใต้","เขตพระโขนง",100910,"โรงเรียนบางจาก (นาคเผื่อนอุปถัมภ์)",7,166,200,301,501
1058,"พระโขนงใต้","เขตพระโขนง",100910,"โรงเรียนสมหารศึกษา",8,195,222,271,493
1059,"พระโขนงใต้","เขตพระโขนง",100910,"เต้นท์บริเวณภายในพื้นที่บริษัท โฮมสุขุมวิท จำกัด (เต็นท์โรงเรียนสมถวิลเดิม)",9,319,263,363,626
1060,"พระโขนงใต้","เขตพระโขนง",100910,"เต้นท์บริเวณภายในพื้นที่บริษัท โฮมสุขุมวิท จำกัด(เต็นท์โรงเรียนสมถวิลเดิม)",10,313,268,345,613
1061,"พระโขนงใต้","เขตพระโขนง",100910,"เต็นท์บริเวณหน้าบ้านเลขที่ 32 และ 34 ซอยริมทางด่วน 62",11,167,223,306,529
1062,"พระโขนงใต้","เขตพระโขนง",100910,"ศาลาอเนกประสงค์ชุมชนหมู่บ้านสวนร่วมพัฒนา",12,114,218,231,449
1063,"พระโขนงใต้","เขตพระโขนง",100910,"เต็นท์ด้านข้างศาลาอเนกประสงค์ชุมชนหมู่บ้านสวนร่วมพัฒนา",13,98,224,239,463
1064,"พระโขนงใต้","เขตพระโขนง",100910,"วัดบุญรอดธรรมาราม",14,117,249,260,509
1065,"พระโขนงใต้","เขตพระโขนง",100910,"วัดบุญรอดธรรมาราม",15,198,263,307,570
1066,"พระโขนงใต้","เขตพระโขนง",100910,"ใต้อาคารหอประชุมโรงเรียนพระโขนงพิทยาลัย",16,171,189,220,409
1067,"พระโขนงใต้","เขตพระโขนง",100910,"ใต้อาคารหอประชุมโรงเรียนพระโขนงพิทยาลัย",17,132,201,206,407
1068,"พระโขนงใต้","เขตพระโขนง",100910,"โรงเรียนบพิธวิทยา",18,247,254,293,547
1069,"พระโขนงใต้","เขตพระโขนง",100910,"โรงเรียนบพิธวิทยา",19,245,241,292,533
1070,"พระโขนงใต้","เขตพระโขนง",100910,"โรงเรียนบพิธวิทยา",20,153,265,318,583
1071,"พระโขนงใต้","เขตพระโขนง",100910,"โรงเรียนพิพัฒนา",21,437,319,473,792
1072,"พระโขนงใต้","เขตพระโขนง",100910,"โรงเรียนพิพัฒนา",22,628,349,476,825
1073,"พระโขนงใต้","เขตพระโขนง",100910,"โรงเรียนพิพัฒนา",23,699,311,513,824
1074,"พระโขนงใต้","เขตพระโขนง",100910,"โรงเรียนพิพัฒนา",24,404,323,468,791
1075,"พระโขนงใต้","เขตพระโขนง",100910,"โรงเรียนพิพัฒนา",25,530,354,505,859
1076,"พระโขนงใต้","เขตพระโขนง",100910,"โรงเรียนพูนสิน (เพชรสุขอุปถัมภ์)",26,340,287,384,671
1077,"พระโขนงใต้","เขตพระโขนง",100910,"โรงเรียนพูนสิน (เพชรสุขอุปถัมภ์)",27,301,298,382,680
1078,"พระโขนงใต้","เขตพระโขนง",100910,"โรงเรียนพูนสิน (เพชรสุขอุปถัมภ์)",28,292,345,338,683
1079,"มีนบุรี","เขตมีนบุรี",101001,"เต็นท์บริเวณปั๊มน้ำมันซัสโก้ ถนนนิมิตใหม่ (1)",1,284,375,417,792
1080,"มีนบุรี","เขตมีนบุรี",101001,"เต็นท์บริเวณปั๊มน้ำมันซัสโก้ ถนนนิมิตใหม่ (2)",2,323,376,448,824
1081,"มีนบุรี","เขตมีนบุรี",101001,"เต็นท์บริเวณปั๊มน้ำมันซัสโก้ ถนนนิมิตใหม่ (3)",3,295,328,422,750
1082,"มีนบุรี","เขตมีนบุรี",101001,"เต็นท์บริเวณปั๊มน้ำมันซัสโก้ ถนนนิมิตใหม่ (4)",4,431,358,448,806
1083,"มีนบุรี","เขตมีนบุรี",101001,"เต็นท์บริเวณปั๊มน้ำมันซัสโก้ ถนนนิมิตใหม่ (5)",5,318,380,440,820
1084,"มีนบุรี","เขตมีนบุรี",101001,"เต็นท์บริเวณสนามเด็กเล่นหมู่บ้านบ้านฟ้านันทวัน ถนนประชาร่วมใจ (1)",6,193,312,347,659
1085,"มีนบุรี","เขตมีนบุรี",101001,"เต็นท์บริเวณสนามเด็กเล่นหมู่บ้านบ้านฟ้านันทวัน ถนนประชาร่วมใจ (2)",7,266,288,404,692
1086,"มีนบุรี","เขตมีนบุรี",101001,"เต็นท์บริเวณสนามเด็กเล่นหมู่บ้านบ้านฟ้านันทวัน ถนนประชาร่วมใจ (3)",8,271,315,391,706
1087,"มีนบุรี","เขตมีนบุรี",101001,"เต็นท์บริเวณสนามเด็กเล่นหมู่บ้านบ้านฟ้านันทวัน ถนนประชาร่วมใจ (4)",9,313,308,394,702
1088,"มีนบุรี","เขตมีนบุรี",101001,"โรงเรียนวัดแสนสุข",10,147,256,277,533
1089,"มีนบุรี","เขตมีนบุรี",101001,"โรงจอดรถสำนักงานเกษตรเขตมีนบุรี",11,120,293,345,638
1090,"มีนบุรี","เขตมีนบุรี",101001,"โรงเรียนมีนบุรี",12,274,420,377,797
1091,"มีนบุรี","เขตมีนบุรี",101001,"หน้าสำนักงานตลาดนัดจตุจักร 2 (เมืองมีน) (1)",13,202,242,314,556
1092,"มีนบุรี","เขตมีนบุรี",101001,"หน้าสำนักงานตลาดนัดจตุจักร 2 (เมืองมีน) (2)",14,302,277,346,623
1093,"มีนบุรี","เขตมีนบุรี",101001,"หน้าสำนักงานตลาดนัดจตุจักร 2 (เมืองมีน) (3)",15,262,271,291,562
1094,"มีนบุรี","เขตมีนบุรี",101001,"เต็นท์บริเวณลานจอดรถสำนักงานประกันสังคม พื้นที่ 10 (1)",16,265,324,383,707
1095,"มีนบุรี","เขตมีนบุรี",101001,"เต็นท์บริเวณลานจอดรถสำนักงานประกันสังคม พื้นที่ 10 (2)",17,310,336,372,708
1096,"มีนบุรี","เขตมีนบุรี",101001,"เต็นท์บริเวณปากซอยเสรีไทย 68 ถนนเสรีไทย",18,351,427,517,944
1097,"มีนบุรี","เขตมีนบุรี",101001,"โรงเรียนสุเหร่าบางชัน",19,153,298,364,662
1098,"มีนบุรี","เขตมีนบุรี",101001,"แฟลตการเคหะนครหลวง สาขาบางชัน (แฟลต 5) (1)",20,283,318,389,707
1099,"มีนบุรี","เขตมีนบุรี",101001,"แฟลตการเคหะนครหลวง สาขาบางชัน (แฟลต 5) (2)",21,275,330,354,684
1100,"มีนบุรี","เขตมีนบุรี",101001,"สถานีดับเพลิงและกู้ภัยบางชัน (1)",22,145,253,292,545
1101,"มีนบุรี","เขตมีนบุรี",101001,"สถานีดับเพลิงและกู้ภัยบางชัน (2)",23,193,305,334,639
1102,"มีนบุรี","เขตมีนบุรี",101001,"สถานีดับเพลิงและกู้ภัยบางชัน (3)",24,182,283,341,624
1103,"มีนบุรี","เขตมีนบุรี",101001,"เต็นท์บริเวณลานอเนกประสงค์บ้านเอื้ออาทรมีนบุรี (1)",25,424,371,455,826
1104,"มีนบุรี","เขตมีนบุรี",101001,"เต็นท์บริเวณลานอเนกประสงค์บ้านเอื้ออาทรมีนบุรี (2)",26,422,394,465,859
1105,"มีนบุรี","เขตมีนบุรี",101001,"เต็นท์บริเวณลานอเนกประสงค์บ้านเอื้ออาทรมีนบุรี (3)",27,417,381,458,839
1106,"มีนบุรี","เขตมีนบุรี",101001,"เต็นท์บริเวณลานอเนกประสงค์บ้านเอื้ออาทรมีนบุรี (4)",28,396,377,441,818
1107,"มีนบุรี","เขตมีนบุรี",101001,"เต็นท์บริเวณลานอเนกประสงค์บ้านเอื้ออาทรมีนบุรี (5)",29,434,363,510,873
1108,"มีนบุรี","เขตมีนบุรี",101001,"เต็นท์บริเวณโรงเรียนเศรษฐบุตรบำเพ็ญ (1)",30,460,349,478,827
1109,"มีนบุรี","เขตมีนบุรี",101001,"เต็นท์บริเวณโรงเรียนเศรษฐบุตรบำเพ็ญ (2)",31,316,402,409,811
1110,"มีนบุรี","เขตมีนบุรี",101001,"เต็นท์บริเวณโรงเรียนเศรษฐบุตรบำเพ็ญ (3)",32,309,329,419,748
1111,"มีนบุรี","เขตมีนบุรี",101001,"ศาลาอเนกประสงค์ลานกีฬาหมู่บ้านปรีชา 11",33,297,374,409,783
1112,"มีนบุรี","เขตมีนบุรี",101001,"เต็นท์บริเวณลานกีฬาชุมชนหมู่บ้านสินธานี 2",34,275,266,384,650
1113,"มีนบุรี","เขตมีนบุรี",101001,"เต็นท์บริเวณร้านย่างเนย ปากซอยรามอินทรา 117 (1)",35,186,257,284,541
1114,"มีนบุรี","เขตมีนบุรี",101001,"เต็นท์บริเวณร้านย่างเนย ปากซอยรามอินทรา 117 (2)",36,278,276,304,580
1115,"มีนบุรี","เขตมีนบุรี",101001,"เต็นท์บริเวณโรงเรียนนูรุ้ลอิสลามศาสนวิทยา (1)",37,305,368,432,800
1116,"มีนบุรี","เขตมีนบุรี",101001,"เต็นท์บริเวณโรงเรียนนูรุ้ลอิสลามศาสนวิทยา (2)",38,223,314,364,678
1117,"มีนบุรี","เขตมีนบุรี",101001,"เต็นท์บริเวณโรงเรียนนูรุ้ลอิสลามศาสนวิทยา (3)",39,203,320,376,696
1118,"มีนบุรี","เขตมีนบุรี",101001,"โรงจอดรถห้างบิ๊กซี สาขาสุวินทวงศ์ (1)",40,330,307,376,683
1119,"มีนบุรี","เขตมีนบุรี",101001,"โรงจอดรถห้างบิ๊กซี สาขาสุวินทวงศ์ (2)",41,220,328,357,685
1120,"มีนบุรี","เขตมีนบุรี",101001,"เต็นท์บริเวณมูลนิธิเทียนฟ้า ถนนหทัยราษฎร์ (1)",42,312,323,369,692
1121,"มีนบุรี","เขตมีนบุรี",101001,"เต็นท์บริเวณมูลนิธิเทียนฟ้า ถนนหทัยราษฎร์ (2)",43,298,268,378,646
1122,"มีนบุรี","เขตมีนบุรี",101001,"เต็นท์บริเวณมูลนิธิเทียนฟ้า ถนนหทัยราษฎร์ (3)",44,226,296,355,651
1123,"มีนบุรี","เขตมีนบุรี",101001,"เต็นท์บริเวณมูลนิธิเทียนฟ้า ถนนหทัยราษฎร์ (4)",45,227,316,344,660
1124,"มีนบุรี","เขตมีนบุรี",101001,"เต็นท์บริเวณมูลนิธิเทียนฟ้า ถนนหทัยราษฎร์ (5)",46,157,261,349,610
1125,"มีนบุรี","เขตมีนบุรี",101001,"เต็นท์บริเวณมูลนิธิเทียนฟ้า ถนนหทัยราษฎร์ (6)",47,223,306,312,618
1126,"มีนบุรี","เขตมีนบุรี",101001,"เต็นท์บริเวณมูลนิธิเทียนฟ้า ถนนหทัยราษฎร์ (7)",48,184,306,352,658
1127,"มีนบุรี","เขตมีนบุรี",101001,"เต็นท์บริเวณมูลนิธิเทียนฟ้า ถนนหทัยราษฎร์ (8)",49,268,308,379,687
1128,"มีนบุรี","เขตมีนบุรี",101001,"เต็นท์บริเวณลานจอดรถร้านต้นข้าว ถนนสามวา (1)",50,350,315,443,758
1129,"มีนบุรี","เขตมีนบุรี",101001,"เต็นท์บริเวณลานจอดรถร้านต้นข้าว ถนนสามวา (2)",51,349,313,418,731
1130,"มีนบุรี","เขตมีนบุรี",101001,"เต็นท์บริเวณลานจอดรถร้านต้นข้าว ถนนสามวา (3)",52,252,299,367,666
1131,"มีนบุรี","เขตมีนบุรี",101001,"โรงเรียนคลองสองต้นนุ่น",53,474,411,579,990
1132,"มีนบุรี","เขตมีนบุรี",101001,"เต็นท์บริเวณโรงเรียนคลองสองต้นนุ่น (1)",54,352,406,506,912
1133,"มีนบุรี","เขตมีนบุรี",101001,"เต็นท์บริเวณโรงเรียนคลองสองต้นนุ่น (2)",55,553,435,542,977
1134,"มีนบุรี","เขตมีนบุรี",101001,"เต็นท์บริเวณโรงเรียนคลองสองต้นนุ่น (3)",56,234,464,484,948
1135,"มีนบุรี","เขตมีนบุรี",101001,"เต็นท์บริเวณโรงเรียนคลองสองต้นนุ่น (4)",57,550,383,496,879
1136,"มีนบุรี","เขตมีนบุรี",101001,"โชว์รูมอีซูซุ ถนนร่มเกล้า",58,315,312,378,690
1137,"มีนบุรี","เขตมีนบุรี",101001,"เต็นท์บริเวณทางเข้าหมู่บ้านรุ่งนภา เพลส ซอยร่มเกล้า 16 (1)",59,212,352,401,753
1138,"มีนบุรี","เขตมีนบุรี",101001,"เต็นท์บริเวณทางเข้าหมู่บ้านรุ่งนภา เพลส ซอยร่มเกล้า 16 (2)",60,304,358,410,768
1139,"มีนบุรี","เขตมีนบุรี",101001,"มหาวิทยาลัยเกษมบัณฑิต",61,396,409,459,868
1140,"มีนบุรี","เขตมีนบุรี",101001,"เต็นท์บริเวณห้างไทวัสดุ ถนนรามคำแหง",62,327,373,476,849
1141,"มีนบุรี","เขตมีนบุรี",101001,"โรงเรียนมีนประสาทวิทยา",63,157,295,301,596
1142,"มีนบุรี","เขตมีนบุรี",101001,"ศาลาอเนกประสงค์การเคหะนครหลวง สาขารามคำแหง (1)",64,214,389,412,801
1143,"มีนบุรี","เขตมีนบุรี",101001,"ศาลาอเนกประสงค์การเคหะนครหลวง สาขารามคำแหง (2)",65,289,337,408,745
1144,"มีนบุรี","เขตมีนบุรี",101001,"เต็นท์บริเวณศาลาอเนกประสงค์การเคหะนครหลวง สาขารามคำแหง (1)",66,290,352,405,757
1145,"มีนบุรี","เขตมีนบุรี",101001,"เต็นท์บริเวณศาลาอเนกประสงค์การเคหะนครหลวง สาขารามคำแหง (2)",67,263,316,418,734
1146,"มีนบุรี","เขตมีนบุรี",101001,"เต็นท์บริเวณศาลาอเนกประสงค์การเคหะนครหลวง สาขารามคำแหง (3)",68,306,358,437,795
1147,"มีนบุรี","เขตมีนบุรี",101001,"เต็นท์บริเวณศาลาอเนกประสงค์การเคหะนครหลวง สาขารามคำแหง (4)",69,271,322,442,764
1148,"มีนบุรี","เขตมีนบุรี",101001,"เต็นท์บริเวณศาลาอเนกประสงค์การเคหะนครหลวง สาขารามคำแหง (5)",70,329,343,423,766
1149,"มีนบุรี","เขตมีนบุรี",101001,"เต็นท์บริเวณสนามข้างสระว่ายน้ำหน้าหมู่บ้านพาร์คเวย์ ชาเล่ต์ (1)",71,300,294,420,714
1150,"มีนบุรี","เขตมีนบุรี",101001,"เต็นท์บริเวณสนามข้างสระว่ายน้ำหน้าหมู่บ้านพาร์คเวย์ ชาเล่ต์ (2)",72,336,294,416,710
1151,"มีนบุรี","เขตมีนบุรี",101001,"เต็นท์บริเวณลานกีฬาหมู่บ้านรินทร์ทอง (1)",73,237,285,347,632
1152,"มีนบุรี","เขตมีนบุรี",101001,"เต็นท์บริเวณลานกีฬาหมู่บ้านรินทร์ทอง (2)",74,240,272,354,626
1153,"มีนบุรี","เขตมีนบุรี",101001,"เต็นท์บริเวณลานกีฬาหมู่บ้านรินทร์ทอง (3)",75,231,273,351,624
1154,"มีนบุรี","เขตมีนบุรี",101001,"เต็นท์บริเวณลานกีฬาหมู่บ้านรินทร์ทอง (4)",76,241,285,337,622
1155,"มีนบุรี","เขตมีนบุรี",101001,"เต็นท์บริเวณหน้าโชว์รูมฮอนด้า (1)",77,240,244,328,572
1156,"มีนบุรี","เขตมีนบุรี",101001,"เต็นท์บริเวณหน้าโชว์รูมฮอนด้า (2)",78,194,287,305,592
1157,"มีนบุรี","เขตมีนบุรี",101001,"เต็นท์บริเวณหน้าโชว์รูมฮอนด้า (3)",79,186,227,293,520
1158,"มีนบุรี","เขตมีนบุรี",101001,"เต็นท์บริเวณโรงเรียนร่วมฤดีวิเทศศึกษา (นานาชาติ) (1)",80,233,234,286,520
1159,"มีนบุรี","เขตมีนบุรี",101001,"เต็นท์บริเวณโรงเรียนร่วมฤดีวิเทศศึกษา (นานาชาติ) (2)",81,250,238,300,538
1160,"มีนบุรี","เขตมีนบุรี",101001,"เต็นท์บริเวณสถานีก๊าซ ปตท. เอ็นจีวี สาขาเอเชียมีนบุรี ถนนรามคำแหง (1)",82,263,260,385,645
1161,"มีนบุรี","เขตมีนบุรี",101001,"เต็นท์บริเวณสถานีก๊าซ ปตท. เอ็นจีวี สาขาเอเชียมีนบุรี ถนนรามคำแหง (2)",83,347,316,397,713
1162,"มีนบุรี","เขตมีนบุรี",101001,"เต็นท์บริเวณสถานีก๊าซ ปตท. เอ็นจีวี สาขาเอเชียมีนบุรี ถนนรามคำแหง (3)",84,259,301,370,671
1163,"มีนบุรี","เขตมีนบุรี",101001,"เต็นท์บริเวณสถานีก๊าซ ปตท. เอ็นจีวี สาขาเอเชียมีนบุรี ถนนรามคำแหง (4)",85,191,283,335,618
1164,"มีนบุรี","เขตมีนบุรี",101001,"เต็นท์บริเวณหน้าหมู่บ้านเบญจรงค์ (1)",86,281,339,432,771
1165,"มีนบุรี","เขตมีนบุรี",101001,"เต็นท์บริเวณหน้าหมู่บ้านเบญจรงค์ (2)",87,255,331,376,707
1166,"มีนบุรี","เขตมีนบุรี",101001,"เต็นท์บริเวณลานกีฬาหมู่บ้านบัวขาว (ฝั่งนอก) (1)",88,276,350,430,780
1167,"มีนบุรี","เขตมีนบุรี",101001,"เต็นท์บริเวณลานกีฬาหมู่บ้านบัวขาว (ฝั่งนอก) (2)",89,270,358,406,764
1168,"มีนบุรี","เขตมีนบุรี",101001,"เต็นท์บริเวณลานกีฬาหมู่บ้านบัวขาว (ฝั่งนอก) (3)",90,311,334,418,752
1169,"มีนบุรี","เขตมีนบุรี",101001,"เต็นท์บริเวณลานกีฬาหมู่บ้านบัวขาว (ฝั่งนอก) (4)",91,397,347,470,817
1170,"มีนบุรี","เขตมีนบุรี",101001,"เต็นท์บริเวณหน้าองค์พระหมู่บ้านบัวขาว (ฝั่งใน) (1)",92,312,382,507,889
1171,"มีนบุรี","เขตมีนบุรี",101001,"เต็นท์บริเวณหน้าองค์พระหมู่บ้านบัวขาว (ฝั่งใน) (2)",93,290,403,460,863
1172,"มีนบุรี","เขตมีนบุรี",101001,"เต็นท์บริเวณหน้าองค์พระหมู่บ้านบัวขาว (ฝั่งใน) (3)",94,442,369,548,917
1173,"มีนบุรี","เขตมีนบุรี",101001,"เต็นท์บริเวณสนามข้างสโมสรหมู่บ้านเพอร์เฟค เฟส 4 (1)",95,297,330,414,744
1174,"มีนบุรี","เขตมีนบุรี",101001,"เต็นท์บริเวณสนามข้างสโมสรหมู่บ้านเพอร์เฟค เฟส 4 (2)",96,304,346,425,771
1175,"มีนบุรี","เขตมีนบุรี",101001,"เต็นท์บริเวณสนามข้างสโมสรหมู่บ้านเพอร์เฟค เฟส 4 (3)",97,404,366,479,845
1176,"มีนบุรี","เขตมีนบุรี",101001,"เต็นท์บริเวณชุมชนลำนายโส",98,117,255,256,511
1177,"มีนบุรี","เขตมีนบุรี",101001,"โรงจอดรถสำนักงานสรรพากรพื้นที่ 21 (โรงจอดรถใหม่) (1)",99,297,275,358,633
1178,"มีนบุรี","เขตมีนบุรี",101001,"โรงจอดรถสำนักงานสรรพากรพื้นที่ 21 (โรงจอดรถใหม่) (2)",100,273,348,409,757
1179,"มีนบุรี","เขตมีนบุรี",101001,"โรงจอดรถสำนักงานสรรพากรพื้นที่ 21 (โรงจอดรถใหม่) (3)",101,255,280,387,667
1180,"มีนบุรี","เขตมีนบุรี",101001,"โรงจอดรถสำนักงานสรรพากรพื้นที่ 21 (โรงจอดรถใหม่) (4)",102,238,295,351,646
1181,"มีนบุรี","เขตมีนบุรี",101001,"โรงจอดรถสำนักงานสรรพากรพื้นที่ 21 (โรงจอดรถใหม่) (5)",103,213,310,354,664
1182,"มีนบุรี","เขตมีนบุรี",101001,"โรงจอดรถสำนักงานสรรพากรพื้นที่ 21 (โรงจอดรถใหม่) (6)",104,246,289,354,643
1183,"แสนแสบ","เขตมีนบุรี",101002,"โรงเรียนศาลาคู้",1,196,346,399,745
1184,"แสนแสบ","เขตมีนบุรี",101002,"เต็นท์บริเวณโรงเรียนศาลาคู้ (1)",2,211,371,417,788
1185,"แสนแสบ","เขตมีนบุรี",101002,"เต็นท์บริเวณโรงเรียนศาลาคู้ (2)",3,207,380,394,774
1186,"แสนแสบ","เขตมีนบุรี",101002,"เต็นท์บริเวณโรงเรียนศาลาคู้ (3)",4,219,391,413,804
1187,"แสนแสบ","เขตมีนบุรี",101002,"เต็นท์บริเวณทางเข้าหมู่บ้านพลอยชมพู (1)",5,318,418,438,856
1188,"แสนแสบ","เขตมีนบุรี",101002,"เต็นท์บริเวณทางเข้าหมู่บ้านพลอยชมพู (2)",6,334,410,454,864
1189,"แสนแสบ","เขตมีนบุรี",101002,"เต็นท์บริเวณทางเข้าหมู่บ้านพลอยชมพู (3)",7,343,391,495,886
1190,"แสนแสบ","เขตมีนบุรี",101002,"เต็นท์บริเวณโรงเรียนสุเหร่าทรายกองดิน (1)",8,256,448,459,907
1191,"แสนแสบ","เขตมีนบุรี",101002,"เต็นท์บริเวณโรงเรียนสุเหร่าทรายกองดิน (2)",9,265,406,470,876
1192,"แสนแสบ","เขตมีนบุรี",101002,"เต็นท์บริเวณโรงเรียนสุเหร่าทรายกองดิน (3)",10,255,392,428,820
1193,"แสนแสบ","เขตมีนบุรี",101002,"เต็นท์บริเวณโรงเรียนอิดด์ฮาร์ดอุลูมุดดีน (1)",11,226,410,420,830
1194,"แสนแสบ","เขตมีนบุรี",101002,"เต็นท์บริเวณโรงเรียนอิดด์ฮาร์ดอุลูมุดดีน (2)",12,279,321,364,685
1195,"แสนแสบ","เขตมีนบุรี",101002,"เต็นท์บริเวณโรงเรียนอิดด์ฮาร์ดอุลูมุดดีน (3)",13,202,346,334,680
1196,"แสนแสบ","เขตมีนบุรี",101002,"เต็นท์บริเวณมัสยิดกมาลุ้ลเอี๊ยะห์ซาน (1)",14,152,297,328,625
1197,"แสนแสบ","เขตมีนบุรี",101002,"เต็นท์บริเวณมัสยิดกมาลุ้ลเอี๊ยะห์ซาน (2)",15,111,272,280,552
1198,"แสนแสบ","เขตมีนบุรี",101002,"เต็นท์บริเวณลานอเนกประสงค์สวนพระยาภิรมย์ ถนนราษฎร์อุทิศ (1)",16,186,284,359,643
1199,"แสนแสบ","เขตมีนบุรี",101002,"เต็นท์บริเวณลานอเนกประสงค์สวนพระยาภิรมย์ ถนนราษฎร์อุทิศ (2)",17,182,278,288,566
1200,"แสนแสบ","เขตมีนบุรี",101002,"โรงอาหารการไฟฟ้า สาขาลาดกระบัง ถนนสุวินทวงศ์",18,383,410,509,919
1201,"แสนแสบ","เขตมีนบุรี",101002,"เต็นท์บริเวณการประปามีนบุรี",19,184,191,267,458
1202,"แสนแสบ","เขตมีนบุรี",101002,"เต็นท์บริเวณสโมสรหมู่บ้านปรีชา ถนนร่มเกล้า",20,384,390,507,897
1203,"แสนแสบ","เขตมีนบุรี",101002,"เต็นท์บริเวณทางเข้าชุมชนทองสงวน (1)",21,224,359,423,782
1204,"แสนแสบ","เขตมีนบุรี",101002,"เต็นท์บริเวณทางเข้าชุมชนทองสงวน (2)",22,192,348,386,734
1205,"แสนแสบ","เขตมีนบุรี",101002,"เต็นท์บริเวณทางเข้าชุมชนทองสงวน (3)",23,224,382,387,769
1206,"แสนแสบ","เขตมีนบุรี",101002,"อาคารสโมสรหมู่บ้านปัญฐิญา",24,320,319,400,719
1207,"แสนแสบ","เขตมีนบุรี",101002,"เต็นท์บริเวณลานกีฬาหมู่บ้านเคหะสุวินทวงศ์",25,383,407,474,881
1208,"แสนแสบ","เขตมีนบุรี",101002,"เต็นท์บริเวณวิทยาลัยเทคนิคกาญจนาภิเษกมหานคร (1)",26,312,336,425,761
1209,"แสนแสบ","เขตมีนบุรี",101002,"เต็นท์บริเวณวิทยาลัยเทคนิคกาญจนาภิเษกมหานคร (2)",27,293,349,416,765
1210,"แสนแสบ","เขตมีนบุรี",101002,"เต็นท์บริเวณวิทยาลัยเทคนิคกาญจนาภิเษกมหานคร (3)",28,189,369,391,760
1211,"แสนแสบ","เขตมีนบุรี",101002,"เต็นท์บริเวณวิทยาลัยเทคนิคกาญจนาภิเษกมหานคร (4)",29,348,360,403,763
1212,"แสนแสบ","เขตมีนบุรี",101002,"เต็นท์บริเวณวิทยาลัยเทคนิคกาญจนาภิเษกมหานคร (5)",30,327,321,420,741
1213,"แสนแสบ","เขตมีนบุรี",101002,"เต็นท์บริเวณวิทยาลัยเทคนิคกาญจนาภิเษกมหานคร (6)",31,215,389,406,795
1214,"แสนแสบ","เขตมีนบุรี",101002,"โรงเรียนบ้านเกาะ (1)",32,171,316,288,604
1215,"แสนแสบ","เขตมีนบุรี",101002,"โรงเรียนบ้านเกาะ (2)",33,158,277,307,584
1216,"แสนแสบ","เขตมีนบุรี",101002,"โรงเรียนนาดาวิทยาทาน (1)",34,236,406,464,870
1217,"แสนแสบ","เขตมีนบุรี",101002,"โรงเรียนนาดาวิทยาทาน (2)",35,220,415,419,834
1218,"แสนแสบ","เขตมีนบุรี",101002,"โรงเรียนคลองสาม (1)",36,190,357,379,736
1219,"แสนแสบ","เขตมีนบุรี",101002,"โรงเรียนคลองสาม (2)",37,184,354,357,711
1220,"แสนแสบ","เขตมีนบุรี",101002,"เต็นท์บริเวณโรงเรียนคลองสาม (1)",38,217,359,350,709
1221,"แสนแสบ","เขตมีนบุรี",101002,"เต็นท์บริเวณโรงเรียนคลองสาม (2)",39,183,344,376,720
1222,"แสนแสบ","เขตมีนบุรี",101002,"เต็นท์บริเวณทางเข้าหมู่บ้านเค.ซี.เนเชอรัลวิลล์ ถ.ร่มเกล้า (1)",40,310,299,425,724
1223,"แสนแสบ","เขตมีนบุรี",101002,"เต็นท์บริเวณทางเข้าหมู่บ้านเค.ซี.เนเชอรัลวิลล์ ถ.ร่มเกล้า (2)",41,295,318,363,681
1224,"แสนแสบ","เขตมีนบุรี",101002,"โรงเรียนวังเล็กวิทยานุสรณ์ (1)",42,209,312,344,656
1225,"แสนแสบ","เขตมีนบุรี",101002,"โรงเรียนวังเล็กวิทยานุสรณ์ (2)",43,222,313,353,666
1226,"แสนแสบ","เขตมีนบุรี",101002,"เต็นท์บริเวณโรงเรียนวังเล็กวิทยานุสรณ์ (1)",44,308,341,351,692
1227,"แสนแสบ","เขตมีนบุรี",101002,"เต็นท์บริเวณโรงเรียนวังเล็กวิทยานุสรณ์ (2)",45,250,301,353,654
1228,"แสนแสบ","เขตมีนบุรี",101002,"เต็นท์บริเวณโรงเรียนวังเล็กวิทยานุสรณ์ (3)",46,153,311,332,643
1229,"แสนแสบ","เขตมีนบุรี",101002,"เต็นท์บริเวณโรงเรียนวังเล็กวิทยานุสรณ์ (4)",47,175,329,359,688
1230,"ลาดกระบัง","เขตลาดกระบัง",101101,"เต็นท์ลานจอดรถข้างศาลเจ้าแป๊ะกง ซอยลาดกระบัง 15/4",1,187,218,277,495
1231,"ลาดกระบัง","เขตลาดกระบัง",101101,"ลานโดมอเนกประสงค์สวนพระนคร",2,163,190,232,422
1232,"ลาดกระบัง","เขตลาดกระบัง",101101,"ลานโดมอเนกประสงค์สวนพระนคร",3,275,300,403,703
1233,"ลาดกระบัง","เขตลาดกระบัง",101101,"ลานโดมอเนกประสงค์สวนพระนคร",4,206,319,397,716
1234,"ลาดกระบัง","เขตลาดกระบัง",101101,"เต็นท์โครงการ เอเวียนวิลเลจ ซอยลาดกระบัง 46/1",5,254,317,342,659
1235,"ลาดกระบัง","เขตลาดกระบัง",101101,"เต็นท์โครงการ เอเวียนวิลเลจ ซอยลาดกระบัง 46/1",6,202,290,320,610
1236,"ลาดกระบัง","เขตลาดกระบัง",101101,"เต็นท์โครงการ เอเวียนวิลเลจ ซอยลาดกระบัง 46/1",7,248,299,377,676
1237,"ลาดกระบัง","เขตลาดกระบัง",101101,"ลานโดมอเนกประสงค์ชุมชนหมู่บ้านเคหะนคร 2",8,245,322,372,694
1238,"ลาดกระบัง","เขตลาดกระบัง",101101,"เต็นท์สนามเด็กเล่นชุมชนหมู่บ้านเคหะนคร 2 ซอย 9",9,257,284,373,657
1239,"ลาดกระบัง","เขตลาดกระบัง",101101,"เต็นท์สนามเด็กเล่นชุมชนหมู่บ้านเคหะนคร 2 ซอย 9",10,256,332,343,675
1240,"ลาดกระบัง","เขตลาดกระบัง",101101,"เต็นท์ลานจอดรถตลาดผลเจริญ ซ.ลาดกระบัง 30/2",11,235,305,354,659
1241,"ลาดกระบัง","เขตลาดกระบัง",101101,"เต็นท์ลานจอดรถร้านเซเว่นอีเลฟเว่น ซอยลาดกระบัง 26",12,273,296,366,662
1242,"ลาดกระบัง","เขตลาดกระบัง",101101,"เต็นท์ลานจอดรถร้านเซ่เว่นอีเลฟเว่น ซอยลาดกระบัง 26",13,303,294,350,644
1243,"ลาดกระบัง","เขตลาดกระบัง",101101,"เต็นท์หน้าโชว์รูมโตโยต้า ที.บี.เอ็น. เดอะพาซิโอ",14,498,407,542,949
1244,"ลาดกระบัง","เขตลาดกระบัง",101101,"โรงขายอาหารใกล้ปากซอยลาดกระบัง 14/2 (อู่สีกรุงเทพ)",15,276,411,451,862
1245,"ลาดกระบัง","เขตลาดกระบัง",101101,"ลานอเนกประสงค์โรงเรียนประเวศพิทยาคาร ซอยลาดกระบัง 14",16,509,434,568,1002
1246,"ลาดกระบัง","เขตลาดกระบัง",101101,"ลานอเนกประสงค์โรงเรียนประเวศพิทยาคาร ซอยลาดกระบัง 14",17,790,398,634,1032
1247,"ลาดกระบัง","เขตลาดกระบัง",101101,"เต็นท์ลานจอดรถร้านเซเว่นอีเลฟเว่น ปากซอยลาดกระบัง 2/1",18,201,303,312,615
1248,"ลาดกระบัง","เขตลาดกระบัง",101101,"อาคารโรงเรียนอนุบาลพร้อม ซอยลาดกระบัง 1 ก/18",19,269,287,378,665
1249,"ลาดกระบัง","เขตลาดกระบัง",101101,"อาคารโรงเรียนอนุบาลพร้อม ซอยลาดกระบัง 1 ก/18",20,248,268,322,590
1250,"ลาดกระบัง","เขตลาดกระบัง",101101,"อาคารโรงเรียนอนุบาลพร้อม ซอยลาดกระบัง 1 ก/18",21,366,308,362,670
1251,"ลาดกระบัง","เขตลาดกระบัง",101101,"ลานโดมอเนกประสงค์โรงเรียนวัดลานบุญ",22,172,266,327,593
1252,"ลาดกระบัง","เขตลาดกระบัง",101101,"ลานโดมอเนกประสงค์โรงเรียนวัดลานบุญ",23,205,294,334,628
1253,"ลาดกระบัง","เขตลาดกระบัง",101101,"ลานโดมอเนกประสงค์โรงเรียนวัดลานบุญ",24,247,317,411,728
1254,"ลาดกระบัง","เขตลาดกระบัง",101101,"ลานโดมอเนกประสงค์โรงเรียนวัดสังฆราชา",25,343,412,477,889
1255,"ลาดกระบัง","เขตลาดกระบัง",101101,"ลานโดมอเนกประสงค์โรงเรียนวัดสังฆราชา",26,443,350,504,854
1256,"ลาดกระบัง","เขตลาดกระบัง",101101,"ลานโดมอเนกประสงค์โรงเรียนวัดสังฆราชา",27,284,387,440,827
1257,"ลาดกระบัง","เขตลาดกระบัง",101101,"ลานโดมอเนกประสงค์โรงเรียนวัดลาดกระบัง",28,179,322,355,677
1258,"ลาดกระบัง","เขตลาดกระบัง",101101,"ลานโดมอเนกประสงค์โรงเรียนวัดลาดกระบัง",29,173,339,318,657
1259,"ลาดกระบัง","เขตลาดกระบัง",101101,"ลานโดมอเนกประสงค์โรงเรียนวัดลาดกระบัง",30,194,256,328,584
1260,"ลาดกระบัง","เขตลาดกระบัง",101101,"ลานโดมอเนกประสงค์โรงเรียนวัดลาดกระบัง",31,191,314,368,682
1261,"ลาดกระบัง","เขตลาดกระบัง",101101,"เต็นท์บริเวณลานจอดรถหอพักบ้านแสงวิวัฒน์ ซอยลาดกระบัง 9/1",32,210,300,332,632
1262,"ลาดกระบัง","เขตลาดกระบัง",101101,"ลานโดมอเนกประสงค์โรงเรียนวัดปลูกศรัทธา",33,200,211,256,467
1263,"ลาดกระบัง","เขตลาดกระบัง",101101,"ลานโดมอเนกประสงค์โรงเรียนวัดปลูกศรัทธา",34,186,215,297,512
1264,"ลาดกระบัง","เขตลาดกระบัง",101101,"โรงเรียนศึกษาพัฒนา",35,121,224,203,427
1265,"ลาดกระบัง","เขตลาดกระบัง",101101,"โรงเรียนศึกษาพัฒนา",36,119,217,220,437
1266,"คลองสองต้นนุ่น","เขตลาดกระบัง",101102,"เต็นท์ที่ว่างบริเวณบ้านเลขที่ 19 ริมถนนร่มเกล้า 1",1,166,270,273,543
1267,"คลองสองต้นนุ่น","เขตลาดกระบัง",101102,"อาคารวิทยาลัยอาชีวศึกษาเอเซีย",2,255,256,291,547
1268,"คลองสองต้นนุ่น","เขตลาดกระบัง",101102,"อาคารวิทยาลัยอาชีวศึกษาเอเชีย",3,284,230,292,522
1269,"คลองสองต้นนุ่น","เขตลาดกระบัง",101102,"ลานโดมอเนกประสงค์โรงเรียนแดงเป้า",4,173,244,285,529
1270,"คลองสองต้นนุ่น","เขตลาดกระบัง",101102,"ลานโดมอเนกประสงค์โรงเรียนแดงเป้า",5,215,270,263,533
1271,"คลองสองต้นนุ่น","เขตลาดกระบัง",101102,"เต็นท์ลานจอดรถหน้าร้านเซเว่นอีเลฟเว่น DHL ถนนพัฒนาชนบท 3",6,199,311,342,653
1272,"คลองสองต้นนุ่น","เขตลาดกระบัง",101102,"เต็นท์ลานจอดรถหน้าร้านเซเว่นอีเลฟเว่น DHL ถนนพัฒนาชนบท 3",7,160,220,259,479
1273,"คลองสองต้นนุ่น","เขตลาดกระบัง",101102,"เต็นท์ลานจอดรถหน้าร้านเซเว่นอีเลฟเว่น DHL ถนนพัฒนาชนบท 3",8,390,334,457,791
1274,"คลองสองต้นนุ่น","เขตลาดกระบัง",101102,"เต็นท์โรงจอดรถมัสยิดดารุ้ลมูฮิบบีน",9,344,400,417,817
1275,"คลองสองต้นนุ่น","เขตลาดกระบัง",101102,"เต็นท์โรงจอดรถมัสยิดดารุ้ลมูฮิบบีน",10,336,282,364,646
1276,"คลองสองต้นนุ่น","เขตลาดกระบัง",101102,"เต็นท์ลานจอดรถมัสยิดดารุ้ลมุฮิบบีน",11,283,274,310,584
1277,"คลองสองต้นนุ่น","เขตลาดกระบัง",101102,"แฟลตเช่าการเคหะฯ หลังที่ 1",12,206,237,269,506
1278,"คลองสองต้นนุ่น","เขตลาดกระบัง",101102,"แฟลตเช่าการเคหะฯ หลังที่ 8",13,261,278,270,548
1279,"คลองสองต้นนุ่น","เขตลาดกระบัง",101102,"ลานโดมอเนกประสงค์โซน 1",14,195,249,267,516
1280,"คลองสองต้นนุ่น","เขตลาดกระบัง",101102,"ลานโดมอเนกประสงค์โซน 1",15,197,266,300,566
1281,"คลองสองต้นนุ่น","เขตลาดกระบัง",101102,"ลานโดมอเนกประสงค์โซน 8",16,175,260,323,583
1282,"คลองสองต้นนุ่น","เขตลาดกระบัง",101102,"ลานโดมอเนกประสงค์โซน 8",17,182,286,279,565
1283,"คลองสองต้นนุ่น","เขตลาดกระบัง",101102,"ลานโดมอเนกประสงค์โซน 8",18,164,268,300,568
1284,"คลองสองต้นนุ่น","เขตลาดกระบัง",101102,"ลานโดมอเนกประสงค์โซน 11",19,230,346,343,689
1285,"คลองสองต้นนุ่น","เขตลาดกระบัง",101102,"ลานโดมอเนกประสงค์โซน 11",20,254,358,381,739
1286,"คลองสองต้นนุ่น","เขตลาดกระบัง",101102,"ลานโดมหน้าศูนย์ชุมชนโซน 11",21,216,317,356,673
1287,"คลองสองต้นนุ่น","เขตลาดกระบัง",101102,"ลานโดมอเนกประสงค์ สนามเด็กเล่นโซนหลังคาเขียว ซอย 27",22,274,313,336,649
1288,"คลองสองต้นนุ่น","เขตลาดกระบัง",101102,"โรงจอดรถสหกรณ์เครดิตยูเนี่ยนคลองจั่น",23,174,225,254,479
1289,"คลองสองต้นนุ่น","เขตลาดกระบัง",101102,"อาคารสหกรณ์เครดิตยูเนี่ยนคลองจั่น",24,187,237,275,512
1290,"คลองสองต้นนุ่น","เขตลาดกระบัง",101102,"โรงจอดรถลานอเนกประสงค์ชุมชนฟื้นนครร่มเกล้าโซน 7",25,148,297,331,628
1291,"คลองสองต้นนุ่น","เขตลาดกระบัง",101102,"โรงจอดรถลานอเนกประสงค์ชุมชนฟื้นนครร่มเกล้าโซน 7",26,173,313,320,633
1292,"คลองสองต้นนุ่น","เขตลาดกระบัง",101102,"ลานโดมอเนกประสงค์ฟื้นนครร่มเกล้า ระยะ 2 โซน 9",27,177,251,256,507
1293,"คลองสองต้นนุ่น","เขตลาดกระบัง",101102,"ลานโดมอเนกประสงค์ฟื้นนครร่มเกล้า ระยะ 2 โซน 9",28,159,235,264,499
1294,"คลองสองต้นนุ่น","เขตลาดกระบัง",101102,"เต็นท์ลานกีฬาชุมชนมิตรประชาร่วมใจฯ ระยะ 6 โซน 12",29,238,347,407,754
1295,"คลองสองต้นนุ่น","เขตลาดกระบัง",101102,"ลานอเนกประสงค์ปฐมาเนอสเซอรี่โซน 6",30,225,318,371,689
1296,"คลองสองต้นนุ่น","เขตลาดกระบัง",101102,"อาคารปฐมาเนอสเซอรี่โซน 6",31,230,282,314,596
1297,"คลองสองต้นนุ่น","เขตลาดกระบัง",101102,"ลานโดมอเนกประสงค์โรงเรียนรัตนโกสินทร์สมโภชลาดกระบัง",32,370,411,456,867
1298,"คลองสองต้นนุ่น","เขตลาดกระบัง",101102,"ลานโดมอเนกประสงค์โรงเรียนรัตนโกสินทร์สมโภชลาดกระบัง",33,249,324,390,714
1299,"คลองสองต้นนุ่น","เขตลาดกระบัง",101102,"แฟลตเช่าซื้อการเคหะฯ หลังที่ 30",34,398,362,488,850
1300,"คลองสองต้นนุ่น","เขตลาดกระบัง",101102,"แฟลตเช่าซื้อการเคหะฯ หลังที่ 31",35,298,316,366,682
1301,"คลองสองต้นนุ่น","เขตลาดกระบัง",101102,"แฟลตเช่าซื้อการเคหะฯ หลังที่ 31",36,360,344,405,749
1302,"คลองสองต้นนุ่น","เขตลาดกระบัง",101102,"แฟลตเช่าซื้อการเคหะฯ หลังที่ 13",37,361,343,357,700
1303,"คลองสองต้นนุ่น","เขตลาดกระบัง",101102,"แฟลตเช่าซื้อการเคหะฯ หลังที่ 18",38,394,362,420,782
1304,"คลองสองต้นนุ่น","เขตลาดกระบัง",101102,"แฟลตเช่าซื้อการเคหะฯ หลังที่ 19",39,395,361,369,730
1305,"คลองสองต้นนุ่น","เขตลาดกระบัง",101102,"แฟลตเช่าซื้อการเคหะฯ หลังที่ 4",40,350,321,398,719
1306,"คลองสองต้นนุ่น","เขตลาดกระบัง",101102,"แฟลตเช่าซื้อการเคหะฯ หลังที่ 4",41,334,319,385,704
1307,"คลองสองต้นนุ่น","เขตลาดกระบัง",101102,"แฟลตเช่าซื้อการเคหะฯ หลังที่ 5",42,356,316,418,734
1308,"คลองสองต้นนุ่น","เขตลาดกระบัง",101102,"อาคารสวัสดิการชุมชนบ้านเอื้ออาทรร่มเกล้า 2",43,326,260,348,608
1309,"คลองสองต้นนุ่น","เขตลาดกระบัง",101102,"อาคารสวัสดิการชุมชนบ้านเอื้ออาทรร่มเกล้า 2",44,367,300,355,655
1310,"คลองสองต้นนุ่น","เขตลาดกระบัง",101102,"เต็นท์ลานกีฬาชุมชนบ้านเอื้ออาทรร่มเกล้า 2",45,333,268,351,619
1311,"คลองสองต้นนุ่น","เขตลาดกระบัง",101102,"เต็นท์ลานกีฬาชุมชนบ้านเอื้ออาทรร่มเกล้า 2",46,371,337,377,714
1312,"คลองสองต้นนุ่น","เขตลาดกระบัง",101102,"เต็นท์ลานกีฬาชุมชนบ้านเอื้ออาทรร่มเกล้า 2",47,385,327,379,706
1313,"คลองสองต้นนุ่น","เขตลาดกระบัง",101102,"เต็นท์ลานกีฬาชุมชนบ้านเอื้ออาทรร่มเกล้า 2",48,380,332,371,703
1314,"คลองสองต้นนุ่น","เขตลาดกระบัง",101102,"เต็นท์ลานกีฬาชุมชนบ้านเอื้ออาทรร่มเกล้า 2",49,365,329,383,712
1315,"คลองสองต้นนุ่น","เขตลาดกระบัง",101102,"เต็นท์ลานกีฬาชุมชนบ้านเอื้ออาทรร่มเกล้า 2",50,391,321,396,717
1316,"คลองสองต้นนุ่น","เขตลาดกระบัง",101102,"เต็นท์ลานกีฬาชุมชนบ้านเอื้ออาทรร่มเกล้า 2",51,386,312,385,697
1317,"คลองสองต้นนุ่น","เขตลาดกระบัง",101102,"เต็นท์ลานกีฬาชุมชนบ้านเอื้ออาทรร่มเกล้า 2",52,366,330,400,730
1318,"คลองสองต้นนุ่น","เขตลาดกระบัง",101102,"เต็นท์ลานกีฬาชุมชนบ้านเอื้ออาทรร่มเกล้า 2",53,338,275,360,635
1319,"คลองสองต้นนุ่น","เขตลาดกระบัง",101102,"เต็นท์ลานกีฬาหมู่บ้านพูนสินธานี 2",54,402,386,489,875
1320,"คลองสองต้นนุ่น","เขตลาดกระบัง",101102,"เต็นท์ลานกีฬาหมู่บ้านพูนสินธานี 2",55,302,348,417,765
1321,"คลองสองต้นนุ่น","เขตลาดกระบัง",101102,"เต็นท์ลานจอดรถร้านเซเว่นอีเลฟเว่น ข้างหมู่บ้านนลินวิลล์ 5",56,455,433,503,936
1322,"คลองสองต้นนุ่น","เขตลาดกระบัง",101102,"เต็นท์ลานจอดรถร้านเซเว่นอีเลฟเว่น ข้างหมู่บ้านนลินวิลล์ 5",57,207,405,434,839
1323,"คลองสองต้นนุ่น","เขตลาดกระบัง",101102,"เต็นท์ลานจอดรถร้านเซเว่นอีเลฟเว่น ข้างหมู่บ้านนลินวิลล์ 5",58,342,333,418,751
1324,"คลองสองต้นนุ่น","เขตลาดกระบัง",101102,"เต็นท์หน้าสำนักงานนิติบุคคล หมู่บ้านเพอร์เฟคเพลส",59,349,351,446,797
1325,"คลองสองต้นนุ่น","เขตลาดกระบัง",101102,"เต็นท์หน้าสำนักงานนิติบุคคล หมู่บ้านเพอร์เฟคเพลส",60,369,353,445,798
1326,"คลองสองต้นนุ่น","เขตลาดกระบัง",101102,"ลานอเนกประสงค์โรงเรียนสุเหร่าลำนายโส",61,246,292,341,633
1327,"คลองสองต้นนุ่น","เขตลาดกระบัง",101102,"อาคารสโมสรหมู่บ้านพูนสินธานี 3",62,293,334,397,731
1328,"คลองสองต้นนุ่น","เขตลาดกระบัง",101102,"เต็นท์สนามเด็กเล่นหมู่บ้านพูนสินธานี 3",63,305,359,430,789
1329,"คลองสองต้นนุ่น","เขตลาดกระบัง",101102,"เต็นท์สนามเด็กเล่นหมู่บ้านพูนสินธานี 3",64,323,343,403,746
1330,"คลองสองต้นนุ่น","เขตลาดกระบัง",101102,"เต็นท์สนามเด็กเล่นหมู่บ้านพูนสินธานี 3",65,303,343,422,765
1331,"คลองสองต้นนุ่น","เขตลาดกระบัง",101102,"เต็นท์สนามเด็กเล่นหมู่บ้านพูนสินธานี 1",66,308,341,422,763
1332,"คลองสองต้นนุ่น","เขตลาดกระบัง",101102,"เต็นท์สนามเด็กเล่นหมู่บ้านพูนสินธานี 1",67,279,275,354,629
1333,"คลองสองต้นนุ่น","เขตลาดกระบัง",101102,"เต็นท์สนามเด็กเล่นหมู่บ้านพูนสินธานี 1",68,282,314,343,657
1334,"คลองสองต้นนุ่น","เขตลาดกระบัง",101102,"ลานโดมอเนกประสงค์โรงเรียนเคหะชุมชนลาดกระบัง",69,182,229,279,508
1335,"คลองสองต้นนุ่น","เขตลาดกระบัง",101102,"ลานโดมอเนกประสงค์โรงเรียนเคหะชุมชนลาดกระบัง",70,188,275,303,578
1336,"คลองสองต้นนุ่น","เขตลาดกระบัง",101102,"ลานโดมอเนกประสงค์สนามเด็กเล่นซอย 32 โซน 3",71,188,219,272,491
1337,"คลองสองต้นนุ่น","เขตลาดกระบัง",101102,"ลานโดมอเนกประสงค์สนามเด็กเล่นซอย 32 โซน 3",72,208,291,334,625
1338,"คลองสองต้นนุ่น","เขตลาดกระบัง",101102,"ลานโดมอเนกประสงค์สนามเด็กเล่นซอย 18 โซน 2",73,230,315,352,667
1339,"คลองสองต้นนุ่น","เขตลาดกระบัง",101102,"เต็นท์สนามเด็กเล่นซอย 18 โซน 2",74,256,329,431,760
1340,"คลองสองต้นนุ่น","เขตลาดกระบัง",101102,"เต็นท์สนามเด็กเล่นชุมชนร่มเกล้าโซนหลังคาแดง ปากซอย 16",75,275,335,398,733
1341,"คลองสองต้นนุ่น","เขตลาดกระบัง",101102,"เต็นท์สนามเด็กเล่นชุมชนร่มเกล้าโซนหลังคาแดง ปากซอย 16",76,323,366,415,781
1342,"คลองสองต้นนุ่น","เขตลาดกระบัง",101102,"ลานอเนกประสงค์หน้าที่ทำการชุมชนเคหะชุมชนร่มเกล้าโซนหลังคาแดง",77,293,342,395,737
1343,"คลองสองต้นนุ่น","เขตลาดกระบัง",101102,"ลานอเนกประสงค์หน้าที่ทำการชุมชนเคหะชุมชนร่มเกล้าโซนหลังคาแดง",78,286,307,383,690
1344,"คลองสามประเวศ","เขตลาดกระบัง",101103,"เต็นท์สวนหย่อมหมู่บ้านรุ่งกิจ 9",1,290,304,396,700
1345,"คลองสามประเวศ","เขตลาดกระบัง",101103,"เต็นท์ลานอเนกประสงค์หมู่บ้านรุ่งกิจ 5",2,174,216,255,471
1346,"คลองสามประเวศ","เขตลาดกระบัง",101103,"เต็นท์ลานอเนกประสงค์หมู่บ้านรุ่งกิจ 5",3,211,213,259,472
1347,"คลองสามประเวศ","เขตลาดกระบัง",101103,"อาคารอเนกประสงค์หมู่บ้านรุ่งกิจ 7",4,299,338,440,778
1348,"คลองสามประเวศ","เขตลาดกระบัง",101103,"อาคารสวัสดิการกองบัญชาการกองทัพไทย ซอยร่มเกล้า 40",5,378,358,276,634
1349,"คลองสามประเวศ","เขตลาดกระบัง",101103,"อาคารสวัสดิการกองบัญชาการกองทัพไทย ซอยร่มเกล้า 40",6,470,358,476,834
1350,"คลองสามประเวศ","เขตลาดกระบัง",101103,"อาคารสวัสดิการกองบัญชาการกองทัพไทย ซอยร่มเกล้า 40",7,556,302,395,697
1351,"คลองสามประเวศ","เขตลาดกระบัง",101103,"เต็นท์สนามเด็กเล่นหมู่บ้านพาราไดซ์ร่มเกล้า",8,273,273,328,601
1352,"คลองสามประเวศ","เขตลาดกระบัง",101103,"เต็นท์ที่จอดรถหน้าหมู่บ้านเวร่า บิสเน็ท",9,406,437,489,926
1353,"คลองสามประเวศ","เขตลาดกระบัง",101103,"เต็นท์ลานจอดรถยันมาร์ (บริษัท ร่มเกล้า โปรเกรส จำกัด)",10,167,221,249,470
1354,"คลองสามประเวศ","เขตลาดกระบัง",101103,"เต็นท์ลานจอดรถยันมาร์ (บริษัท ร่มเกล้า โปรเกรส จำกัด)",11,174,217,261,478
1355,"คลองสามประเวศ","เขตลาดกระบัง",101103,"เต็นท์ตลาดพอเพลิน",12,268,284,365,649
1356,"คลองสามประเวศ","เขตลาดกระบัง",101103,"เต็นท์ตลาดพอเพลิน",13,224,252,322,574
1357,"คลองสามประเวศ","เขตลาดกระบัง",101103,"เต็นท์ตลาดพอเพลิน",14,221,271,265,536
1358,"คลองสามประเวศ","เขตลาดกระบัง",101103,"เต็นท์บริษัทอินแลนด์ คอนเทนเนอร์ ดิลิเวอรี่",15,310,386,452,838
1359,"คลองสามประเวศ","เขตลาดกระบัง",101103,"เต็นท์สำนักงานสถานีบรรจุและแยกสินค้ากล่อง ลาดกระบัง",16,154,196,199,395
1360,"คลองสามประเวศ","เขตลาดกระบัง",101103,"ลานศาลาบำเพ็ญกุศลวัดบำรุงรื่น",17,174,253,278,531
1361,"คลองสามประเวศ","เขตลาดกระบัง",101103,"ลานศาลาบำเพ็ญกุศลวัดบำรุงรื่น",18,187,196,237,433
1362,"คลองสามประเวศ","เขตลาดกระบัง",101103,"ลานจอดรถร้านแสงทองโฮมมาร์ท",19,215,265,339,604
1363,"คลองสามประเวศ","เขตลาดกระบัง",101103,"บริเวณใต้สะพานชุมชนศีลาภิรัตน์ ถนนมอเตอร์เวย์ ฝั่งเหนือ",20,217,265,323,588
1364,"คลองสามประเวศ","เขตลาดกระบัง",101103,"ที่ทำการชุมชนศีลาภิรัตน์",21,187,246,290,536
1365,"ลำปลาทิว","เขตลาดกระบัง",101104,"เต็นท์ที่ทำการไปรษณีย์ลาดกระบัง",1,242,296,296,592
1366,"ลำปลาทิว","เขตลาดกระบัง",101104,"เต็นท์ร้านอาหารสบาย สบาย ถนนคุ้มเกล้า",2,238,361,356,717
1367,"ลำปลาทิว","เขตลาดกระบัง",101104,"เต็นท์ลานจอดรถ เอฟ.บี.ที. ถนนคุ้มเกล้า ตรงข้ามซอยคุ้มเกล้า 52",3,169,235,242,477
1368,"ลำปลาทิว","เขตลาดกระบัง",101104,"เต็นท์ลานจอดรถ เอฟ.บี.ที. ถนนคุ้มเกล้า ตรงข้ามซอยคุ้มเกล้า 52",4,143,235,261,496
1369,"ลำปลาทิว","เขตลาดกระบัง",101104,"เต็นท์สวนหย่อมหมู่บ้านชัยพฤกษ์ 1 (สนามบาสเก็ตบอล)",5,352,362,448,810
1370,"ลำปลาทิว","เขตลาดกระบัง",101104,"สโมสรหมู่บ้านปาริชาต เฟส 1",6,309,268,333,601
1371,"ลำปลาทิว","เขตลาดกระบัง",101104,"ลานโดมอเนกประสงค์โรงเรียนวัดบึงบัว",7,243,354,401,755
1372,"ลำปลาทิว","เขตลาดกระบัง",101104,"ลานโดมอเนกประสงค์โรงเรียนวัดบึงบัว",8,250,380,382,762
1373,"ลำปลาทิว","เขตลาดกระบัง",101104,"โรงอาหารโรงเรียนวัดบึงบัว",9,335,399,461,860
1374,"ลำปลาทิว","เขตลาดกระบัง",101104,"โรงอาหารโรงเรียนวัดบึงบัว",10,269,352,394,746
1375,"ลำปลาทิว","เขตลาดกระบัง",101104,"เต็นท์ศูนย์การค้าวีมาร์เก็ต",11,298,354,417,771
1376,"ลำปลาทิว","เขตลาดกระบัง",101104,"เต็นท์ศูนย์การค้าวีมาร์เก็ต",12,276,357,387,744
1377,"ลำปลาทิว","เขตลาดกระบัง",101104,"เต็นท์ใต้สะพานคลองลำกอไผ่",13,555,445,564,1009
1378,"ลำปลาทิว","เขตลาดกระบัง",101104,"เต็นท์ใต้สะพานคลองลำกอไผ่",14,359,443,467,910
1379,"ลำปลาทิว","เขตลาดกระบัง",101104,"ลานโดมอเนกประสงค์โรงเรียนวัดทิพพาวาส",15,293,341,413,754
1380,"ลำปลาทิว","เขตลาดกระบัง",101104,"ลานโดมอเนกประสงค์โรงเรียนวัดทิพพาวาส",16,385,368,396,764
1381,"ลำปลาทิว","เขตลาดกระบัง",101104,"ลานโดมอเนกประสงค์โรงเรียนวัดทิพพาวาส",17,278,345,406,751
1382,"ลำปลาทิว","เขตลาดกระบัง",101104,"ลานโดมอเนกประสงค์โรงเรียนวัดทิพพาวาส",18,302,356,397,753
1383,"ลำปลาทิว","เขตลาดกระบัง",101104,"ห้องประชุมโรงเรียนวัดทิพพาวาส",19,466,471,501,972
1384,"ลำปลาทิว","เขตลาดกระบัง",101104,"ห้องประชุมโรงเรียนวัดทิพพาวาส",20,456,456,487,943
1385,"ลำปลาทิว","เขตลาดกระบัง",101104,"ลานโดมอเนกประสงค์โรงเรียนลำพะอง",21,240,270,331,601
1386,"ลำปลาทิว","เขตลาดกระบัง",101104,"ลานโดมอเนกประสงค์โรงเรียนลำพะอง",22,371,335,395,730
1387,"ลำปลาทิว","เขตลาดกระบัง",101104,"ลานโดมอเนกประสงค์โรงเรียนลำพะอง",23,361,321,394,715
1388,"ลำปลาทิว","เขตลาดกระบัง",101104,"เต็นท์ที่ว่างหน้าที่ทำการชุมชนริมคลองลำปลาทิว ฉลองกรุง 54",24,188,260,281,541
1389,"ลำปลาทิว","เขตลาดกระบัง",101104,"เต็นท์ลานจอดรถร้านเซเว่นอีเลฟเว่น ปากซอยฉลองกรุง 6",25,215,306,362,668
1390,"ลำปลาทิว","เขตลาดกระบัง",101104,"เต็นท์ลานจอดรถร้านเซเว่นอีเลฟเว่น ปากซอยฉลองกรุง 6",26,162,305,321,626
1391,"ลำปลาทิว","เขตลาดกระบัง",101104,"ศาลาอเนกประสงค์วัดอุทัยธรรมาราม (สารีบุตร)",27,134,225,242,467
1392,"ทับยาว","เขตลาดกระบัง",101105,"เต็นท์หน้าสโมสรหมู่บ้านวนารมย์",1,263,303,362,665
1393,"ทับยาว","เขตลาดกระบัง",101105,"เต็นท์หน้าสโมสรหมู่บ้านวนารมย์",2,286,303,364,667
1394,"ทับยาว","เขตลาดกระบัง",101105,"เต็นท์หน้าสโมสรหมู่บ้านวนารมย์",3,221,302,354,656
1395,"ทับยาว","เขตลาดกระบัง",101105,"ลานโดมอเนกประสงค์โรงเรียนวัดสุทธาโภชน์",4,158,249,277,526
1396,"ทับยาว","เขตลาดกระบัง",101105,"ลานโดมอเนกประสงค์โรงเรียนวัดสุทธาโภชน์",5,160,258,284,542
1397,"ทับยาว","เขตลาดกระบัง",101105,"ศาลาศูนย์พัฒนาเด็กก่อนวัยเรียนชุมชนสุทธาโภชน์สุนทรอุปถัมภ์",6,174,309,315,624
1398,"ทับยาว","เขตลาดกระบัง",101105,"เต็นท์ศูนย์พัฒนาเด็กก่อนวัยเรียนชุมชนสุทธาโภชน์สุนทรอุปถัมภ์",7,194,312,325,637
1399,"ทับยาว","เขตลาดกระบัง",101105,"ห้องประชุมโรงเรียนประสานสามัคคี",8,316,427,447,874
1400,"ทับยาว","เขตลาดกระบัง",101105,"ลานโดมอเนกประสงค์โรงเรียนประสานสามัคคี",9,344,444,445,889
1401,"ทับยาว","เขตลาดกระบัง",101105,"ที่ทำการชุมชนวัดพลมานีย์ (ฝั่งบน)",10,246,354,401,755
1402,"ทับยาว","เขตลาดกระบัง",101105,"เต็นท์ที่ว่างข้างที่ทำการชุมชนวัดพลมานีย์ (ฝั่งบน)",11,156,267,298,565
1403,"ทับยาว","เขตลาดกระบัง",101105,"สนามกีฬาหมู่บ้านเอื้ออาทรลาดกระบัง 2 นำไกร",12,455,358,397,755
1404,"ทับยาว","เขตลาดกระบัง",101105,"สนามกีฬาหมู่บ้านเอื้ออาทรลาดกระบัง 2 นำไกร",13,405,340,376,716
1405,"ทับยาว","เขตลาดกระบัง",101105,"สนามกีฬาหมู่บ้านเอื้ออาทรลาดกระบัง 2 นำไกร",14,399,347,375,722
1406,"ทับยาว","เขตลาดกระบัง",101105,"สนามกีฬาหมู่บ้านเอื้ออาทรลาดกระบัง 2 นำไกร",15,394,306,379,685
1407,"ทับยาว","เขตลาดกระบัง",101105,"สนามกีฬาหมู่บ้านเอื้ออาทรลาดกระบัง 2 นำไกร",16,445,348,405,753
1408,"ทับยาว","เขตลาดกระบัง",101105,"สนามกีฬาหมู่บ้านเอื้ออาทรลาดกระบัง 2 นำไกร",17,431,350,391,741
1409,"ทับยาว","เขตลาดกระบัง",101105,"สนามกีฬาหมู่บ้านเอื้ออาทรลาดกระบัง 2 นำไกร",18,657,471,549,1020
1410,"ทับยาว","เขตลาดกระบัง",101105,"เต็นท์ลานจอดรถร้านเซเว่นอีเลฟเว่นทางเข้านิคมอุตสาหกรรมนำไกร",19,389,425,511,936
1411,"ทับยาว","เขตลาดกระบัง",101105,"เต็นท์ลานจอดรถร้านเซเว่นอีเลฟเว่นทางเข้านิคมอุตสาหกรรมนำไกร",20,391,406,453,859
1412,"ทับยาว","เขตลาดกระบัง",101105,"อาคารศูนย์คุ้มครองสวัสดิภาพชุมชนหมู่บ้านเอื้ออาทรลาดกระบัง",21,271,375,393,768
1413,"ทับยาว","เขตลาดกระบัง",101105,"เต็นท์ลานกีฬาหมู่บ้านเอื้ออาทรลาดกระบัง",22,328,330,426,756
1414,"ทับยาว","เขตลาดกระบัง",101105,"เต็นท์ลานกีฬาหมู่บ้านเอื้ออาทรลาดกระบัง",23,356,309,393,702
1415,"ทับยาว","เขตลาดกระบัง",101105,"เต็นท์ลานกีฬาหมู่บ้านเอื้ออาทรลาดกระบัง",24,434,365,483,848
1416,"ทับยาว","เขตลาดกระบัง",101105,"เต็นท์ลานจอดรถสถานีดับเพลิงและกู้ภัยลาดกระบัง",25,216,309,329,638
1417,"ทับยาว","เขตลาดกระบัง",101105,"เต็นท์ลานจอดรถสถานีดับเพลิงและกู้ภัยลาดกระบัง",26,244,333,418,751
1418,"ทับยาว","เขตลาดกระบัง",101105,"เต็นท์หน้าอพาร์ทเม้นท์ เอ็ม.บี.เฮ้าส์",27,183,246,248,494
1419,"ทับยาว","เขตลาดกระบัง",101105,"เต็นท์ลานจอดรถหน้าโรงเรียนมาเรียลัย",28,182,360,392,752
1420,"ทับยาว","เขตลาดกระบัง",101105,"เต็นท์ลานจอดรถหน้าโรงเรียนมาเรียลัย",29,229,354,424,778
1421,"ทับยาว","เขตลาดกระบัง",101105,"ลานโดมอเนกประสงค์โรงเรียนวัดพลมานีย์",30,491,448,538,986
1422,"ทับยาว","เขตลาดกระบัง",101105,"ลานโดมอเนกประสงค์โรงเรียนวัดพลมานีย์",31,499,427,519,946
1423,"ทับยาว","เขตลาดกระบัง",101105,"เต็นท์ลานจอดรถร้านเซเว่นอีเลฟเว่น วัดพลมานีย์ จุดที่ 5",32,252,410,450,860
1424,"ขุมทอง","เขตลาดกระบัง",101106,"เต็นท์ข้างศาลเจ้าพ่อตลาดหลวงแพ่ง",1,194,228,300,528
1425,"ขุมทอง","เขตลาดกระบัง",101106,"ลานโดมอเนกประสงค์วัดราชโกษา",2,271,396,434,830
1426,"ขุมทอง","เขตลาดกระบัง",101106,"ลานโดมอเนกประสงค์วัดราชโกษา",3,308,378,432,810
1427,"ขุมทอง","เขตลาดกระบัง",101106,"ลานโดมอเนกประสงค์วัดราชโกษา",4,217,349,398,747
1428,"ขุมทอง","เขตลาดกระบัง",101106,"เต็นท์หน้าหมู่บ้านเลคการ์เด้นท์",5,268,351,356,707
1429,"ขุมทอง","เขตลาดกระบัง",101106,"ลานโดมอเนกประสงค์โรงเรียนวัดขุมทอง",6,158,254,259,513
1430,"ขุมทอง","เขตลาดกระบัง",101106,"ลานโดมอเนกประสงค์โรงเรียนวัดขุมทอง",7,142,230,260,490
1431,"ขุมทอง","เขตลาดกระบัง",101106,"เต็นท์บริเวณสนามฟุตบอลชุมชนวัดลาดกระบัง (บ้านเลขที่ 57)",8,230,343,359,702
1432,"ขุมทอง","เขตลาดกระบัง",101106,"เต็นท์บ้านเลขที่ 509 ถนนขุมทอง-ลำต้อยติ่ง (ตรงข้ามหมู่บ้านราชพฤกษ์)",9,124,195,198,393
1433,"ขุมทอง","เขตลาดกระบัง",101106,"ลานอเนกประสงค์มัสยิดดารุ้ลมูฮายีรีน",10,197,313,317,630
1434,"ช่องนนทรี","เขตยานนาวา",101203,"สถานรับเลี้ยงเด็ก น๊อตดี้เพลย์กรุ๊ป",1,250,245,374,619
1435,"ช่องนนทรี","เขตยานนาวา",101203,"สถานรับเลี้ยงเด็ก น๊อตดี้เพลย์กรุ๊ป",2,258,256,355,611
1436,"ช่องนนทรี","เขตยานนาวา",101203,"เต็นท์บริเวณกิจการวิทยุกระจายเสียงทหารเรือทุ่งมหาเมฆ",3,361,256,363,619
1437,"ช่องนนทรี","เขตยานนาวา",101203,"เต็นท์บริเวณกิจการวิทยุกระจายเสียงทหารเรือทุ่งมหาเมฆ",4,240,277,331,608
1438,"ช่องนนทรี","เขตยานนาวา",101203,"โรงเรียนประถมนนทรี",5,178,305,291,596
1439,"ช่องนนทรี","เขตยานนาวา",101203,"โรงเรียนประถมนนทรี",6,219,311,327,638
1440,"ช่องนนทรี","เขตยานนาวา",101203,"โรงเรียนประถมนนทรี",7,221,277,345,622
1441,"ช่องนนทรี","เขตยานนาวา",101203,"เต็นท์ลานจอดรถ บ.กู๊ดทีม เอ็นเตอร์ไพรส์ จำกัด",8,252,281,339,620
1442,"ช่องนนทรี","เขตยานนาวา",101203,"เต็นท์ลานจอดรถ บ.กู๊ดทีม เอ็นเตอร์ไพรส์ จำกัด",9,203,317,310,627
1443,"ช่องนนทรี","เขตยานนาวา",101203,"เต็นท์ลานจอดรถ บ.กู๊ดทีม เอ็นเตอร์ไพรส์ จำกัด",10,288,295,324,619
1444,"ช่องนนทรี","เขตยานนาวา",101203,"เต็นท์ลานจอดรถ บ.กู๊ดทีม เอ็นเตอร์ไพรส์ จำกัด",11,271,262,363,625
1445,"ช่องนนทรี","เขตยานนาวา",101203,"เต็นท์หน้าโรงพยาบาลกรุณาพิทักษ์",12,185,290,336,626
1446,"ช่องนนทรี","เขตยานนาวา",101203,"เต็นท์หน้าโรงพยาบาลกรุณาพิทักษ์",13,222,266,351,617
1447,"ช่องนนทรี","เขตยานนาวา",101203,"เต็นท์หน้าโรงพยาบาลกรุณาพิทักษ์",14,291,301,323,624
1448,"ช่องนนทรี","เขตยานนาวา",101203,"โรงเรียนนนทรีวิทยา",15,191,288,343,631
1449,"ช่องนนทรี","เขตยานนาวา",101203,"โรงเรียนนนทรีวิทยา",16,373,260,379,639
1450,"ช่องนนทรี","เขตยานนาวา",101203,"โรงเรียนวัดช่องลม",17,167,247,284,531
1451,"ช่องนนทรี","เขตยานนาวา",101203,"เต็นท์ในวัดช่องลม",18,123,265,268,533
1452,"ช่องนนทรี","เขตยานนาวา",101203,"เต็นท์ในวัดช่องลม",19,151,253,277,530
1453,"ช่องนนทรี","เขตยานนาวา",101203,"เต็นท์ในวัดช่องลม",20,166,251,285,536
1454,"ช่องนนทรี","เขตยานนาวา",101203,"เต็นท์หน้าอาคาร แอล พี เอ็น ทาวเวอร์",21,354,225,320,545
1455,"ช่องนนทรี","เขตยานนาวา",101203,"เต็นท์หน้าหมู่บ้านรวยรุ่งเรือง",22,135,247,291,538
1456,"ช่องนนทรี","เขตยานนาวา",101203,"เต็นท์หน้าหมู่บ้านรวยรุ่งเรือง",23,173,249,293,542
1457,"ช่องนนทรี","เขตยานนาวา",101203,"เต็นท์หน้าหมู่บ้านรวยรุ่งเรือง",24,317,220,318,538
1458,"ช่องนนทรี","เขตยานนาวา",101203,"เต็นท์หน้าธนาคารทหารไทยธนชาต สาขาช่องนนทรี",25,204,238,299,537
1459,"ช่องนนทรี","เขตยานนาวา",101203,"เต็นท์บริเวณสถานีบริการน้ำมัน shell ถนนจันทน์",26,191,297,314,611
1460,"ช่องนนทรี","เขตยานนาวา",101203,"เต็นท์บริเวณสถานีบริการน้ำมัน shell ถนนจันทน์",27,196,280,323,603
1461,"ช่องนนทรี","เขตยานนาวา",101203,"โรงเรียนอนุบาลมณีรัตน์",28,216,242,345,587
1462,"ช่องนนทรี","เขตยานนาวา",101203,"โรงเรียนอนุบาลมณีรัตน์",29,301,243,350,593
1463,"ช่องนนทรี","เขตยานนาวา",101203,"โรงเรียนอนุบาลมณีรัตน์",30,364,253,346,599
1464,"ช่องนนทรี","เขตยานนาวา",101203,"เต็นท์หน้า หจก.อาจิวการไฟฟ้า",31,165,266,336,602
1465,"ช่องนนทรี","เขตยานนาวา",101203,"เต็นท์หน้า หจก.อาจิวการไฟฟ้า",32,254,240,365,605
1466,"ช่องนนทรี","เขตยานนาวา",101203,"โรงเรียนทวีวัฒนา",33,195,255,339,594
1467,"ช่องนนทรี","เขตยานนาวา",101203,"โรงเรียนทวีวัฒนา",34,265,240,353,593
1468,"ช่องนนทรี","เขตยานนาวา",101203,"โรงเรียนวรมงคล",35,288,214,344,558
1469,"ช่องนนทรี","เขตยานนาวา",101203,"โรงเรียนวรมงคล",36,276,253,299,552
1470,"ช่องนนทรี","เขตยานนาวา",101203,"โรงเรียนวรมงคล",37,194,248,300,548
1471,"ช่องนนทรี","เขตยานนาวา",101203,"โรงเรียนวรมงคล",38,193,251,296,547
1472,"ช่องนนทรี","เขตยานนาวา",101203,"เต็นท์ข้างสมาคมพฤกษ์สัมพันธ์ (หมู่บ้านนครไทย)",39,202,281,337,618
1473,"ช่องนนทรี","เขตยานนาวา",101203,"เต็นท์ข้างสมาคมพฤกษ์สัมพันธ์ (หมู่บ้านนครไทย)",40,229,274,339,613
1474,"ช่องนนทรี","เขตยานนาวา",101203,"โรงเรียนพระแม่มารี สาธุประดิษฐ์",41,287,217,327,544
1475,"ช่องนนทรี","เขตยานนาวา",101203,"โรงเรียนพระแม่มารี สาธุประดิษฐ์",42,352,219,335,554
1476,"ช่องนนทรี","เขตยานนาวา",101203,"โรงเรียนพระแม่มารี สาธุประดิษฐ์",43,392,196,347,543
1477,"ช่องนนทรี","เขตยานนาวา",101203,"โรงเรียนพระแม่มารี สาธุประดิษฐ์",44,162,249,289,538
1478,"ช่องนนทรี","เขตยานนาวา",101203,"เต็นท์บริเวณสมาคมตระกูลเฮ้งแห่งประเทศไทย",45,226,268,274,542
1479,"ช่องนนทรี","เขตยานนาวา",101203,"เต็นท์บริเวณสมาคมตระกูลเฮ้งแห่งประเทศไทย",46,289,248,298,546
1480,"ช่องนนทรี","เขตยานนาวา",101203,"เต็นท์หน้าอาคาร พี เอส ที คอนโดมิเนียม",47,182,235,304,539
1481,"ช่องนนทรี","เขตยานนาวา",101203,"เต็นท์หน้าอาคาร พี เอส ที คอนโดมิเนียม",48,183,237,303,540
1482,"ช่องนนทรี","เขตยานนาวา",101203,"เต็นท์หน้าอาคาร พี เอส ที คอนโดมิเนียม",49,245,243,303,546
1483,"ช่องนนทรี","เขตยานนาวา",101203,"เต็นท์หน้าอาคาร พี เอส ที คอนโดมิเนียม",50,216,238,304,542
1484,"ช่องนนทรี","เขตยานนาวา",101203,"เต็นท์หน้าอาคาร พี เอส ที คอนโดมิเนียม",51,295,226,318,544
1485,"ช่องนนทรี","เขตยานนาวา",101203,"เต็นท์หน้าอาคาร พี เอส ที คอนโดมิเนียม",52,309,194,340,534
1486,"ช่องนนทรี","เขตยานนาวา",101203,"เต็นท์หน้าอาคาร พี เอส ที คอนโดมิเนียม",53,233,229,308,537
1487,"ช่องนนทรี","เขตยานนาวา",101203,"เต็นท์หน้าอาคาร พี เอส ที คอนโดมิเนียม",54,207,249,283,532
1488,"ช่องนนทรี","เขตยานนาวา",101203,"โรงเรียนวัดช่องนนทรี",55,162,241,275,516
1489,"ช่องนนทรี","เขตยานนาวา",101203,"โรงเรียนวัดช่องนนทรี",56,138,235,276,511
1490,"ช่องนนทรี","เขตยานนาวา",101203,"โรงเรียนวัดช่องนนทรี",57,121,263,262,525
1491,"ช่องนนทรี","เขตยานนาวา",101203,"โรงเรียนวัดช่องนนทรี",58,152,249,269,518
1492,"ช่องนนทรี","เขตยานนาวา",101203,"โรงเรียนวัดช่องนนทรี",59,221,223,296,519
1493,"ช่องนนทรี","เขตยานนาวา",101203,"โรงเรียนวัดช่องนนทรี",60,191,227,295,522
1494,"ช่องนนทรี","เขตยานนาวา",101203,"โรงเรียนวัดช่องนนทรี",61,203,238,280,518
1495,"ช่องนนทรี","เขตยานนาวา",101203,"โรงเรียนวัดช่องนนทรี",62,251,237,276,513
1496,"ช่องนนทรี","เขตยานนาวา",101203,"โรงเรียนวัดช่องนนทรี",63,284,206,306,512
1497,"ช่องนนทรี","เขตยานนาวา",101203,"โรงเรียนวัดคลองภูมิ",64,370,261,374,635
1498,"ช่องนนทรี","เขตยานนาวา",101203,"โรงเรียนวัดคลองภูมิ",65,245,208,326,534
1499,"ช่องนนทรี","เขตยานนาวา",101203,"โรงเรียนวัดคลองภูมิ",66,390,221,329,550
1500,"ช่องนนทรี","เขตยานนาวา",101203,"โรงเรียนวัดคลองภูมิ",67,315,215,326,541
1501,"บางโพงพาง","เขตยานนาวา",101204,"โรงเรียนสารสาสน์พิทยา",1,154,236,298,534
1502,"บางโพงพาง","เขตยานนาวา",101204,"โรงเรียนสารสาสน์พิทยา",2,144,256,244,500
1503,"บางโพงพาง","เขตยานนาวา",101204,"โรงเรียนสารสาสน์พิทยา",3,122,210,219,429
1504,"บางโพงพาง","เขตยานนาวา",101204,"มัสยิดลิวาอุ้ลอิสลาม",4,163,250,276,526
1505,"บางโพงพาง","เขตยานนาวา",101204,"มัสยิดลิวาอุ้ลอิสลาม",5,127,291,277,568
1506,"บางโพงพาง","เขตยานนาวา",101204,"โรงเรียนพระแม่มารี สาธุประดิษฐ์",6,174,254,279,533
1507,"บางโพงพาง","เขตยานนาวา",101204,"โรงเรียนพระแม่มารี สาธุประดิษฐ์",7,167,265,311,576
1508,"บางโพงพาง","เขตยานนาวา",101204,"โรงเรียนพระแม่มารี สาธุประดิษฐ์",8,200,257,318,575
1509,"บางโพงพาง","เขตยานนาวา",101204,"เต็นท์ในลานจอดรถเกษรสุข",9,270,309,342,651
1510,"บางโพงพาง","เขตยานนาวา",101204,"เต็นท์ในลานจอดรถเกษรสุข",10,200,323,348,671
1511,"บางโพงพาง","เขตยานนาวา",101204,"โรงเรียนวัดดอกไม้",11,212,350,351,701
1512,"บางโพงพาง","เขตยานนาวา",101204,"โรงเรียนวัดดอกไม้",12,556,238,438,676
1513,"บางโพงพาง","เขตยานนาวา",101204,"โรงเรียนวัดดอกไม้",13,342,230,347,577
1514,"บางโพงพาง","เขตยานนาวา",101204,"โรงเรียนวัดดอกไม้",14,220,293,355,648
1515,"บางโพงพาง","เขตยานนาวา",101204,"โรงเรียนวัดดอกไม้",15,175,264,354,618
1516,"บางโพงพาง","เขตยานนาวา",101204,"โรงเรียนวัดดอกไม้",16,193,290,320,610
1517,"บางโพงพาง","เขตยานนาวา",101204,"โรงเรียนวัดดอกไม้",17,203,273,294,567
1518,"บางโพงพาง","เขตยานนาวา",101204,"โรงเรียนวัดดอกไม้",18,183,284,289,573
1519,"บางโพงพาง","เขตยานนาวา",101204,"โรงเรียนวัดดอกไม้",19,196,336,338,674
1520,"บางโพงพาง","เขตยานนาวา",101204,"เต็นท์บริเวณอาคารที่ทำการชุมสายโทรศัพท์ ซ.สาธุประดิษฐ์ 49",20,132,185,190,375
1521,"บางโพงพาง","เขตยานนาวา",101204,"เต็นท์บริเวณอาคารที่ทำการชุมสายโทรศัพท์ ซ.สาธุประดิษฐ์ 49",21,137,214,263,477
1522,"บางโพงพาง","เขตยานนาวา",101204,"เต็นท์บริเวณอาคารที่ทำการชุมสายโทรศัพท์ ซ.สาธุประดิษฐ์ 49",22,165,196,261,457
1523,"บางโพงพาง","เขตยานนาวา",101204,"เต็นท์บริเวณอาคารที่ทำการชุมสายโทรศัพท์ ซ.สาธุประดิษฐ์ 49",23,160,217,270,487
1524,"บางโพงพาง","เขตยานนาวา",101204,"เต็นท์บริเวณอาคารที่ทำการชุมสายโทรศัพท์ ซ.สาธุประดิษฐ์ 49",24,178,261,300,561
1525,"บางโพงพาง","เขตยานนาวา",101204,"เต็นท์บริเวณอาคารที่ทำการชุมสายโทรศัพท์ ซ.สาธุประดิษฐ์ 49",25,91,247,258,505
1526,"บางโพงพาง","เขตยานนาวา",101204,"เต็นท์บริเวณอาคารที่ทำการชุมสายโทรศัพท์ ซ.สาธุประดิษฐ์ 49",26,193,295,321,616
1527,"บางโพงพาง","เขตยานนาวา",101204,"เต็นท์บริเวณอาคารที่ทำการชุมสายโทรศัพท์ ซ.สาธุประดิษฐ์ 49",27,164,223,242,465
1528,"บางโพงพาง","เขตยานนาวา",101204,"เต็นท์หน้าอาคารทองยั่งยืนอพาร์ตเม้น ซอยปรีชา 1",28,153,229,234,463
1529,"บางโพงพาง","เขตยานนาวา",101204,"เต็นท์หน้าอาคารทองยั่งยืนอพาร์ตเม้น ซอยปรีชา 1",29,147,214,252,466
1530,"บางโพงพาง","เขตยานนาวา",101204,"เต็นท์ลานจอดรถบริษัท พระรามสาม ครีเอชั่น จำกัด ถนนพระราม 3",30,155,278,321,599
1531,"บางโพงพาง","เขตยานนาวา",101204,"เต็นท์ลานจอดรถบริษัท พระรามสาม ครีเอชั่น จำกัด ถนนพระราม 3",31,246,240,314,554
1532,"บางโพงพาง","เขตยานนาวา",101204,"โรงเรียนวัดปริวาศ",32,186,276,315,591
1533,"บางโพงพาง","เขตยานนาวา",101204,"โรงเรียนวัดปริวาศ",33,159,276,291,567
1534,"บางโพงพาง","เขตยานนาวา",101204,"โรงเรียนวัดปริวาศ",34,259,330,381,711
1535,"บางโพงพาง","เขตยานนาวา",101204,"โรงเรียนวัดปริวาศ",35,197,334,351,685
1536,"บางโพงพาง","เขตยานนาวา",101204,"โรงเรียนวัดด่าน",36,521,307,431,738
1537,"บางโพงพาง","เขตยานนาวา",101204,"โรงเรียนวัดด่าน",37,429,255,354,609
1538,"บางโพงพาง","เขตยานนาวา",101204,"โรงเรียนวัดด่าน",38,401,287,398,685
1539,"บางโพงพาง","เขตยานนาวา",101204,"โรงเรียนวัดคลองใหม่",39,107,148,159,307
1540,"บางโพงพาง","เขตยานนาวา",101204,"โรงเรียนวัดคลองใหม่",40,227,152,238,390
1541,"จักรวรรดิ","เขตสัมพันธวงศ์",101301,"มหาวิทยาลัยเทคโนโลยีราชมงคลรัตนโกสินทร์ บพิตรพิมุข จักรวรรดิ(ใต้อาคารเรียนฝั่งซ้าย)",1,186,273,318,591
1542,"จักรวรรดิ","เขตสัมพันธวงศ์",101301,"มหาวิทยาลัยเทคโนโลยีราชมงคลรัตนโกสินทร์ บพิตรพิมุข จักรวรรดิ(ใต้อาคารเรียนฝั่งขวา)",2,229,367,372,739
1543,"จักรวรรดิ","เขตสัมพันธวงศ์",101301,"มหาวิทยาลัยเทคโนโลยีราชมงคลรัตนโกสินทร์ บพิตรพิมุข จักรวรรดิ(โรงอาหาร)",3,288,380,403,783
1544,"จักรวรรดิ","เขตสัมพันธวงศ์",101301,"โรงเรียนวัดจักรวรรดิ (ห้องประชุม)",4,260,314,374,688
1545,"จักรวรรดิ","เขตสัมพันธวงศ์",101301,"เต็นท์บริเวณโรงเรียนวัดจักรวรรดิ",5,211,236,250,486
1546,"จักรวรรดิ","เขตสัมพันธวงศ์",101301,"เต็นท์บริเวณวัดโลกานุเคราะห์",6,189,249,270,519
1547,"จักรวรรดิ","เขตสัมพันธวงศ์",101301,"โรงเรียนเผยอิง (ห้องเรียนฝั่งซ้าย)",7,243,291,365,656
1548,"จักรวรรดิ","เขตสัมพันธวงศ์",101301,"โรงเรียนเผยอิง (ห้องเรียนฝั่งขวา)",8,254,334,359,693
1549,"สัมพันธวงศ์","เขตสัมพันธวงศ์",101302,"โรงเรียนวัดชัยชนะสงคราม",1,233,271,307,578
1550,"สัมพันธวงศ์","เขตสัมพันธวงศ์",101302,"วัดกันมาตุยาราม",2,186,252,291,543
1551,"สัมพันธวงศ์","เขตสัมพันธวงศ์",101302,"วัดกันมาตุยาราม",3,196,255,308,563
1552,"สัมพันธวงศ์","เขตสัมพันธวงศ์",101302,"เต็นท์บริเวณวัดกันมาตุยาราม",4,228,231,336,567
1553,"สัมพันธวงศ์","เขตสัมพันธวงศ์",101302,"วัดมงคลสมาคม",5,267,449,412,861
1554,"สัมพันธวงศ์","เขตสัมพันธวงศ์",101302,"สมาคมฮากกา (ลานจอดรถ)",6,181,223,281,504
1555,"สัมพันธวงศ์","เขตสัมพันธวงศ์",101302,"โรงเรียนวัดสัมพันธวงศ์",7,301,373,491,864
1556,"สัมพันธวงศ์","เขตสัมพันธวงศ์",101302,"โรงเรียนวัดสัมพันธวงศ์",8,269,418,468,886
1557,"สัมพันธวงศ์","เขตสัมพันธวงศ์",101302,"โรงเรียนวัดปทุมคงคา",9,146,214,268,482
1558,"สัมพันธวงศ์","เขตสัมพันธวงศ์",101302,"เต็นท์บริเวณโรงเรียนวัดปทุมคงคา",10,165,255,280,535
1559,"ตลาดน้อย","เขตสัมพันธวงศ์",101303,"เต็นท์บริเวณโรงเรียนไตรมิตรวิทยาลัย",1,199,359,366,725
1560,"ตลาดน้อย","เขตสัมพันธวงศ์",101303,"เต็นท์บริเวณโรงเรียนไตรมิตรวิทยาลัย",2,208,368,408,776
1561,"ตลาดน้อย","เขตสัมพันธวงศ์",101303,"เต็นท์บริเวณโรงเรียนไตรมิตรวิทยาลัย",3,220,329,409,738
1562,"ตลาดน้อย","เขตสัมพันธวงศ์",101303,"โรงเรียนกุหลาบวิทยา (ใต้อาคารเรียนฝั่งวัดแม่พระ)",4,226,325,389,714
1563,"ตลาดน้อย","เขตสัมพันธวงศ์",101303,"โรงเรียนกุหลาบวิทยา (ใต้อาคารเรียนฝั่งวัดแม่พระ)",5,193,293,348,641
1564,"ตลาดน้อย","เขตสัมพันธวงศ์",101303,"โรงเรียนกุหลาบวิทยา (ใต้อาคารเรียนฝั่งวัดแม่พระ)",6,216,302,363,665
1565,"ตลาดน้อย","เขตสัมพันธวงศ์",101303,"โรงเรียนกุหลาบวิทยา (โรงอาหาร)",7,262,249,389,638
1566,"ตลาดน้อย","เขตสัมพันธวงศ์",101303,"โรงเรียนกุหลาบวิทยา (โรงอาหาร)",8,179,352,342,694
1567,"สามเสนใน","เขตพญาไท",101401,"เต็นท์หน้าห้างสรรพสินค้าบิ๊กซีซูเปอร์เซ็นเตอร์",1,270,247,310,557
1568,"สามเสนใน","เขตพญาไท",101401,"เต็นท์บริเวณลานจอดรถ ปากซอยอินทามระ 1",2,275,216,359,575
1569,"สามเสนใน","เขตพญาไท",101401,"เต็นท์บริเวณลานจอดรถ ปากซอยอินทามระ 1",3,162,261,294,555
1570,"สามเสนใน","เขตพญาไท",101401,"เต็นท์บริเวณลานจอดรถ ปากซอยอินทามระ 1",4,316,204,334,538
1571,"สามเสนใน","เขตพญาไท",101401,"เต็นท์บริเวณลานจอดรถ ปากซอยอินทามระ 1",5,296,156,264,420
1572,"สามเสนใน","เขตพญาไท",101401,"เต็นท์บ้านโรจนา (ASHA QUEST HOUSE) ซอยอินทามระ 3",6,199,251,312,563
1573,"สามเสนใน","เขตพญาไท",101401,"เต็นท์หน้าธนาคารกสิกรไทย สาขาสุทธิสาร",7,163,202,251,453
1574,"สามเสนใน","เขตพญาไท",101401,"เต็นท์หน้าธนาคารกสิกรไทย สาขาสุทธิสาร",8,143,254,287,541
1575,"สามเสนใน","เขตพญาไท",101401,"อาคารโรงจอดรถ ปากซอยอินทามระ 17",9,269,274,404,678
1576,"สามเสนใน","เขตพญาไท",101401,"อาคารโรงจอดรถ ปากซอยอินทามระ 17",10,224,273,349,622
1577,"สามเสนใน","เขตพญาไท",101401,"อาคารโรงจอดรถ ปากซอยอินทามระ 17",11,306,273,347,620
1578,"สามเสนใน","เขตพญาไท",101401,"อาคารโรงจอดรถ ปากซอยอินทามระ 17",12,232,281,373,654
1579,"สามเสนใน","เขตพญาไท",101401,"เต็นท์หน้าอาคารแฟมมิลี่ทาวน์ ซอยอินทามระ 29 แยก 1",13,344,247,346,593
1580,"สามเสนใน","เขตพญาไท",101401,"เต็นท์หน้าอาคารแฟมมิลี่ทาวน์ ซอยอินทามระ 29 แยก 1",14,369,299,359,658
1581,"สามเสนใน","เขตพญาไท",101401,"เต็นท์หน้าอาคารแฟมมิลี่ทาวน์ ซอยอินทามระ 29 แยก 1",15,182,295,327,622
1582,"สามเสนใน","เขตพญาไท",101401,"เต็นท์หน้าอาคารแฟมมิลี่ทาวน์ ซอยอินทามระ 29 แยก 1",16,315,250,360,610
1583,"สามเสนใน","เขตพญาไท",101401,"เต็นท์สมาคมพระคริสตธรรมไทย สี่แยกสุทธิสาร",17,358,161,263,424
1584,"สามเสนใน","เขตพญาไท",101401,"เต็นท์สมาคมพระคริสตธรรมไทย สี่แยกสุทธิสาร",18,169,214,273,487
1585,"สามเสนใน","เขตพญาไท",101401,"เต็นท์อาคาร เจ ซี ทาวเวอร์ คอนโดมิเนียม ซอยอินทามระ 10",19,117,203,205,408
1586,"สามเสนใน","เขตพญาไท",101401,"เต็นท์อาคาร เจ ซี ทาวเวอร์ คอนโดมิเนียม ซอยอินทามระ 10",20,235,161,226,387
1587,"สามเสนใน","เขตพญาไท",101401,"เต็นท์หน้าธนาคารออมสิน สำนักงานใหญ่",21,234,243,242,485
1588,"สามเสนใน","เขตพญาไท",101401,"โรงเรียนรุจิเสรีวิทยา ซอยศุภราช",22,295,185,298,483
1589,"สามเสนใน","เขตพญาไท",101401,"โรงเรียนรุจิเสรีวิทยา ซอยศุภราช",23,226,241,321,562
1590,"สามเสนใน","เขตพญาไท",101401,"เต็นท์โรงเรียนรุจิเสรีวิทยา ซอยศุภราช",24,388,230,357,587
1591,"สามเสนใน","เขตพญาไท",101401,"เต็นท์โรงเรียนรุจิเสรีวิทยา ซอยศุภราช",25,183,219,282,501
1592,"สามเสนใน","เขตพญาไท",101401,"เต็นท์สำนักงานคณะกรรมการกิจการกระจายเสียง กิจการโทรทัศน์และกิจการโทรคมนาคมแห่งชาติ ซอยพหลโยธิน 8",26,186,185,232,417
1593,"สามเสนใน","เขตพญาไท",101401,"เต็นท์สำนักงานคณะกรรมการกิจการกระจายเสียง กิจการโทรทัศน์และกิจการโทรคมนาคมแห่งชาติ ซอยพหลโยธิน 8",27,197,275,279,554
1594,"สามเสนใน","เขตพญาไท",101401,"เต็นท์สำนักงานคณะกรรมการกิจการกระจายเสียง กิจการโทรทัศน์และกิจการโทรคมนาคมแห่งชาติ ซอยพหลโยธิน 8",28,256,332,186,518
1595,"สามเสนใน","เขตพญาไท",101401,"เต็นท์สำนักงานคณะกรรมการกิจการกระจายเสียง กิจการโทรทัศน์และกิจการโทรคมนาคมแห่งชาติ ซอยพหลโยธิน 8",29,242,303,189,492
1596,"สามเสนใน","เขตพญาไท",101401,"เต็นท์สำนักงานคณะกรรมการกิจการกระจายเสียง กิจการโทรทัศน์และกิจการโทรคมนาคมแห่งชาติ ซอยพหลโยธิน 8",30,241,280,136,416
1597,"สามเสนใน","เขตพญาไท",101401,"เต็นท์สำนักงานคณะกรรมการกิจการกระจายเสียง กิจการโทรทัศน์และกิจการโทรคมนาคมแห่งชาติ ซอยพหลโยธิน 8",31,313,374,211,585
1598,"สามเสนใน","เขตพญาไท",101401,"แฟลตเฉลิมลาภ 2",32,240,186,269,455
1599,"สามเสนใน","เขตพญาไท",101401,"แฟลตเฉลิมลาภ 2",33,196,201,230,431
1600,"สามเสนใน","เขตพญาไท",101401,"เต็นท์หน้าอาคารแสงโสม ปากซอยพหลโยธิน 2",34,351,306,386,692
1601,"สามเสนใน","เขตพญาไท",101401,"เต็นท์หน้าห้างหุ้นส่วนจำกัด กิตติแอร์",35,1,468,0,468
1602,"สามเสนใน","เขตพญาไท",101401,"เต็นท์หน้าบริษัท สถาปนิกสมดุล จำกัด",36,195,377,149,526
1603,"สามเสนใน","เขตพญาไท",101401,"เต็นท์หน้ากองพลทหารม้าที่ 2 รักษาพระองค์ฯ",37,1,462,0,462
1604,"สามเสนใน","เขตพญาไท",101401,"เต็นท์หน้าร้านค้าสวัสดิการ พล.ม.2",38,163,211,144,355
1605,"สามเสนใน","เขตพญาไท",101401,"เต็นท์หน้าร้านทรอทอะราวน์ (TROT AROUND)",39,163,200,123,323
1606,"สามเสนใน","เขตพญาไท",101401,"เต็นท์หน้า ที โฮสเทล แอนด์ คาเฟ่ (T HOSTEL & CAFE)",40,1,619,0,619
1607,"สามเสนใน","เขตพญาไท",101401,"เต็นท์หน้าอาคารฮะเซ้ง ถนนพหลโยธิน",41,194,158,238,396
1608,"สามเสนใน","เขตพญาไท",101401,"เต็นท์ใต้ทางด่วนปากซอยราชวิถี 4 (ซอยพระนาง)",42,165,176,264,440
1609,"สามเสนใน","เขตพญาไท",101401,"เต็นท์ใต้ทางด่วนปากซอยราชวิถี 4 (ซอยพระนาง)",43,144,174,240,414
1610,"สามเสนใน","เขตพญาไท",101401,"เต็นท์สำนักงานคณะกรรมการป้องกันและปราบปรามยาเสพติด (ปปส.)",44,154,220,263,483
1611,"สามเสนใน","เขตพญาไท",101401,"เต็นท์สำนักงานคณะกรรมการป้องกันและปราบปรามยาเสพติด (ปปส.)",45,387,249,364,613
1612,"สามเสนใน","เขตพญาไท",101401,"สมาคมคนตาบอดแห่งประเทศไทย ซอยบุญอยู่",46,236,312,307,619
1613,"สามเสนใน","เขตพญาไท",101401,"เต็นท์ด้านข้างนิติบุคคลอาคารชุด มิว ถนนวิภาวดีรังสิต",47,204,405,221,626
1614,"พญาไท","เขตพญาไท",101406,"เต็นท์บริเวณลานกิจกรรมโรงเรียนวัดไผ่ตัน",1,123,200,247,447
1615,"พญาไท","เขตพญาไท",101406,"เต็นท์บริเวณลานกิจกรรมโรงเรียนวัดไผ่ตัน",2,103,226,211,437
1616,"พญาไท","เขตพญาไท",101406,"โรงจอดรถที่ทำการไปรษณีย์สามเสนใน",3,442,275,373,648
1617,"พญาไท","เขตพญาไท",101406,"โรงจอดรถที่ทำการไปรษณีย์สามเสนใน",4,414,247,356,603
1618,"พญาไท","เขตพญาไท",101406,"เต็นท์หน้าโรงแรมประดิพัทธ์",5,575,325,466,791
1619,"พญาไท","เขตพญาไท",101406,"เต็นท์หน้าโรงแรมประดิพัทธ์",6,228,314,391,705
1620,"พญาไท","เขตพญาไท",101406,"เต็นท์หน้าโรงแรมประดิพัทธ์",7,504,348,474,822
1621,"พญาไท","เขตพญาไท",101406,"เต็นท์หน้าคอนโดลุมพินี สะพานควาย ประดิพัทธ์",8,561,339,451,790
1622,"พญาไท","เขตพญาไท",101406,"เต็นท์ทางเข้าหมู่บ้านจตุมิตร ซอยประดิพัทธ์ 15",9,182,292,342,634
1623,"พญาไท","เขตพญาไท",101406,"เต็นท์ลานโพธิ์ชุมชนอุทัยรัตน์ ซอยประดิพัทธ์ 15",10,106,207,226,433
1624,"พญาไท","เขตพญาไท",101406,"เต็นท์ลานโพธิ์ชุมชนอุทัยรัตน์ ซอยประดิพัทธ์ 15",11,112,226,244,470
1625,"พญาไท","เขตพญาไท",101406,"ศูนย์บริการสาธารณสุข 11 ซอยประดิพัทธ์ 7",12,135,188,225,413
1626,"พญาไท","เขตพญาไท",101406,"เต็นท์ใต้ทางด่วน ซอยประดิพัทธ์ 5 (เรวดีเหนือ)",13,146,200,259,459
1627,"พญาไท","เขตพญาไท",101406,"เต็นท์บริเวณลานชุมชนประดิพัทธ์ 1 (อาเซียน)",14,219,293,326,619
1628,"พญาไท","เขตพญาไท",101406,"เต็นท์ลานจอดรถร้านเดอะลุกซ์ สนุกเกอร์คลับ",15,241,310,370,680
1629,"พญาไท","เขตพญาไท",101406,"เต็นท์ข้างบริษัทอุตสาหกรรมพันท้ายนรสิงห์ฯ ถนนประดิพัทธ์",16,203,247,285,532
1630,"พญาไท","เขตพญาไท",101406,"เต็นท์ใต้ทางด่วนตรงข้ามโรงเรียนเรวดี",17,245,245,339,584
1631,"พญาไท","เขตพญาไท",101406,"เต็นท์ใต้ทางด่วนตรงข้ามโรงเรียนเรวดี",18,352,272,382,654
1632,"พญาไท","เขตพญาไท",101406,"โรงเรียนอนุบาลสามเสน",19,166,154,244,398
1633,"พญาไท","เขตพญาไท",101406,"โรงเรียนอนุบาลสามเสน",20,174,191,218,409
1634,"พญาไท","เขตพญาไท",101406,"เต็นท์โรงเรียนอนุบาลสามเสน",21,317,280,432,712
1635,"พญาไท","เขตพญาไท",101406,"เต็นท์วงเวียนหมู่บ้านอาคารพิบูลวัฒนา",22,230,285,418,703
1636,"พญาไท","เขตพญาไท",101406,"โรงเรียนสามเสนวิทยาลัย",23,119,148,204,352
1637,"พญาไท","เขตพญาไท",101406,"โรงเรียนสามเสนวิทยาลัย",24,167,208,160,368
1638,"พญาไท","เขตพญาไท",101406,"โรงเรียนสามเสนวิทยาลัย",25,158,203,150,353
1639,"พญาไท","เขตพญาไท",101406,"อาคารตรงข้ามสถานีรถไฟสามเสน",26,259,339,377,716
1640,"พญาไท","เขตพญาไท",101406,"อาคารลานเอนกประสงค์กรมประชาสัมพันธ์",27,242,258,334,592
1641,"พญาไท","เขตพญาไท",101406,"อาคารลานเอนกประสงค์กรมประชาสัมพันธ์",28,206,236,364,600
1642,"พญาไท","เขตพญาไท",101406,"เต็นท์ใต้ทางด่วนข้างกระทรวงการคลัง  ถนนริมคลองประปา",29,225,263,344,607
1643,"พญาไท","เขตพญาไท",101406,"โรงเรียนสวนบัว ซอยราชครู",30,413,294,435,729
1644,"พญาไท","เขตพญาไท",101406,"โรงเรียนสวนบัว ซอยราชครู",31,458,239,373,612
1645,"พญาไท","เขตพญาไท",101406,"โรงเรียนสวนบัว ซอยราชครู",32,378,240,355,595
1646,"พญาไท","เขตพญาไท",101406,"โรงเรียนสวนบัว ซอยราชครู",33,242,256,327,583
1647,"พญาไท","เขตพญาไท",101406,"เต็นท์โรงเรียนสวนบัว ซอยราชครู",34,268,252,369,621
1648,"พญาไท","เขตพญาไท",101406,"เต็นท์อาคารบ้านยสวดี  ซอยอารีย์",35,414,331,453,784
1649,"พญาไท","เขตพญาไท",101406,"กองบัญชาการตำรวจตระเวนชายแดน",36,374,281,346,627
1650,"พญาไท","เขตพญาไท",101406,"กองบัญชาการตำรวจตระเวนชายแดน",37,468,248,365,613
1651,"พญาไท","เขตพญาไท",101406,"โรงพยาบาลประสานมิตร",38,310,208,337,545
1652,"พญาไท","เขตพญาไท",101406,"เต็นท์ลานจอดรถหน้าร้านบ้านราชครู",39,291,247,349,596
1653,"พญาไท","เขตพญาไท",101406,"เต็นท์ใต้ทางด่วนบริเวณสวนพญาไทภิรมย์",40,168,230,293,523
1654,"พญาไท","เขตพญาไท",101406,"เต็นท์ใต้ทางด่วนบริเวณสวนพญาไทภิรมย์",41,203,209,302,511
1655,"พญาไท","เขตพญาไท",101406,"เต็นท์ใต้ทางด่วนบริเวณสวนพญาไทภิรมย์",42,235,315,381,696
1656,"พญาไท","เขตพญาไท",101406,"แฟลตลือชา 9",43,339,325,381,706
1657,"พญาไท","เขตพญาไท",101406,"แฟลตลือชา 6",44,221,209,213,422
1658,"พญาไท","เขตพญาไท",101406,"แฟลตลือชา 15",45,226,241,210,451
1659,"พญาไท","เขตพญาไท",101406,"เต็นท์ใต้ทางด่วนบริเวณสวนพญาไทภิรมย์",46,166,267,294,561
1660,"พญาไท","เขตพญาไท",101406,"เต็นท์ลานหน้าศาลเจ้าสนามเป้า ซอยพหลโยธิน 1",47,177,220,296,516
1661,"พญาไท","เขตพญาไท",101406,"เต็นท์ลานหน้าศาลเจ้าสนามเป้า ซอยพหลโยธิน 1",48,176,194,268,462
1662,"วัดกัลยาณ์","เขตธนบุรี",101501,"โรงเรียนวัดประยุรวงศ์ (ห้องประชุม)",1,139,224,269,493
1663,"วัดกัลยาณ์","เขตธนบุรี",101501,"โรงเรียนซางตาครู้สศึกษา (อาคารพระเมตตา)",2,159,276,347,623
1664,"วัดกัลยาณ์","เขตธนบุรี",101501,"โรงเรียนแสงอรุณ (ใต้อาคารตึกปิตุเรศ)",3,198,284,339,623
1665,"วัดกัลยาณ์","เขตธนบุรี",101501,"โรงเรียนแสงอรุณ (ใต้อาคารตึกปิตุเรศ)",4,117,257,309,566
1666,"วัดกัลยาณ์","เขตธนบุรี",101501,"ลานกีฬาใต้สะพานอนุทินสวัสดิ์",5,81,181,245,426
1667,"วัดกัลยาณ์","เขตธนบุรี",101501,"ลานกีฬาใต้สะพานอนุทินสวัสดิ์",6,97,191,234,425
1668,"วัดกัลยาณ์","เขตธนบุรี",101501,"วัดบุปผาราม (ศาลาปิ่นเพชร)",7,181,289,346,635
1669,"วัดกัลยาณ์","เขตธนบุรี",101501,"วัดบุปผาราม (ศาลาปิ่นเพชร)",8,158,280,309,589
1670,"วัดกัลยาณ์","เขตธนบุรี",101501,"เต็นท์โรงเรียนสอนขับรถยนต์ ส.สะพานมอญ ซอยอิสรภาพ 24",9,177,295,309,604
1671,"วัดกัลยาณ์","เขตธนบุรี",101501,"มหาวิทยาลัยราชภัฏธนบุรี (โรงอาหาร)",10,174,273,321,594
1672,"วัดกัลยาณ์","เขตธนบุรี",101501,"โรงเรียนศึกษานารี (สนามเล็ก)",11,162,242,316,558
1673,"วัดกัลยาณ์","เขตธนบุรี",101501,"โรงเรียนศึกษานารี (สนามเล็ก)",12,130,239,279,518
1674,"หิรัญรูจี","เขตธนบุรี",101502,"โรงเรียนสหบำรุงวิทยา (ใต้อาคาร)",1,172,275,328,603
1675,"หิรัญรูจี","เขตธนบุรี",101502,"โรงเรียนสหบำรุงวิทยา (ใต้อาคาร)",2,116,283,334,617
1676,"หิรัญรูจี","เขตธนบุรี",101502,"มหาวิทยาลัยราชภัฏบ้านสมเด็จเจ้าพระยา (ชั้นล่างอาคารหอประชุม)",3,163,296,351,647
1677,"หิรัญรูจี","เขตธนบุรี",101502,"มหาวิทยาลัยราชภัฏบ้านสมเด็จเจ้าพระยา (ชั้นล่างอาคารหอประชุม)",4,181,287,345,632
1678,"หิรัญรูจี","เขตธนบุรี",101502,"มหาวิทยาลัยราชภัฏบ้านสมเด็จเจ้าพระยา (ชั้นล่างอาคารหอประชุม)",5,170,247,326,573
1679,"หิรัญรูจี","เขตธนบุรี",101502,"โรงเรียนวัดประดิษฐาราม (ห้องประชุม)",6,204,346,439,785
1680,"หิรัญรูจี","เขตธนบุรี",101502,"โรงเรียนวัดใหญ่ศรีสุพรรณ (โรงอาหาร)",7,201,336,364,700
1681,"หิรัญรูจี","เขตธนบุรี",101502,"โรงเรียนวัดใหญ่ศรีสุพรรณ (โรงอาหาร)",8,186,348,383,731
1682,"หิรัญรูจี","เขตธนบุรี",101502,"โรงเรียนวัดใหญ่ศรีสุพรรณ (โรงอาหาร)",9,165,336,400,736
1683,"หิรัญรูจี","เขตธนบุรี",101502,"โรงเรียนวัดใหญ่ศรีสุพรรณ (ห้องเรียน)",10,155,327,370,697
1684,"หิรัญรูจี","เขตธนบุรี",101502,"โรงเรียนวัดใหญ่ศรีสุพรรณ (ห้องเรียน)",11,277,351,404,755
1685,"หิรัญรูจี","เขตธนบุรี",101502,"วัดหิรัญรูจี (ศาลา 1)",12,172,252,313,565
1686,"หิรัญรูจี","เขตธนบุรี",101502,"วัดหิรัญรูจี (ศาลา 4)",13,166,258,337,595
1687,"หิรัญรูจี","เขตธนบุรี",101502,"วัดหิรัญรูจี (ศาลา 5)",14,185,293,340,633
1688,"บางยี่เรือ","เขตธนบุรี",101503,"เต็นท์ในศูนย์เยาวชนวัดเวฬุราชิณ (สนามฟุตซอล)",1,314,329,416,745
1689,"บางยี่เรือ","เขตธนบุรี",101503,"เต็นท์ในศูนย์เยาวชนวัดเวฬุราชิณ (สนามฟุตซอล)",2,180,302,352,654
1690,"บางยี่เรือ","เขตธนบุรี",101503,"เต็นท์ในศูนย์เยาวชนวัดเวฬุราชิณ (สนามฟุตซอล)",3,179,288,321,609
1691,"บางยี่เรือ","เขตธนบุรี",101503,"โรงเรียนวัดเวฬุราชิณ",4,192,313,382,695
1692,"บางยี่เรือ","เขตธนบุรี",101503,"โรงเรียนวัดเวฬุราชิณ",5,148,357,309,666
1693,"บางยี่เรือ","เขตธนบุรี",101503,"เต็นท์ในลานกีฬาชุมชนสวนพลู",6,188,361,363,724
1694,"บางยี่เรือ","เขตธนบุรี",101503,"เต็นท์ในลานกีฬาชุมชนสวนพลู",7,180,337,374,711
1695,"บางยี่เรือ","เขตธนบุรี",101503,"เต็นท์ในลานกีฬาชุมชนสวนพลู",8,126,352,358,710
1696,"บางยี่เรือ","เขตธนบุรี",101503,"โรงเรียนศาสนธรรมวิทยา สวนพลู (อาคารใหม่)",9,139,305,301,606
1697,"บางยี่เรือ","เขตธนบุรี",101503,"โรงเรียนศาสนธรรมวิทยา สวนพลู (อาคารเก่า)",10,130,291,351,642
1698,"บางยี่เรือ","เขตธนบุรี",101503,"โรงเรียนศาสนธรรมวิทยา สวนพลู (อาคารเก่า)",11,175,341,349,690
1699,"บางยี่เรือ","เขตธนบุรี",101503,"โรงเรียนวัดอินทาราม (อาคาร 4 โรงอาหาร ชั้นล่าง)",12,141,318,337,655
1700,"บางยี่เรือ","เขตธนบุรี",101503,"โรงเรียนวัดราชคฤห์ (อาคาร 1 ชั้นล่าง)",13,166,290,378,668
1701,"บางยี่เรือ","เขตธนบุรี",101503,"โรงเรียนวัดราชคฤห์ (อาคาร 1 ชั้นล่าง)",14,195,293,381,674
1702,"บางยี่เรือ","เขตธนบุรี",101503,"โรงเรียนวัดโพธินิมิตร (อาคารราชสุธี)",15,199,308,341,649
1703,"บางยี่เรือ","เขตธนบุรี",101503,"โรงเรียนวัดโพธินิมิตร (อาคารราชสุธี)",16,176,320,364,684
1704,"บางยี่เรือ","เขตธนบุรี",101503,"โรงเจเซี่ยงเข่งตึ้ง ซอยเทอดไทย 21",17,188,276,326,602
1705,"บางยี่เรือ","เขตธนบุรี",101503,"โรงเจเซี่ยงเข่งตึ้ง ซอยเทอดไทย 21",18,165,259,294,553
1706,"บางยี่เรือ","เขตธนบุรี",101503,"โรงเจเซี่ยงเข่งตึ้ง ซอยเทอดไทย 21",19,145,273,312,585
1707,"บางยี่เรือ","เขตธนบุรี",101503,"เต็นท์ในที่จอดรถข้างศาลเจ้าโอวเจี่ยะหยี่อาเนี้ยเก็ง ซอยเทอดไทย 21",20,151,289,326,615
1708,"บางยี่เรือ","เขตธนบุรี",101503,"เต็นท์ในที่จอดรถข้างศาลเจ้าโอวเจี่ยะหยี่อาเนี้ยเก็ง ซอยเทอดไทย 21",21,138,301,350,651
1709,"บางยี่เรือ","เขตธนบุรี",101503,"เต็นท์บริเวณที่ทำการชุมชนตากสินสัมพันธ์",22,219,300,355,655
1710,"บางยี่เรือ","เขตธนบุรี",101503,"เต็นท์บริเวณที่ทำการชุมชนตากสินสัมพันธ์",23,159,305,314,619
1711,"บางยี่เรือ","เขตธนบุรี",101503,"หน้าศาลเจ้าเล่าปุนเถ้าก๋ง ซอยสมเด็จพระเจ้าตากสิน 4",24,119,167,231,398
1712,"บางยี่เรือ","เขตธนบุรี",101503,"เต็นท์ในโรงงิ้วหน้าศาลเจ้าเล่าปุนเถ้าก๋ง ซอยสมเด็จพระเจ้าตากสิน 4",25,140,213,263,476
1713,"บุคคโล","เขตธนบุรี",101504,"ใต้อาคารหอประชุมมูลนิธิสีมาสงเคราะห์",1,715,327,546,873
1714,"บุคคโล","เขตธนบุรี",101504,"ใต้อาคารหอประชุมมูลนิธิสีมาสงเคราะห์",2,724,373,496,869
1715,"บุคคโล","เขตธนบุรี",101504,"ใต้อาคารหอประชุมมูลนิธิสีมาสงเคราะห์",3,328,399,473,872
1716,"บุคคโล","เขตธนบุรี",101504,"เต็นท์ปากซอยสมเด็จพระเจ้าตากสิน 12/1",4,248,251,310,561
1717,"บุคคโล","เขตธนบุรี",101504,"เต็นท์ปากซอยสมเด็จพระเจ้าตากสิน 12/1",5,195,261,281,542
1718,"บุคคโล","เขตธนบุรี",101504,"อาคารที่พักอาศัยส่วนกลาง กองทัพเรือ (บุคคโล) แฟลต 3",6,285,287,306,593
1719,"บุคคโล","เขตธนบุรี",101504,"อาคารที่พักอาศัยส่วนกลาง กองทัพเรือ (บุคคโล) แฟลต 3",7,263,284,260,544
1720,"บุคคโล","เขตธนบุรี",101504,"อาคารที่พักอาศัยส่วนกลาง กองทัพเรือ (บุคคโล) แฟลต 3",8,204,283,359,642
1721,"บุคคโล","เขตธนบุรี",101504,"อาคารที่พักอาศัยส่วนกลาง กองทัพเรือ (บุคคโล) แฟลต 4",9,177,322,344,666
1722,"บุคคโล","เขตธนบุรี",101504,"อาคารที่พักอาศัยส่วนกลาง กองทัพเรือ (บุคคโล) แฟลต 4",10,172,292,295,587
1723,"บุคคโล","เขตธนบุรี",101504,"อาคารที่พักอาศัยส่วนกลาง กองทัพเรือ (บุคคโล) แฟลต 4",11,136,297,325,622
1724,"บุคคโล","เขตธนบุรี",101504,"โรงเรียนวัดกระจับพินิจ (อาคาร 2 ชั้นล่าง)",12,210,370,398,768
1725,"บุคคโล","เขตธนบุรี",101504,"โรงเรียนวัดกระจับพินิจ (อาคาร 2 ชั้นล่าง)",13,201,319,366,685
1726,"บุคคโล","เขตธนบุรี",101504,"โรงเรียนวัดกระจับพินิจ (อาคาร 2 ชั้นล่าง)",14,306,350,419,769
1727,"บุคคโล","เขตธนบุรี",101504,"โรงเรียนวัดกระจับพินิจ (อาคาร 3 ชั้นล่าง)",15,210,332,369,701
1728,"บุคคโล","เขตธนบุรี",101504,"เต็นท์ที่จอดรถโรงพยาบาลสมเด็จพระปิ่นเกล้า (ข้างธนาคารทหารไทย)",16,121,152,423,575
1729,"บุคคโล","เขตธนบุรี",101504,"เต็นท์ที่จอดรถโรงพยาบาลสมเด็จพระปิ่นเกล้า(ข้างธนาคารทหารไทย)",17,228,308,352,660
1730,"บุคคโล","เขตธนบุรี",101504,"วัดสุทธาวาส (ศาลา 4 ชั้น)",18,532,363,506,869
1731,"บุคคโล","เขตธนบุรี",101504,"วัดสุทธาวาส (ศาลา 4 ชั้น)",19,519,339,470,809
1732,"ตลาดพลู","เขตธนบุรี",101505,"โรงเรียนธนบุรีวรเทพีพลารักษ์ (โรงอาหาร)",1,223,277,380,657
1733,"ตลาดพลู","เขตธนบุรี",101505,"โรงเรียนธนบุรีวรเทพีพลารักษ์ (โรงอาหาร)",2,170,314,359,673
1734,"ตลาดพลู","เขตธนบุรี",101505,"โรงเรียนกันตทาราราม (อาคาร 2 )",3,177,289,327,616
1735,"ตลาดพลู","เขตธนบุรี",101505,"โรงเรียนวัดขุนจันทร์ (อาคาร 1 ชั้นล่าง)",4,147,293,347,640
1736,"ตลาดพลู","เขตธนบุรี",101505,"โรงเรียนวัดขุนจันทร์ (อาคาร 1 ชั้นล่าง)",5,175,284,362,646
1737,"ตลาดพลู","เขตธนบุรี",101505,"โรงเรียนวัดขุนจันทร์ (อาคาร 1 ชั้นล่าง)",6,217,271,407,678
1738,"ตลาดพลู","เขตธนบุรี",101505,"โรงเรียนวัดขุนจันทร์ (อาคาร 2 ชั้นล่าง)",7,177,297,315,612
1739,"ตลาดพลู","เขตธนบุรี",101505,"โรงเรียนวัดบางสะแกนอก (โรงอาหาร)",8,183,268,299,567
1740,"ตลาดพลู","เขตธนบุรี",101505,"โรงเรียนวัดบางสะแกนอก (โรงอาหาร)",9,333,267,392,659
1741,"ตลาดพลู","เขตธนบุรี",101505,"โรงเรียนวัดบางสะแกนอก (หน้าเสาธง)",10,213,296,371,667
1742,"ตลาดพลู","เขตธนบุรี",101505,"โรงเรียนวัดบางสะแกนอก (ห้องประชุม)",11,314,280,367,647
1743,"ตลาดพลู","เขตธนบุรี",101505,"โรงเรียนวัดบางสะแกนอก (ห้องประชุม)",12,172,306,329,635
1744,"ตลาดพลู","เขตธนบุรี",101505,"โรงเรียนวัดบางสะแกใน (อาคาร 2 ห้องประชุม)",13,139,241,290,531
1745,"ตลาดพลู","เขตธนบุรี",101505,"โรงเรียนวัดบางสะแกใน (อาคาร 2 ห้องประชุม)",14,133,266,313,579
1746,"ตลาดพลู","เขตธนบุรี",101505,"เต็นท์ลานจอดรถคอนโดเมโทรสกาย ถนนวุฒากาส",15,199,287,348,635
1747,"ตลาดพลู","เขตธนบุรี",101505,"เต็นท์ลานจอดรถคอนโดเมโทรสกาย ถนนวุฒากาส",16,184,266,300,566
1748,"ตลาดพลู","เขตธนบุรี",101505,"วัดใหม่ยายนุ้ย (ศาลาวงษ์บัญญัติประชาร่วมบุญ)",17,151,248,274,522
1749,"ตลาดพลู","เขตธนบุรี",101505,"วัดใหม่ยายนุ้ย (ศาลาปทีปพลีผลประชาร่วมบุญ)",18,129,215,237,452
1750,"ตลาดพลู","เขตธนบุรี",101505,"โรงเรียนวัดใหม่ยายนุ้ย (ห้องประชุม)",19,145,239,241,480
1751,"ตลาดพลู","เขตธนบุรี",101505,"เต็นท์ลานอเนกประสงค์ตลาดพลู ถนนวุฒากาส",20,470,346,495,841
1752,"ดาวคะนอง","เขตธนบุรี",101506,"เต็นท์ตลาดนัดจินดา ซอยเทอดไทย 33",1,724,324,525,849
1753,"ดาวคะนอง","เขตธนบุรี",101506,"เต็นท์ตลาดนัดจินดา ซอยเทอดไทย 33",2,590,347,522,869
1754,"ดาวคะนอง","เขตธนบุรี",101506,"เต็นท์ตลาดนัดจินดา ซอยเทอดไทย 33",3,359,342,426,768
1755,"ดาวคะนอง","เขตธนบุรี",101506,"เต็นท์ตลาดนัดจินดา ซอยเทอดไทย 33",4,319,363,430,793
1756,"ดาวคะนอง","เขตธนบุรี",101506,"ที่จอดรถใต้อาคารศาลเจ้าโกบ๊อ ซอยสมเด็จพระเจ้าตากสิน 34",5,205,344,353,697
1757,"ดาวคะนอง","เขตธนบุรี",101506,"ที่จอดรถใต้อาคารศาลเจ้าโกบ๊อ ซอยสมเด็จพระเจ้าตากสิน 34",6,236,355,409,764
1758,"ดาวคะนอง","เขตธนบุรี",101506,"ที่จอดรถใต้อาคารศาลเจ้าโกบ๊อ ซอยสมเด็จพระเจ้าตากสิน 34",7,186,359,386,745
1759,"ดาวคะนอง","เขตธนบุรี",101506,"เต็นท์ข้างโรงเรียนประจักษ์วิทยา ซอยรัชดาภิเษก 5",8,174,341,339,680
1760,"ดาวคะนอง","เขตธนบุรี",101506,"เต็นท์ที่จอดรถอพาร์ทเม้นท์พีเอ็น สามัคคี ซอยรัชดาภิเษก 5",9,216,350,388,738
1761,"ดาวคะนอง","เขตธนบุรี",101506,"เต็นท์ที่จอดรถอพาร์ทเม้นท์พีเอ็น สามัคคี ซอยรัชดาภิเษก 5",10,294,324,421,745
1762,"ดาวคะนอง","เขตธนบุรี",101506,"ที่จอดรถใต้อาคารห้างสรรพสินค้าบิ๊กซี สาขาดาวคนอง",11,168,256,271,527
1763,"ดาวคะนอง","เขตธนบุรี",101506,"ที่จอดรถใต้อาคารห้างสรรพสินค้าบิ๊กซี สาขาดาวคนอง",12,183,304,355,659
1764,"ดาวคะนอง","เขตธนบุรี",101506,"ที่จอดรถใต้อาคารห้างสรรพสินค้าบิ๊กซี สาขาดาวคนอง",13,134,298,336,634
1765,"ดาวคะนอง","เขตธนบุรี",101506,"ชั้นล่างโรงภาพยนตร์ดาวคนองรามา",14,226,250,339,589
1766,"ดาวคะนอง","เขตธนบุรี",101506,"ที่จอดรถมูลนิธิตงฮั้วการแพทย์ (ธนบุรี)",15,166,190,250,440
1767,"ดาวคะนอง","เขตธนบุรี",101506,"เต็นท์หน้าธนาคารกสิกรไทย สาขาดาวคนองถนนสมเด็จพระเจ้าตากสิน",16,133,217,232,449
1768,"ดาวคะนอง","เขตธนบุรี",101506,"เต็นท์หน้ามูลนิธิศึกษาและเผยแพร่พระพุทธศาสนา ซอยเจริญนคร 78",17,205,280,336,616
1769,"ดาวคะนอง","เขตธนบุรี",101506,"เต็นท์ที่จอดรถศูนย์ซ่อมสีและตัวถัง บริษัท มาสด้า จำกัด ถนนเจริญนคร",18,155,225,264,489
1770,"ดาวคะนอง","เขตธนบุรี",101506,"เต็นท์ที่จอดรถศูนย์ซ่อมสีและตัวถัง บริษัท มาสด้า จำกัด ถนนเจริญนคร",19,250,266,310,576
1771,"ดาวคะนอง","เขตธนบุรี",101506,"เต็นท์ที่จอดรถศูนย์ซ่อมสีและตัวถัง บริษัท มาสด้า จำกัด ถนนเจริญนคร",20,158,235,261,496
1772,"ดาวคะนอง","เขตธนบุรี",101506,"โรงเรียนวัดบุคคโล (อาคาร 1 ห้องประชุม)",21,179,287,331,618
1773,"ดาวคะนอง","เขตธนบุรี",101506,"โรงเรียนวัดดาวคนอง (อาคาร 4 โรงอาหาร)",22,124,263,291,554
1774,"สำเหร่","เขตธนบุรี",101507,"เต็นท์หน้าบริษัท ฮุนได นีโอ จำกัด (ซอยสมเด็จพระเจ้าตากสิน 11)",1,383,364,484,848
1775,"สำเหร่","เขตธนบุรี",101507,"เต็นท์หน้าโรงพยาบาลสมิติเวช ธนบุรี",2,199,323,370,693
1776,"สำเหร่","เขตธนบุรี",101507,"เต็นท์หน้าโรงพยาบาลสมิติเวช ธนบุรี",3,228,337,392,729
1777,"สำเหร่","เขตธนบุรี",101507,"โรงเรียนฤดีศึกษา (ห้องเรียนอาคาร 1)",4,167,225,291,516
1778,"สำเหร่","เขตธนบุรี",101507,"โรงเรียนฤดีศึกษา (ห้องเรียนอาคาร 1)",5,183,232,289,521
1779,"สำเหร่","เขตธนบุรี",101507,"เต็นท์หน้าบริษัทซุปเปอร์ พี เฮ้าส์ ถนนสมเด็จพระเจ้าตากสิน",6,229,305,385,690
1780,"สำเหร่","เขตธนบุรี",101507,"เต็นท์หน้าบริษัทเกีย ตากสิน ถนนสมเด็จพระเจ้าตากสิน",7,202,306,369,675
1781,"สำเหร่","เขตธนบุรี",101507,"โรงเรียนวัดราชวรินทร์ (อาคาร 2 ชั้นล่าง)",8,183,294,321,615
1782,"สำเหร่","เขตธนบุรี",101507,"โรงเรียนวัดราชวรินทร์ (อาคาร 2 ชั้นล่าง)",9,149,293,327,620
1783,"สำเหร่","เขตธนบุรี",101507,"โรงเรียนวัดราชวรินทร์ (อาคาร 3 ชั้นล่าง)",10,183,297,336,633
1784,"สำเหร่","เขตธนบุรี",101507,"โรงเรียนวัดราชวรินทร์ (อาคาร 3 ชั้นล่าง)",11,167,244,296,540
1785,"สำเหร่","เขตธนบุรี",101507,"วัดสันติธรรมาราม (ศาลาอเนกประสงค์)",12,139,203,227,430
1786,"สำเหร่","เขตธนบุรี",101507,"วัดสันติธรรมาราม (ศาลาอเนกประสงค์)",13,142,211,242,453
1787,"สำเหร่","เขตธนบุรี",101507,"วัดสันติธรรมาราม (ศาลาอเนกประสงค์)",14,166,219,248,467
1788,"สำเหร่","เขตธนบุรี",101507,"เต็นท์ปากซอยสมเด็จพระเจ้าตากสิน 29",15,128,149,204,353
1789,"สำเหร่","เขตธนบุรี",101507,"เต็นท์ด้านข้าง ไซม์ ดาร์บี้ มาสด้า สาขาเจริญนคร",16,278,321,327,648
1790,"สำเหร่","เขตธนบุรี",101507,"โรงเรียนเกื้อวิทยา (ใต้อาคารเรียน)",17,145,222,243,465
1791,"สำเหร่","เขตธนบุรี",101507,"โรงเรียนเกื้อวิทยา (ใต้อาคารเรียน)",18,152,209,273,482
1792,"สำเหร่","เขตธนบุรี",101507,"สถานีตำรวจนครบาลสำเหร่ (ที่จอดรถใต้อาคาร)",19,195,261,340,601
1793,"สำเหร่","เขตธนบุรี",101507,"โรงเรียนวัดบางน้ำชน (อาคาร 1 ห้องประชุม)",20,353,232,332,564
1794,"สำเหร่","เขตธนบุรี",101507,"โรงเรียนวัดบางน้ำชน (อาคาร 1 ห้องประชุม)",21,138,216,253,469
1795,"วัดอรุณ","เขตบางกอกใหญ่",101601,"อาคารศูนย์บริการสาธารณสุข 33 วัดหงส์รัตนาราม",1,161,331,379,710
1796,"วัดอรุณ","เขตบางกอกใหญ่",101601,"เต็นท์บริเวณสนามโรงเรียนวัดหงส์รัตนาราม",2,99,202,247,449
1797,"วัดอรุณ","เขตบางกอกใหญ่",101601,"เต็นท์บริเวณสนามโรงเรียนวัดหงส์รัตนาราม",3,97,193,219,412
1798,"วัดอรุณ","เขตบางกอกใหญ่",101601,"เต็นท์บริเวณลานจอดรถ สน.บางกอกใหญ่",4,184,259,279,538
1799,"วัดอรุณ","เขตบางกอกใหญ่",101601,"เต็นท์บริเวณลานจอดรถ สน.บางกอกใหญ่",5,154,252,318,570
1800,"วัดอรุณ","เขตบางกอกใหญ่",101601,"เต็นท์บริเวณสนามโรงเรียนประถมทวีธาภิเศก",6,123,249,296,545
1801,"วัดอรุณ","เขตบางกอกใหญ่",101601,"เต็นท์บริเวณสนามโรงเรียนประถมทวีธาภิเศก",7,64,177,120,297
1802,"วัดอรุณ","เขตบางกอกใหญ่",101601,"เต็นท์บริเวณสนามโรงเรียนประถมทวีธาภิเศก",8,2,319,0,319
1803,"วัดอรุณ","เขตบางกอกใหญ่",101601,"เต็นท์บริเวณที่จอดรถฌาปนสถานกองทัพเรือ(วัดเครือวัลย์)",9,48,93,97,190
1804,"วัดอรุณ","เขตบางกอกใหญ่",101601,"อาคารโรงเรียนวัดนาคกลาง",10,100,186,240,426
1805,"วัดอรุณ","เขตบางกอกใหญ่",101601,"อาคารโรงเรียนวัดนาคกลาง",11,121,228,243,471
1806,"วัดอรุณ","เขตบางกอกใหญ่",101601,"อาคารโรงเรียนวัดนาคกลาง",12,104,201,247,448
1807,"วัดอรุณ","เขตบางกอกใหญ่",101601,"เต็นท์ที่ว่างโรงเรียนทวีธาภิเศก",13,196,313,377,690
1808,"วัดอรุณ","เขตบางกอกใหญ่",101601,"เต็นท์ในหมู่บ้านศิวาลัย (ระหว่างซอย 1-3)",14,132,195,248,443
1809,"วัดอรุณ","เขตบางกอกใหญ่",101601,"เต็นท์ในหมู่บ้านศิวาลัย (ระหว่างซอย 1-3)",15,233,213,327,540
1810,"วัดอรุณ","เขตบางกอกใหญ่",101601,"อาคารโรงเรียนวัดใหม่พิเรนทร์",16,168,247,324,571
1811,"วัดอรุณ","เขตบางกอกใหญ่",101601,"อาคารโรงเรียนวัดใหม่พิเรนทร์",17,132,255,279,534
1812,"วัดอรุณ","เขตบางกอกใหญ่",101601,"เต็นท์บริเวณรถไฟฟ้า สถานีอิสรภาพ (ปากซอยอิสรภาพ 23)",18,113,194,199,393
1813,"วัดอรุณ","เขตบางกอกใหญ่",101601,"เต็นท์บริเวณรถไฟฟ้า สถานีอิสรภาพ (ปากซอยอิสรภาพ 23)",19,132,224,272,496
1814,"วัดอรุณ","เขตบางกอกใหญ่",101601,"เต็นท์บริเวณรถไฟฟ้า สถานีอิสรภาพ (ด้านในซอยอิสรภาพ 34)",20,139,190,264,454
1815,"วัดท่าพระ","เขตบางกอกใหญ่",101602,"ฌาปนสถาน วัดราชสิทธารามฯ",1,140,323,344,667
1816,"วัดท่าพระ","เขตบางกอกใหญ่",101602,"ฌาปนสถาน วัดราชสิทธารามฯ",2,161,283,345,628
1817,"วัดท่าพระ","เขตบางกอกใหญ่",101602,"เต็นท์บริเวณฌาปนสถาน วัดราชสิทธารามฯ",3,191,281,334,615
1818,"วัดท่าพระ","เขตบางกอกใหญ่",101602,"ลานศาลาอุดมชัยพัฒนกิจ วัดราชสิทธารามฯ",4,199,327,363,690
1819,"วัดท่าพระ","เขตบางกอกใหญ่",101602,"อาคารโรงเรียนชาตศึกษา",5,276,348,427,775
1820,"วัดท่าพระ","เขตบางกอกใหญ่",101602,"อาคารโรงเรียนชาตศึกษา",6,236,355,414,769
1821,"วัดท่าพระ","เขตบางกอกใหญ่",101602,"อาคารโรงเรียนชาตศึกษา",7,161,308,352,660
1822,"วัดท่าพระ","เขตบางกอกใหญ่",101602,"เต็นท์บริเวณสนามโรงเรียนชาตศึกษา",8,202,244,310,554
1823,"วัดท่าพระ","เขตบางกอกใหญ่",101602,"เต็นท์บริเวณสนามโรงเรียนชาตศึกษา",9,134,141,176,317
1824,"วัดท่าพระ","เขตบางกอกใหญ่",101602,"อาคารโรงเรียนวัดดีดวด",10,196,328,403,731
1825,"วัดท่าพระ","เขตบางกอกใหญ่",101602,"อาคารโรงเรียนวัดดีดวด",11,210,270,369,639
1826,"วัดท่าพระ","เขตบางกอกใหญ่",101602,"เต็นท์บริเวณสนามโรงเรียนวัดดีดวด",12,245,286,400,686
1827,"วัดท่าพระ","เขตบางกอกใหญ่",101602,"เต็นท์บริเวณสนามโรงเรียนวัดดีดวด",13,226,302,357,659
1828,"วัดท่าพระ","เขตบางกอกใหญ่",101602,"เต็นท์ข้าง บริษัท ยุโรปา มอเตอร์ จำกัด(ด้านในซอยจรัญสนิทวงศ์ 14)",14,77,133,130,263
1829,"วัดท่าพระ","เขตบางกอกใหญ่",101602,"เต็นท์วิทยาลัยเทคโนโลยีสยาม",15,167,239,264,503
1830,"วัดท่าพระ","เขตบางกอกใหญ่",101602,"อาคารโรงเรียนวัดเจ้ามูล",16,156,233,284,517
1831,"วัดท่าพระ","เขตบางกอกใหญ่",101602,"อาคารโรงเรียนวัดเจ้ามูล",17,126,219,237,456
1832,"วัดท่าพระ","เขตบางกอกใหญ่",101602,"อาคารโรงเรียนวัดท่าพระ",18,238,257,347,604
1833,"วัดท่าพระ","เขตบางกอกใหญ่",101602,"อาคารโรงเรียนวัดท่าพระ",19,163,246,350,596
1834,"วัดท่าพระ","เขตบางกอกใหญ่",101602,"เต็นท์บริเวณสนามโรงเรียนวัดท่าพระ",20,187,255,337,592
1835,"วัดท่าพระ","เขตบางกอกใหญ่",101602,"เต็นท์บริเวณสนามโรงเรียนวัดท่าพระ",21,138,238,269,507
1836,"วัดท่าพระ","เขตบางกอกใหญ่",101602,"อาคารศาลาหลวงพ่อเกษรประชาสรรค์ วัดท่าพระ",22,130,266,295,561
1837,"วัดท่าพระ","เขตบางกอกใหญ่",101602,"อาคารศาลาหลวงพ่อเกษรประชาสรรค์ วัดท่าพระ",23,166,317,336,653
1838,"วัดท่าพระ","เขตบางกอกใหญ่",101602,"เต็นท์บริเวณทางเข้าสถานีสูบจ่ายน้ำ ท่าพระ",24,214,306,349,655
1839,"วัดท่าพระ","เขตบางกอกใหญ่",101602,"เต็นท์บริเวณทางเข้าสถานีสูบจ่ายน้ำ ท่าพระ",25,195,284,344,628
1840,"วัดท่าพระ","เขตบางกอกใหญ่",101602,"อาคารโรงเรียนวัดราชสิทธาราม",26,164,260,335,595
1841,"วัดท่าพระ","เขตบางกอกใหญ่",101602,"อาคารโรงเรียนวัดราชสิทธาราม",27,152,275,341,616
1842,"วัดท่าพระ","เขตบางกอกใหญ่",101602,"เต็นท์บริเวณสนามโรงเรียนวัดราชสิทธาราม",28,201,301,310,611
1843,"วัดท่าพระ","เขตบางกอกใหญ่",101602,"เต็นท์หน้าศาลาวิเศษนิยม วัดสังข์กระจายฯ",29,148,231,283,514
1844,"วัดท่าพระ","เขตบางกอกใหญ่",101602,"เต็นท์หน้าศาลาวิเศษนิยม วัดสังข์กระจายฯ",30,93,222,224,446
1845,"วัดท่าพระ","เขตบางกอกใหญ่",101602,"อาคารโรงเรียนชัยพิทยพัฒน์ มูลนิธิชัยพัฒนา(จารุวัฒนานุกูลท่าพระ)",31,192,275,335,610
1846,"วัดท่าพระ","เขตบางกอกใหญ่",101602,"อาคารโรงเรียนชัยพิทยพัฒน์ มูลนิธิชัยพัฒนา (จารุวัฒนานุกูลท่าพระ)",32,160,246,294,540
1847,"วัดท่าพระ","เขตบางกอกใหญ่",101602,"อาคารโรงเรียนชัยพิทยพัฒน์ มูลนิธิชัยพัฒนา (จารุวัฒนานุกูลท่าพระ)",33,172,257,299,556
1848,"วัดท่าพระ","เขตบางกอกใหญ่",101602,"อาคารโรงเรียนฤทธิณรงค์รอน",34,116,151,177,328
1849,"วัดท่าพระ","เขตบางกอกใหญ่",101602,"เต็นท์ลานจอดรถซอยชูเวทย์ (ก่อนถึงซอยจำเนียรสุข 3)",35,129,185,227,412
1850,"วัดท่าพระ","เขตบางกอกใหญ่",101602,"เต็นท์บริเวณปลายซอยจำเนียรสุข 3",36,127,182,209,391
1851,"วัดท่าพระ","เขตบางกอกใหญ่",101602,"เต็นท์บริเวณหน้า หจก. แอร์ธนบุรีซาวด์ (ปากซอยเพชรเกษม 4)",37,329,339,404,743
1852,"วัดท่าพระ","เขตบางกอกใหญ่",101602,"เต็นท์บริเวณหน้า หจก. แอร์ธนบุรีซาวด์ (ปากซอยเพชรเกษม 4)",38,218,344,347,691
1853,"วัดท่าพระ","เขตบางกอกใหญ่",101602,"เต็นท์บริเวณปากซอยเชิงพงษ์จิตต์",39,138,271,280,551
1854,"วัดท่าพระ","เขตบางกอกใหญ่",101602,"เต็นท์บริเวณหน้า บ้านเลขที่ 11/17-18 ถนนเพชรเกษม(ฝั่งเลขคี่)",40,153,223,255,478
1855,"วัดท่าพระ","เขตบางกอกใหญ่",101602,"เต็นท์บริเวณสะพานลอย ข้างบ้านเลขที่ 11/24 ถนนเพชรเกษม(ฝั่งเลขคี่)",41,147,224,281,505
1856,"วัดท่าพระ","เขตบางกอกใหญ่",101602,"อาคารโรงเรียนสายประสิทธิ์วิทยา",42,506,373,533,906
1857,"วัดท่าพระ","เขตบางกอกใหญ่",101602,"อาคารโรงเรียนสายประสิทธิ์วิทยา",43,593,389,529,918
1858,"วัดท่าพระ","เขตบางกอกใหญ่",101602,"เต็นท์บริเวณหน้า บริษัท อีสเทอร์น ควีนฯ(ปากซอยรัชดาภิเษก 16)",44,220,262,327,589
1859,"วัดท่าพระ","เขตบางกอกใหญ่",101602,"เต็นท์บริเวณหน้า บริษัท พี.เค.ซิลเวอร์กรุ๊ป จำกัด(ปากซอยรัชดาภิเษก 19)",45,427,370,519,889
1860,"วัดท่าพระ","เขตบางกอกใหญ่",101602,"อาคารโรงเรียนวัดประดู่ฉิมพลี",46,94,162,151,313
1861,"วัดท่าพระ","เขตบางกอกใหญ่",101602,"อาคารโรงเรียนวัดประดู่ในทรงธรรม",47,187,287,336,623
1862,"วัดท่าพระ","เขตบางกอกใหญ่",101602,"อาคารโรงเรียนวัดประดู่ในทรงธรรม",48,150,315,349,664
1863,"วัดท่าพระ","เขตบางกอกใหญ่",101602,"ที่จอดรถสำนักงานกิ่งศาลิคุปต์ (ปากซอยเพชรเกษม 17)",49,151,215,248,463
1864,"วัดท่าพระ","เขตบางกอกใหญ่",101602,"อาคารวิทยาลัยอาชีวศึกษากรุงเทพธุรกิจ(วิทยาลัยเทคโนโลยีวิบูลย์บริหารธุรกิจเดิม)",50,138,204,225,429
1865,"วัดท่าพระ","เขตบางกอกใหญ่",101602,"อาคารวิทยาลัยอาชีวศึกษากรุงเทพธุรกิจ(วิทยาลัยเทคโนโลยีวิบูลย์บริหารธุรกิจเดิม)",51,180,266,311,577
1866,"วัดท่าพระ","เขตบางกอกใหญ่",101602,"เต็นท์บริเวณสนามวิทยาลัยอาชีวศึกษากรุงเทพธุรกิจ(วิทยาลัยเทคโนโลยีวิบูลย์บริหารธุรกิจเดิม)",52,195,258,320,578
1867,"วัดท่าพระ","เขตบางกอกใหญ่",101602,"เต็นท์บริเวณหน้าบ้านเลขที่ 23/58 - 59 (เลยปากซอยจรัญสนิทวงศ์ 1)",53,338,346,426,772
1868,"วัดท่าพระ","เขตบางกอกใหญ่",101602,"เต็นท์บริเวณหน้าบ้านเลขที่ 23/65 (เลยปากซอยจรัญสนิทวงศ์ 1)",54,202,286,358,644
1869,"วัดท่าพระ","เขตบางกอกใหญ่",101602,"หจก.ห้างกระจก ตั้ง ฮง เส็ง (ห้างกระจกไทยอาซาฮี)",55,202,270,323,593
1870,"วัดท่าพระ","เขตบางกอกใหญ่",101602,"หจก.ห้างกระจก ตั้ง ฮง เส็ง (ห้างกระจกไทยอาซาฮี)",56,523,227,414,641
1871,"วัดท่าพระ","เขตบางกอกใหญ่",101602,"หจก.ห้างกระจก ตั้ง ฮง เส็ง (ห้างกระจกไทยอาซาฮี)",57,426,289,385,674
1872,"วัดท่าพระ","เขตบางกอกใหญ่",101602,"เต็นท์บริเวณชุมชนปลายซอยศักดิ์เจริญ (ซอยจรัญสนิทวงศ์ 3)",58,203,266,391,657
1873,"วัดท่าพระ","เขตบางกอกใหญ่",101602,"เต็นท์บริเวณชุมชนปลายซอยศักดิ์เจริญ (ซอยจรัญสนิทวงศ์ 3)",59,270,316,397,713
1874,"วัดท่าพระ","เขตบางกอกใหญ่",101602,"เต็นท์บริเวณชุมชนปลายซอยศักดิ์เจริญ (ซอยจรัญสนิทวงศ์ 3)",60,136,247,262,509
1875,"วัดท่าพระ","เขตบางกอกใหญ่",101602,"เต็นท์บริเวณหน้าร้าน กิน กัน จัง ชาบู ชีส(เลยปากซอยจรัญสนิทวงศ์ 3)",61,137,194,235,429
1876,"วัดท่าพระ","เขตบางกอกใหญ่",101602,"เต็นท์บริเวณที่ว่างปากซอยจรัญสนิทวงศ์ 7",62,172,283,324,607
1877,"วัดท่าพระ","เขตบางกอกใหญ่",101602,"เต็นท์บริเวณที่ว่างปากซอยจรัญสนิทวงศ์ 7",63,169,286,318,604
1878,"วัดท่าพระ","เขตบางกอกใหญ่",101602,"เต็นท์บริเวณที่ว่างปากซอยจรัญสนิทวงศ์ 7",64,148,270,301,571
1879,"วัดท่าพระ","เขตบางกอกใหญ่",101602,"เต็นท์บริเวณที่ว่างปากซอยจรัญสนิทวงศ์ 7",65,147,226,289,515
1880,"วัดท่าพระ","เขตบางกอกใหญ่",101602,"เต็นท์บริเวณหน้าธนาคารกสิกรไทย สาขาจรัญสนิทวงศ์ 11",66,188,224,282,506
1881,"วัดท่าพระ","เขตบางกอกใหญ่",101602,"เต็นท์บริเวณที่จอดรถธนาคารกรุงไทย สาขาจรัญสนิทวงศ์ 13",67,194,236,285,521
1882,"วัดท่าพระ","เขตบางกอกใหญ่",101602,"เต็นท์บริเวณสนามวิทยาลัยอาชีวศึกษาธนบุรี",68,257,292,346,638
1883,"วัดท่าพระ","เขตบางกอกใหญ่",101602,"เต็นท์บริเวณสนามวิทยาลัยอาชีวศึกษาธนบุรี",69,195,276,320,596
1884,"วัดท่าพระ","เขตบางกอกใหญ่",101602,"เต็นท์บริเวณสนามวิทยาลัยอาชีวศึกษาธนบุรี",70,185,253,320,573
1885,"วัดท่าพระ","เขตบางกอกใหญ่",101602,"เต็นท์บริเวณสนามวิทยาลัยอาชีวศึกษาธนบุรี",71,189,263,310,573
1886,"วัดท่าพระ","เขตบางกอกใหญ่",101602,"เต็นท์บริเวณสนามวิทยาลัยอาชีวศึกษาธนบุรี",72,162,233,287,520
1887,"วัดท่าพระ","เขตบางกอกใหญ่",101602,"อู่ซ่อมรถ ที 21 ซอยพาณิชยการธนบุรี 21",73,329,350,447,797
1888,"ห้วยขวาง","เขตห้วยขวาง",101701,"เต็นท์ที่จอดรถ บริษัท ท็อปโมสต์ ออโต้ อิมพอร์ต จำกัด ถนนพระราม 9",1,454,271,374,645
1889,"ห้วยขวาง","เขตห้วยขวาง",101701,"เต็นท์ที่จอดรถ บริษัท ท็อปโมสต์ ออโต้ อิมพอร์ต จำกัด ถนนพระราม 9",2,414,284,401,685
1890,"ห้วยขวาง","เขตห้วยขวาง",101701,"เต็นท์ที่จอดรถ บริษัท ท็อปโมสต์ ออโต้ อิมพอร์ต จำกัด ถนนพระราม 9",3,497,281,375,656
1891,"ห้วยขวาง","เขตห้วยขวาง",101701,"เต็นท์ที่จอดรถ บริษัท ท็อปโมสต์ ออโต้ อิมพอร์ต จำกัด ถนนพระราม 9",4,453,211,329,540
1892,"ห้วยขวาง","เขตห้วยขวาง",101701,"เต็นท์ที่จอดรถ บริษัท ท็อปโมสต์ ออโต้ อิมพอร์ต จำกัด ถนนพระราม 9",5,578,284,424,708
1893,"ห้วยขวาง","เขตห้วยขวาง",101701,"โรงเรียนเตรียมอุดมศึกษาพัฒนาการ รัชดา ถนนรัชดาภิเษก",6,230,265,335,600
1894,"ห้วยขวาง","เขตห้วยขวาง",101701,"โรงเรียนเตรียมอุดมศึกษาพัฒนาการ รัชดา ถนนรัชดาภิเษก",7,426,228,371,599
1895,"ห้วยขวาง","เขตห้วยขวาง",101701,"โรงเรียนเตรียมอุดมศึกษาพัฒนาการ รัชดา ถนนรัชดาภิเษก",8,415,300,373,673
1896,"ห้วยขวาง","เขตห้วยขวาง",101701,"โรงเรียนเตรียมอุดมศึกษาพัฒนาการ รัชดา ถนนรัชดาภิเษก",9,630,310,421,731
1897,"ห้วยขวาง","เขตห้วยขวาง",101701,"โรงเรียนเตรียมอุดมศึกษาพัฒนาการ รัชดา ถนนรัชดาภิเษก",10,527,281,349,630
1898,"ห้วยขวาง","เขตห้วยขวาง",101701,"เต็นท์ลานจอดรถ แมนชั่นเซเว่น ถนนรัชดาภิเษก",11,220,290,358,648
1899,"ห้วยขวาง","เขตห้วยขวาง",101701,"ที่จอดรถ บริษัท โตโยต้า เค มอเตอร์ จำกัด ซอยประชาราษฎร์บำเพ็ญ 3",12,288,273,350,623
1900,"ห้วยขวาง","เขตห้วยขวาง",101701,"ที่จอดรถ บริษัท โตโยต้า เค มอเตอร์ จำกัด ซอยประชาราษฎร์บำเพ็ญ 3",13,355,273,419,692
1901,"ห้วยขวาง","เขตห้วยขวาง",101701,"ที่จอดรถ บริษัท โตโยต้า เค มอเตอร์ จำกัด ซอยประชาราษฎร์บำเพ็ญ 3",14,199,226,281,507
1902,"ห้วยขวาง","เขตห้วยขวาง",101701,"ลานจอดรถ ฐมศรแมนชั่น ซอยประชาราษฎร์บำเพ็ญ 14",15,325,291,440,731
1903,"ห้วยขวาง","เขตห้วยขวาง",101701,"เต็นท์ปากซอยประชาราษฎร์บำเพ็ญ 6 ย้ายมาจาก(ลานจอดรถ โรงแรมรัชดาซิตี้ ซอยประชาราษฎร์บำเพ็ญ 6)",16,183,192,298,490
1904,"ห้วยขวาง","เขตห้วยขวาง",101701,"เต็นท์ปากซอยประชาราษฎร์บำเพ็ญ 6ย้ายมาจาก(ลานจอดรถ โรงแรมรัชดาซิตี้ ซอยประชาราษฎร์บำเพ็ญ 6)",17,238,279,338,617
1905,"ห้วยขวาง","เขตห้วยขวาง",101701,"เต็นท์ลานกีฬา สวนราษฎร์บำเพ็ญ ซอยประชาราษฎร์บำเพ็ญ 11",18,231,300,383,683
1906,"ห้วยขวาง","เขตห้วยขวาง",101701,"เต็นท์ลานกีฬา สวนราษฎร์บำเพ็ญ ซอยประชาราษฎร์บำเพ็ญ 9",19,251,378,405,783
1907,"ห้วยขวาง","เขตห้วยขวาง",101701,"เต็นท์ลานจอดรถฝ่ายรักษาความสะอาดและสวนสาธารณะ(ย้ายมาจาก เต็นท์ร้านออโต้ โทรนิค)",20,201,201,305,506
1908,"ห้วยขวาง","เขตห้วยขวาง",101701,"เต็นท์ลานจอดรถฝ่ายรักษาความสะอาดและสวนสาธารณะ (ย้ายมาจาก เต็นท์ร้านออโต้ โทรนิค)",21,289,284,400,684
1909,"ห้วยขวาง","เขตห้วยขวาง",101701,"ลานจอดรถ ดิ โอเอซิส ซอย 20 มิถุนา 11",22,254,262,355,617
1910,"ห้วยขวาง","เขตห้วยขวาง",101701,"เต็นท์ลานจอดรถเซเว่นอีเลฟเว่น ถนนประชาอุทิศ",23,391,242,346,588
1911,"ห้วยขวาง","เขตห้วยขวาง",101701,"เต็นท์ลานจอดรถเซเว่นอีเลฟเว่น ถนนประชาอุทิศ",24,506,246,403,649
1912,"ห้วยขวาง","เขตห้วยขวาง",101701,"เต็นท์ลานจอดรถเซเว่นอีเลฟเว่น ถนนประชาอุทิศ",25,227,252,317,569
1913,"ห้วยขวาง","เขตห้วยขวาง",101701,"โรงเรียนบางกอกทวิวิทย์ ถนนประชาอุทิศ",26,317,293,412,705
1914,"ห้วยขวาง","เขตห้วยขวาง",101701,"โรงเรียนบางกอกทวิวิทย์ ถนนประชาอุทิศ",27,573,294,435,729
1915,"ห้วยขวาง","เขตห้วยขวาง",101701,"โรงเรียนบางกอกทวิวิทย์ ถนนประชาอุทิศ",28,427,235,392,627
1916,"ห้วยขวาง","เขตห้วยขวาง",101701,"โรงเรียนบางกอกทวิวิทย์ ถนนประชาอุทิศ",29,450,322,434,756
1917,"ห้วยขวาง","เขตห้วยขวาง",101701,"โรงเรียนบางกอกทวิวิทย์ ถนนประชาอุทิศ",30,205,300,369,669
1918,"ห้วยขวาง","เขตห้วยขวาง",101701,"เต็นท์ร้านแซ่บ ถนนสุทธิสารวินิจฉัย",31,211,219,269,488
1919,"ห้วยขวาง","เขตห้วยขวาง",101701,"เต็นท์ร้านแซ่บ ถนนสุทธิสารวินิจฉัย",32,272,236,296,532
1920,"ห้วยขวาง","เขตห้วยขวาง",101701,"เต็นท์ลานจอดรถ ฟิโดอินเตอร์เนชั่นแนล ถนนสุทธิสารวินิจฉัย",33,181,223,299,522
1921,"บางกะปิ","เขตห้วยขวาง",101702,"โรงเรียนวัดอุทัยธาราม",1,682,350,462,812
1922,"บางกะปิ","เขตห้วยขวาง",101702,"โรงเรียนวัดอุทัยธาราม",2,373,302,370,672
1923,"บางกะปิ","เขตห้วยขวาง",101702,"โรงเรียนวัดอุทัยธาราม",3,667,304,484,788
1924,"บางกะปิ","เขตห้วยขวาง",101702,"โรงเรียนวัดอุทัยธาราม",4,445,273,410,683
1925,"บางกะปิ","เขตห้วยขวาง",101702,"โรงเรียนอันวารุ้ลอิสลาม ถนนเพชรพระราม",5,177,228,285,513
1926,"บางกะปิ","เขตห้วยขวาง",101702,"โรงเรียนอันวารุ้ลอิสลาม ถนนเพชรพระราม",6,184,288,270,558
1927,"บางกะปิ","เขตห้วยขวาง",101702,"โรงเรียนอันวารุ้ลอิสลาม ถนนเพชรพระราม",7,220,286,263,549
1928,"บางกะปิ","เขตห้วยขวาง",101702,"โรงเรียนอันวารุ้ลอิสลาม ถนนเพชรพระราม",8,199,283,304,587
1929,"บางกะปิ","เขตห้วยขวาง",101702,"โรงเรียนอันวารุ้ลอิสลาม ถนนเพชรพระราม",9,231,259,336,595
1930,"บางกะปิ","เขตห้วยขวาง",101702,"โรงเรียนวัดใหม่ช่องลม ถนนเพชรบุรีตัดใหม่",10,446,270,370,640
1931,"บางกะปิ","เขตห้วยขวาง",101702,"โรงเรียนวัดใหม่ช่องลม ถนนเพชรบุรีตัดใหม่",11,349,266,383,649
1932,"บางกะปิ","เขตห้วยขวาง",101702,"โรงเรียนวัดใหม่ช่องลม ถนนเพชรบุรีตัดใหม่",12,482,255,400,655
1933,"บางกะปิ","เขตห้วยขวาง",101702,"โรงเรียนวัดใหม่ช่องลม ถนนเพชรบุรีตัดใหม่",13,366,328,381,709
1934,"บางกะปิ","เขตห้วยขวาง",101702,"เต็นท์โรงเรียนดลวิทยา ซอยศูนย์วิจัย 10",14,252,275,292,567
1935,"บางกะปิ","เขตห้วยขวาง",101702,"เต็นท์โรงเรียนดลวิทยา ซอยศูนย์วิจัย 10",15,448,251,396,647
1936,"บางกะปิ","เขตห้วยขวาง",101702,"เต็นท์โรงเรียนดลวิทยา ซอยศูนย์วิจัย 10",16,271,252,356,608
1937,"บางกะปิ","เขตห้วยขวาง",101702,"เต็นท์โรงเรียนดลวิทยา ซอยศูนย์วิจัย 10",17,298,271,363,634
1938,"บางกะปิ","เขตห้วยขวาง",101702,"เต็นท์โรงเรียนดลวิทยา ซอยศูนย์วิจัย 10",18,250,242,295,537
1939,"บางกะปิ","เขตห้วยขวาง",101702,"เต็นท์โรงเรียนดลวิทยา ซอยศูนย์วิจัย 10",19,306,295,357,652
1940,"บางกะปิ","เขตห้วยขวาง",101702,"เต็นท์โรงเรียนพระราม ๙ กาญจนาภิเษก",20,300,245,355,600
1941,"บางกะปิ","เขตห้วยขวาง",101702,"เต็นท์โรงเรียนพระราม ๙ กาญจนาภิเษก",21,481,223,322,545
1942,"บางกะปิ","เขตห้วยขวาง",101702,"เต็นท์โรงเรียนพระราม ๙ กาญจนาภิเษก",22,424,287,384,671
1943,"บางกะปิ","เขตห้วยขวาง",101702,"เต็นท์ลานกีฬาชุมชนบึงพระราม ๙ พัฒนา  (ย้ายมาจาก ศูนย์พัฒนาเด็กเล็กชุมชนบึงพระราม ๙ พัฒนา)",23,134,223,225,448
1944,"บางกะปิ","เขตห้วยขวาง",101702,"เต็นท์ลานกีฬาชุมชนบึงพระราม ๙ พัฒนา  (ย้ายมาจาก ศูนย์พัฒนาเด็กเล็กชุมชนบึงพระราม ๙ พัฒนา)",24,131,252,242,494
1945,"บางกะปิ","เขตห้วยขวาง",101702,"เต็นท์ลานกีฬาชุมชนบึงพระราม ๙(ย้ายมาจาก ศูนย์พัฒนาเด็กเล็กชุมชนบึงพระราม ๙)",25,99,217,216,433
1946,"บางกะปิ","เขตห้วยขวาง",101702,"เต็นท์ลานกีฬาชุมชนบึงพระราม ๙(ย้ายมาจาก ศูนย์พัฒนาเด็กเล็กชุมชนบึงพระราม ๙)",26,111,237,226,463
1947,"สามเสนนอก","เขตห้วยขวาง",101704,"เต็นท์ลานจอดรถ พี เค แมนชั่น ซอยลาดพร้าว 35/1",1,172,255,317,572
1948,"สามเสนนอก","เขตห้วยขวาง",101704,"เต็นท์ลานจอดรถ พี เค แมนชั่น ซอยลาดพร้าว 35/1",2,224,260,339,599
1949,"สามเสนนอก","เขตห้วยขวาง",101704,"เต็นท์ลานจอดรถ พี เค แมนชั่น ซอยลาดพร้าว 35/1",3,195,243,298,541
1950,"สามเสนนอก","เขตห้วยขวาง",101704,"เต็นท์ลานจอดรถ พี เค แมนชั่น ซอยลาดพร้าว 35/1",4,204,276,304,580
1951,"สามเสนนอก","เขตห้วยขวาง",101704,"เต็นท์ที่ว่างติดกับปั๊มน้ำมันเซลล์ ถนนลาดพร้าว(ย้ายมาจาก ลานจอดรถธนาคารกรุงเทพ จำกัด สาขาลาดพร้าว 44)",5,321,208,322,530
1952,"สามเสนนอก","เขตห้วยขวาง",101704,"เต็นท์ที่ว่างติดกับปั๊มน้ำมันเชลล์ ถนนลาดพร้าว(ย้ายมาจาก ลานจอดรถธนาคารกรุงเทพ จำกัด สาขาลาดพร้าว 44)",6,150,221,257,478
1953,"สามเสนนอก","เขตห้วยขวาง",101704,"เต็นท์ศูนย์บริการสาธารณสุข 15 ลาดพร้าว",7,194,211,247,458
1954,"สามเสนนอก","เขตห้วยขวาง",101704,"เต็นท์ศูนย์บริการสาธารณสุข 15 ลาดพร้าว",8,229,182,243,425
1955,"สามเสนนอก","เขตห้วยขวาง",101704,"เต็นท์ศูนย์บริการสาธารณสุข 15 ลาดพร้าว",9,227,211,281,492
1956,"สามเสนนอก","เขตห้วยขวาง",101704,"เต็นท์โรงเรียนพิบูลอุปถัมภ์ ถนนลาดพร้าว",10,222,230,323,553
1957,"สามเสนนอก","เขตห้วยขวาง",101704,"เต็นท์โรงเรียนพิบูลอุปถัมภ์ ถนนลาดพร้าว",11,118,270,293,563
1958,"สามเสนนอก","เขตห้วยขวาง",101704,"เต็นท์โรงเรียนพิบูลอุปถัมภ์ ถนนลาดพร้าว",12,155,275,303,578
1959,"สามเสนนอก","เขตห้วยขวาง",101704,"เต็นท์โรงเรียนพิบูลอุปถัมภ์ ถนนลาดพร้าว",13,150,257,301,558
1960,"สามเสนนอก","เขตห้วยขวาง",101704,"เต็นท์โรงเรียนอนุบาล 3 ภาษาบ้านต้นไม้ ซอยลาดพร้าว48 แยก11",14,333,250,344,594
1961,"สามเสนนอก","เขตห้วยขวาง",101704,"เต็นท์โรงเรียนอนุบาล 3 ภาษาบ้านต้นไม้ ซอยลาดพร้าว48 แยก11",15,376,249,386,635
1962,"สามเสนนอก","เขตห้วยขวาง",101704,"เต็นท์โรงเรียนอนุบาล 3 ภาษาบ้านต้นไม้ ซอยลาดพร้าว48 แยก11",16,299,261,348,609
1963,"สามเสนนอก","เขตห้วยขวาง",101704,"เต็นท์ลานจอดรถ ด้านหลังอาคารบริษัท รักษาความปลอดภัยทีสร์ กรุ๊ป จำกัด ซอยลาดพร้าว 48 แยก 6 (ซอยพชรวี)",17,264,269,330,599
1964,"สามเสนนอก","เขตห้วยขวาง",101704,"เต็นท์ลานจอดรถ ด้านหลังอาคารบริษัท รักษาความปลอดภัยทีสร์ กรุ๊ป จำกัด ซอยลาดพร้าว 48 แยก 6 (ซอยพชรวี)",18,222,268,356,624
1965,"สามเสนนอก","เขตห้วยขวาง",101704,"โรงเรียนอนุบาลวัฒนานิเวศน์ ซอยวัฒนานิเวศน์ 5 (ลาดพร้าว 48)",19,252,319,397,716
1966,"สามเสนนอก","เขตห้วยขวาง",101704,"โรงเรียนอนุบาลวัฒนานิเวศน์ ซอยวัฒนานิเวศน์ 5 (ลาดพร้าว 48)",20,222,250,359,609
1967,"สามเสนนอก","เขตห้วยขวาง",101704,"โรงเรียนอนุบาลวัฒนานิเวศน์ ซอยวัฒนานิเวศน์ 5 (ลาดพร้าว 48)",21,229,261,338,599
1968,"สามเสนนอก","เขตห้วยขวาง",101704,"โรงเรียนสิริเทพ ซอยวัฒนานิเวศน์ 5 (ซอยลาดพร้าว 48 )",22,216,267,316,583
1969,"สามเสนนอก","เขตห้วยขวาง",101704,"โรงเรียนสิริเทพ ซอยวัฒนานิเวศน์ 5 (ซอยลาดพร้าว 48 )",23,200,249,299,548
1970,"สามเสนนอก","เขตห้วยขวาง",101704,"เต็นท์ลานจอดรถเซเว่นอีเลฟเว่น ปากซอยสิทธิปัญญา (ย้ายมาจาก โรงเรียนสมฤทัย ถนนสุทธิสารวินิจฉัย)",24,213,271,310,581
1971,"สามเสนนอก","เขตห้วยขวาง",101704,"เต็นท์ลานจอดรถเซเว่นอีเลฟเว่น ปากซอยสิทธิปัญญา(ย้ายมาจาก โรงเรียนสมฤทัย ถนนสุทธิสารวินิจฉัย)",25,259,247,378,625
1972,"สามเสนนอก","เขตห้วยขวาง",101704,"เต็นท์ลานจอดรถเซเว่นอีเลฟเว่น ปากซอยสิทธิปัญญา(ย้ายมาจาก โรงเรียนสมฤทัย ถนนสุทธิสารวินิจฉัย)",26,245,241,336,577
1973,"สามเสนนอก","เขตห้วยขวาง",101704,"เต็นท์ลานจอดรถเซเว่นอีเลฟเว่น ปากซอยสิทธิปัญญา(ย้ายมาจาก โรงเรียนสมฤทัย ถนนสุทธิสารวินิจฉัย)",27,224,219,297,516
1974,"สามเสนนอก","เขตห้วยขวาง",101704,"เต็นท์ลานจอดรถ เอ ไอ ที กรุ๊ป ถนนสุทธิสารวินิจฉัย",28,566,293,410,703
1975,"สามเสนนอก","เขตห้วยขวาง",101704,"เต็นท์ลานจอดรถ เอ ไอ ที กรุ๊ป ถนนสุทธิสารวินิจฉัย",29,322,252,325,577
1976,"สามเสนนอก","เขตห้วยขวาง",101704,"เต็นท์ลานจอดรถ เอ ไอ ที กรุ๊ป ถนนสุทธิสารวินิจฉัย",30,428,223,377,600
1977,"สามเสนนอก","เขตห้วยขวาง",101704,"เต็นท์ลานจอดรถโรงแรม นาซ่า การ์เด็น ซอย 20 มิถุนา 11 แยก4",31,241,236,302,538
1978,"สามเสนนอก","เขตห้วยขวาง",101704,"เต็นท์ลานจอดรถโรงแรม นาซ่า การ์เด็น ซอย 20 มิถุนา 11 แยก4",32,293,301,398,699
1979,"สามเสนนอก","เขตห้วยขวาง",101704,"ลานจอดรถสำนักงานศุุภชัยการบัญชี ปากซอย 20 มิถุนา 11 แยก17",33,208,248,304,552
1980,"สามเสนนอก","เขตห้วยขวาง",101704,"ลานจอดรถสำนักงานศุุภชัยการบัญชี ปากซอย 20 มิถุนา 11 แยก17",34,232,205,286,491
1981,"สามเสนนอก","เขตห้วยขวาง",101704,"ลานจอดรถสำนักงานศุุภชัยการบัญชี ปากซอย 20 มิถุนา 11 แยก17",35,163,209,255,464
1982,"สามเสนนอก","เขตห้วยขวาง",101704,"ลานจอดรถสำราญแมนชั่น ถนนประชาราษฎร์บำเพ็ญ",36,242,129,241,370
1983,"สามเสนนอก","เขตห้วยขวาง",101704,"ลานจอดรถสำราญแมนชั่น ถนนประชาราษฎร์บำเพ็ญ",37,148,143,216,359
1984,"สามเสนนอก","เขตห้วยขวาง",101704,"เต็นท์โรงเรียนประชาราษฎร์บำเพ็ญ",38,356,182,345,527
1985,"สามเสนนอก","เขตห้วยขวาง",101704,"เต็นท์โรงเรียนประชาราษฎร์บำเพ็ญ",39,201,239,286,525
1986,"สามเสนนอก","เขตห้วยขวาง",101704,"เต็นท์โรงเรียนประชาราษฎร์บำเพ็ญ",40,267,223,293,516
1987,"สามเสนนอก","เขตห้วยขวาง",101704,"โรงเรียนอนุบาลบุณยรักษ์ ถนนรัชดานิเวศน์",41,147,187,216,403
1988,"สามเสนนอก","เขตห้วยขวาง",101704,"โรงเรียนอนุบาลบุณยรักษ์ ถนนรัชดานิเวศน์",42,172,183,231,414
1989,"สามเสนนอก","เขตห้วยขวาง",101704,"โรงเรียนจันทร์หุ่นบำเพ็ญ",43,225,244,371,615
1990,"สามเสนนอก","เขตห้วยขวาง",101704,"โรงเรียนจันทร์หุ่นบำเพ็ญ",44,238,279,355,634
1991,"สามเสนนอก","เขตห้วยขวาง",101704,"โรงเรียนจันทร์หุ่นบำเพ็ญ",45,261,285,371,656
1992,"สามเสนนอก","เขตห้วยขวาง",101704,"โรงเรียนจันทร์หุ่นบำเพ็ญ",46,207,234,308,542
1993,"สามเสนนอก","เขตห้วยขวาง",101704,"โรงเรียนจันทร์หุ่นบำเพ็ญ",47,242,260,309,569
1994,"สามเสนนอก","เขตห้วยขวาง",101704,"เต็นท์ลานจอดรถหน้าอาคารปรีชาคอมเพล็กซ์ ถนนรัชดาภิเษก",48,292,232,316,548
1995,"สามเสนนอก","เขตห้วยขวาง",101704,"เต็นท์ลานจอดรถหน้าอาคารปรีชาคอมเพล็กซ์ ถนนรัชดาภิเษก",49,224,201,253,454
1996,"สามเสนนอก","เขตห้วยขวาง",101704,"เต็นท์ลานจอดรถสวนอาหารนาทอง ถนนประชาอุทิศ",50,278,286,340,626
1997,"สามเสนนอก","เขตห้วยขวาง",101704,"เต็นท์ลานจอดรถสวนอาหารนาทอง ถนนประชาอุทิศ",51,261,279,353,632
1998,"สามเสนนอก","เขตห้วยขวาง",101704,"เต็นท์ลานจอดรถสวนอาหารนาทอง ถนนประชาอุทิศ",52,200,289,316,605
1999,"สามเสนนอก","เขตห้วยขวาง",101704,"เต็นท์ลานจอดรถสวนอาหารนาทอง ถนนประชาอุทิศ",53,162,277,329,606
2000,"สามเสนนอก","เขตห้วยขวาง",101704,"เต็นท์ลานจอดรถสวนอาหารนาทอง ถนนประชาอุทิศ",54,215,236,284,520
2001,"สามเสนนอก","เขตห้วยขวาง",101704,"ลานจอดรถ อาคาร บี 1 ลุมพินีวิลล์ ถนนประชาอุทิศ",55,327,144,280,424
2002,"สามเสนนอก","เขตห้วยขวาง",101704,"ลานจอดรถ อาคาร บี 1 ลุมพินีวิลล์ ถนนประชาอุทิศ",56,319,151,277,428
2003,"สมเด็จเจ้าพระยา","เขตคลองสาน",101801,"เต็นท์หน้าสวนป่าฯ  เชิงสะพานพระปกเกล้า",1,128,176,224,400
2004,"สมเด็จเจ้าพระยา","เขตคลองสาน",101801,"เต็นท์หน้าสวนป่าฯ เชิงสะพานพระปกเกล้า",2,116,185,229,414
2005,"สมเด็จเจ้าพระยา","เขตคลองสาน",101801,"โรงเรียนบำรุงวิชา ซอยช่างนาค",3,119,200,229,429
2006,"สมเด็จเจ้าพระยา","เขตคลองสาน",101801,"โรงเรียนบำรุงวิชา ซอยช่างนาค",4,141,206,241,447
2007,"สมเด็จเจ้าพระยา","เขตคลองสาน",101801,"โรงเรียนบำรุงวิชา ซอยช่างนาค",5,184,296,338,634
2008,"สมเด็จเจ้าพระยา","เขตคลองสาน",101801,"โรงเรียนสตรีวุฑฒิศึกษา (เดิม) ซอยสมเด็จเจ้าพระยา 5",6,102,184,192,376
2009,"สมเด็จเจ้าพระยา","เขตคลองสาน",101801,"โรงเรียนสตรีวุฑฒิศึกษา  (เดิม) ซอยสมเด็จเจ้าพระยา 5",7,120,233,251,484
2010,"สมเด็จเจ้าพระยา","เขตคลองสาน",101801,"เต็นท์หน้าศาลเจ้าซำไนเก็ง  ถนนท่าดินแดง",8,126,165,221,386
2011,"สมเด็จเจ้าพระยา","เขตคลองสาน",101801,"เต็นท์หน้าศาลเจ้าซำไนเก็ง  ถนนท่าดินแดง",9,110,173,198,371
2012,"สมเด็จเจ้าพระยา","เขตคลองสาน",101801,"โรงเรียนวัดพิชัยญาติ",10,136,215,230,445
2013,"สมเด็จเจ้าพระยา","เขตคลองสาน",101801,"โรงรถ บริษัท บี.เอ็ล.ฮั้ว จำกัด  ซอยสมเด็จเจ้าพระยา 12",11,161,234,288,522
2014,"สมเด็จเจ้าพระยา","เขตคลองสาน",101801,"โรงรถ บริษัท บี.เอ็ล.ฮั้ว จำกัด  ซอยสมเด็จเจ้าพระยา 12",12,136,222,267,489
2015,"สมเด็จเจ้าพระยา","เขตคลองสาน",101801,"โรงรถ บริษัท บี.เอ็ล.ฮั้ว จำกัด  ซอยสมเด็จเจ้าพระยา 12",13,201,235,309,544
2016,"สมเด็จเจ้าพระยา","เขตคลองสาน",101801,"เต็นท์หน้าบ้านเลขที่ 73 - 81  ซอยท่าดินแดง 3",14,141,230,263,493
2017,"สมเด็จเจ้าพระยา","เขตคลองสาน",101801,"เต็นท์หน้าบ้านเลขที่ 73 - 81  ซอยท่าดินแดง 3",15,127,188,236,424
2018,"สมเด็จเจ้าพระยา","เขตคลองสาน",101801,"เต็นท์หน้าธนาคารอาคารสงเคราะห์ สาขาสี่แยกบ้านแขก ซอยอิสรภาพ 10",16,159,184,253,437
2019,"สมเด็จเจ้าพระยา","เขตคลองสาน",101801,"โรงเรียนพัฒนาวิทยา  ถนนอิสรภาพ",17,158,248,272,520
2020,"สมเด็จเจ้าพระยา","เขตคลองสาน",101801,"โรงเรียนพัฒนาวิทยา  ถนนอิสรภาพ",18,225,296,348,644
2021,"สมเด็จเจ้าพระยา","เขตคลองสาน",101801,"เต็นท์ปากซอยสารภี 2  ถนนประชาธิปก",19,127,149,197,346
2022,"สมเด็จเจ้าพระยา","เขตคลองสาน",101801,"เต็นท์ข้างห้างแพลตฟอร์ม  ถนนลาดหญ้า",20,142,173,225,398
2023,"สมเด็จเจ้าพระยา","เขตคลองสาน",101801,"เต็นท์หน้าชุมสายโทรศัพท์  ถนนลาดหญ้า",21,118,145,192,337
2024,"คลองสาน","เขตคลองสาน",101802,"โรงเรียนวัดทองธรรมชาติ",1,121,164,200,364
2025,"คลองสาน","เขตคลองสาน",101802,"โรงเรียนวัดทองธรรมชาติ",2,141,233,280,513
2026,"คลองสาน","เขตคลองสาน",101802,"เต็นท์หน้าโรงเรียนวัดทองธรรมชาติ",3,143,220,253,473
2027,"คลองสาน","เขตคลองสาน",101802,"เต็นท์หน้าโรงเรียนวัดทองธรรมชาติ",4,166,249,314,563
2028,"คลองสาน","เขตคลองสาน",101802,"เต็นท์หน้าโรงเรียนวัดทองธรรมชาติ",5,176,219,285,504
2029,"คลองสาน","เขตคลองสาน",101802,"เต็นท์หน้าโรงเรียนวัดทองธรรมชาติ",6,117,225,232,457
2030,"คลองสาน","เขตคลองสาน",101802,"เต็นท์หน้าโรงเรียนวัดทองธรรมชาติ",7,149,261,312,573
2031,"คลองสาน","เขตคลองสาน",101802,"เต็นท์ในวิทยาลัยสารพัดช่างธนบุรี  ถนนเชียงใหม่",8,108,185,195,380
2032,"คลองสาน","เขตคลองสาน",101802,"โรงเรียนวัดทองนพคุณ",9,217,231,445,676
2033,"คลองสาน","เขตคลองสาน",101802,"โรงเรียนวัดทองนพคุณ",10,118,215,250,465
2034,"คลองสาน","เขตคลองสาน",101802,"เต็นท์หน้าธนาคารทหารไทยธนชาต  สาขาลาดหญ้า",11,172,178,209,387
2035,"คลองสาน","เขตคลองสาน",101802,"โรงจอดรถสำนักการศึกษา",12,160,299,223,522
2036,"คลองสาน","เขตคลองสาน",101802,"โรงจอดรถสำนักการศึกษา",13,84,171,161,332
2037,"คลองสาน","เขตคลองสาน",101802,"เต็นท์บริเวณสามเหลี่ยมลาดหญ้า",14,175,228,280,508
2038,"คลองสาน","เขตคลองสาน",101802,"ที่จอดรถธนาคารไทยพาณิชย์  สาขาลาดหญ้า",15,199,244,300,544
2039,"คลองสาน","เขตคลองสาน",101802,"ที่จอดรถธนาคารไทยพาณิชย์  สาขาลาดหญ้า",16,168,234,254,488
2040,"คลองสาน","เขตคลองสาน",101802,"โถงใต้อาคารบริษัท เอี่ยมกิจ เทรดดิ้ง จำกัด ฝั่งซอยเจริญรัถ 3",17,157,217,283,500
2041,"คลองสาน","เขตคลองสาน",101802,"เต็นท์บริเวณลาดจอดรถโรงเรียนผดุงกิจวิทยา (เดิม)  ถนนเจริญรัถ",18,116,149,163,312
2042,"คลองสาน","เขตคลองสาน",101802,"ศูนย์เยาวชน (กระจ่างบริรักษ์นิติเกษตร)  ถนนสมเด็จเจ้าพระยา",19,97,154,166,320
2043,"คลองสาน","เขตคลองสาน",101802,"ศูนย์เยาวชน (กระจ่างบริรักษ์นิติเกษตร) ถนนสมเด็จเจ้าพระยา",20,101,157,192,349
2044,"บางลำภูล่าง","เขตคลองสาน",101803,"โรงเรียนอนุบาลศันสนีย์  ซอยเจริญนคร 23",1,148,150,181,331
2045,"บางลำภูล่าง","เขตคลองสาน",101803,"เต็นท์หน้าร้าน ส.สมบูรณ์ออกซิเจน (ข้างโรงเลื่อยเกษตร) ถนนเจริญนคร",2,143,137,218,355
2046,"บางลำภูล่าง","เขตคลองสาน",101803,"เต็นท์หน้าร้าน ส.สมบูรณ์ออกซิเจน (ข้างโรงเลื่อยเกษตร)ถนนเจริญนคร",3,100,169,179,348
2047,"บางลำภูล่าง","เขตคลองสาน",101803,"ห้องประชุมโรงเรียนวัดเศวตฉัตร",4,108,281,291,572
2048,"บางลำภูล่าง","เขตคลองสาน",101803,"ห้องประชุมโรงเรียนวัดเศวตฉัตร",5,114,165,213,378
2049,"บางลำภูล่าง","เขตคลองสาน",101803,"ที่จอดรถธนาคารกรุงศรีอยุธยา สาขาย่อยเจริญนคร ซอย 35",6,475,259,426,685
2050,"บางลำภูล่าง","เขตคลองสาน",101803,"ที่จอดรถธนาคารกรุงศรีอยุธยา สาขาย่อยเจริญนคร ซอย 35",7,155,184,264,448
2051,"บางลำภูล่าง","เขตคลองสาน",101803,"ที่จอดรถธนาคารกรุงศรีอยุธยา สาขาย่อยเจริญนคร ซอย 35",8,169,231,262,493
2052,"บางลำภูล่าง","เขตคลองสาน",101803,"ที่จอดรถธนาคารกรุงศรีอยุธยา สาขาย่อยเจริญนคร ซอย 35",9,190,234,313,547
2053,"บางลำภูล่าง","เขตคลองสาน",101803,"เต็นท์บริเวณลานเอนกประสงค์ในชุมชนหลังตลาดเจริญนคร ซอยเจริญนคร 55",10,81,213,222,435
2054,"บางลำภูล่าง","เขตคลองสาน",101803,"เต็นท์บริเวณลานเอนกประสงค์ในชุมชนหลังตลาดเจริญนคร ซอยเจริญนคร 55",11,91,163,219,382
2055,"บางลำภูล่าง","เขตคลองสาน",101803,"อาคารสมาคมตระกูลลิ้ม ซอยเจริญนคร 46",12,163,177,208,385
2056,"บางลำภูล่าง","เขตคลองสาน",101803,"อาคารสมาคมตระกูลลิ้ม ซอยเจริญนคร 46",13,148,210,287,497
2057,"บางลำภูล่าง","เขตคลองสาน",101803,"อาคารสมาคมตระกูลลิ้ม ซอยเจริญนคร 46",14,223,245,335,580
2058,"บางลำภูล่าง","เขตคลองสาน",101803,"อาคารสมาคมตระกูลลิ้ม ซอยเจริญนคร 46",15,169,238,302,540
2059,"บางลำภูล่าง","เขตคลองสาน",101803,"เต็นท์ลานจอดรถธนาคารไทยพาณิชย์  สาขาเจริญนคร",16,146,196,247,443
2060,"บางลำภูล่าง","เขตคลองสาน",101803,"เต็นท์ลานจอดรถธนาคารไทยพาณิชย์  สาขาเจริญนคร",17,176,227,248,475
2061,"บางลำภูล่าง","เขตคลองสาน",101803,"เต็นท์ลานจอดรถธนาคารไทยพาณิชย์  สาขาเจริญนคร",18,177,225,283,508
2062,"บางลำภูล่าง","เขตคลองสาน",101803,"เต็นท์ข้างโบสถ์บน (วัดเศวตฉัตร)",19,147,275,324,599
2063,"บางลำภูล่าง","เขตคลองสาน",101803,"เต็นท์ลานจอดรถ สำนักงานที่ดินกรุงเทพมหานคร สาขาธนบุรี(ซอยเจริญนคร 28)",20,194,242,332,574
2064,"บางลำภูล่าง","เขตคลองสาน",101803,"เต็นท์ลานจอดรถ สำนักงานที่ดินกรุงเทพมหานคร สาขาธนบุรี(ซอยเจริญนคร 28)",21,152,226,269,495
2065,"บางลำภูล่าง","เขตคลองสาน",101803,"เต็นท์ลานจอดรถในซอยเจริญนคร 30/2 (ซ้งโภชนา)",22,159,243,267,510
2066,"บางลำภูล่าง","เขตคลองสาน",101803,"เต็นท์ลานจอดรถในซอยเจริญนคร 30/2 (ซ้งโภชนา)",23,109,182,237,419
2067,"บางลำภูล่าง","เขตคลองสาน",101803,"เต็นท์บริเวณปากซอยเจริญนคร 32/1",24,311,285,399,684
2068,"บางลำภูล่าง","เขตคลองสาน",101803,"เต็นท์บริเวณปากซอยเจริญนคร 32/1",25,152,231,266,497
2069,"บางลำภูล่าง","เขตคลองสาน",101803,"ห้องประชุมโรงเรียนวัดสุทธาราม",26,155,281,336,617
2070,"บางลำภูล่าง","เขตคลองสาน",101803,"ห้องประชุมโรงเรียนวัดสุทธาราม",27,190,299,365,664
2071,"บางลำภูล่าง","เขตคลองสาน",101803,"ห้องประชุมโรงเรียนมัธยมวัดสุทธาราม (อาคารตากสินฯ)",28,183,271,319,590
2072,"บางลำภูล่าง","เขตคลองสาน",101803,"ห้องประชุมโรงเรียนมัธยมวัดสุทธาราม (อาคารตากสินฯ)",29,176,324,372,696
2073,"บางลำภูล่าง","เขตคลองสาน",101803,"โรงอาหารโรงเรียนมัธยมวัดสุทธาราม",30,222,289,401,690
2074,"บางลำภูล่าง","เขตคลองสาน",101803,"โรงอาหารโรงเรียนมัธยมวัดสุทธาราม",31,162,231,253,484
2075,"บางลำภูล่าง","เขตคลองสาน",101803,"เต็นท์ปากซอยกรุงธนบุรี 2",32,380,281,363,644
2076,"บางลำภูล่าง","เขตคลองสาน",101803,"เต็นท์ลานจอดรถบ้านวัฒนา  ซอยกรุงธนบุรี 6",33,466,367,524,891
2077,"บางลำภูล่าง","เขตคลองสาน",101803,"เต็นท์ลานจอดรถบ้านวัฒนา ซอยกรุงธนบุรี 6",34,221,299,365,664
2078,"บางลำภูล่าง","เขตคลองสาน",101803,"เต็นท์ลานจอดรถโรงเรียนอนุบาลเชาวน์ดี  ซอยกรุงธนบุรี 6",35,158,253,282,535
2079,"บางลำภูล่าง","เขตคลองสาน",101803,"เต็นท์ลานจอดรถโรงเรียนอนุบาลเชาวน์ดี  ซอยกรุงธนบุรี 6",36,160,244,240,484
2080,"คลองต้นไทร","เขตคลองสาน",101804,"ศาลเจ้าอาเหนียวเก่า ซอยสมเด็จพระเจ้าตากสิน 5",1,157,205,268,473
2081,"คลองต้นไทร","เขตคลองสาน",101804,"เต็นท์ลานจอดรถอาคารสาทร บิซิเนสปาร์ค สถานีรถไฟฟ้าวงเวียนใหญ่ฝั่งซอยกรุงธนบุรี 1",2,178,284,378,662
2082,"คลองต้นไทร","เขตคลองสาน",101804,"เต็นท์ลานจอดรถอาคารสาทร บิซิเนสปาร์ค สถานีรถไฟฟ้าวงเวียนใหญ่ฝั่งซอยกรุงธนบุรี 1",3,259,319,370,689
2083,"คลองต้นไทร","เขตคลองสาน",101804,"เต็นท์ลานจอดรถอาคารสาทร บิซิเนสปาร์ค สถานีรถไฟฟ้าวงเวียนใหญ่ฝั่งซอยกรุงธนบุรี 1",4,460,301,486,787
2084,"คลองต้นไทร","เขตคลองสาน",101804,"เต็นท์ลานจอดรถอาคารสาทร บิซิเนสปาร์ค สถานีรถไฟฟ้าวงเวียนใหญ่ฝั่งซอยกรุงธนบุรี 1",5,236,291,396,687
2085,"คลองต้นไทร","เขตคลองสาน",101804,"เต็นท์ลานจอดรถอาคารสาทร บิซิเนสปาร์ค สถานีรถไฟฟ้าวงเวียนใหญ่ฝั่งซอยกรุงธนบุรี 1",6,481,308,413,721
2086,"คลองต้นไทร","เขตคลองสาน",101804,"เต็นท์ลานกีฬาชุมชนซอยร่วมมิตร  ซอยเจริญรัถ 8",7,201,266,335,601
2087,"คลองต้นไทร","เขตคลองสาน",101804,"เต็นท์ลานกีฬาชุมชนซอยร่วมมิตร  ซอยเจริญรัถ 8",8,206,294,332,626
2088,"คลองต้นไทร","เขตคลองสาน",101804,"ห้องประชุมโรงเรียนวัดทองเพลง",9,160,209,269,478
2089,"คลองต้นไทร","เขตคลองสาน",101804,"ห้องประชุมโรงเรียนวัดทองเพลง",10,120,199,191,390
2090,"คลองต้นไทร","เขตคลองสาน",101804,"โรงอาหารโรงเรียนวัดทองเพลง",11,107,162,220,382
2091,"คลองต้นไทร","เขตคลองสาน",101804,"โรงอาหารโรงเรียนวัดทองเพลง",12,139,266,272,538
2092,"คลองต้นไทร","เขตคลองสาน",101804,"เต็นท์ลานจอดรถโรงเรียนนานาชาติอินเตอร์เนชั่นแนลไพโอเนียร์สซอยเจริญรัถ 14",13,116,184,209,393
2093,"คลองต้นไทร","เขตคลองสาน",101804,"เต็นท์ปากซอยกรุงธนบุรี 5  ถนนกรุงธนบุรี",14,258,320,415,735
2094,"คลองต้นไทร","เขตคลองสาน",101804,"เต็นท์ปากซอยกรุงธนบุรี 5  ถนนกรุงธนบุรี",15,425,244,366,610
2095,"คลองต้นไทร","เขตคลองสาน",101804,"เต็นท์ปากซอยกรุงธนบุรี 5  ถนนกรุงธนบุรี",16,450,235,394,629
2096,"คลองต้นไทร","เขตคลองสาน",101804,"เต็นท์ใต้สะพานสมเด็จพระเจ้าตากสิน (สาทร)",17,260,234,328,562
2097,"คลองต้นไทร","เขตคลองสาน",101804,"เต็นท์ใต้สะพานสมเด็จพระเจ้าตากสิน (สาทร)",18,416,244,310,554
2098,"คลองต้นไทร","เขตคลองสาน",101804,"ศาลาวัดสุวรรณ",19,159,233,257,490
2099,"คลองต้นไทร","เขตคลองสาน",101804,"ศาลาวัดสุวรรณ",20,169,248,277,525
2100,"คลองต้นไทร","เขตคลองสาน",101804,"ศาลาวัดสุวรรณ",21,207,253,328,581
2101,"คลองต้นไทร","เขตคลองสาน",101804,"โรงอาหารวิทยาลัยเทคโนโลยีมิตรพลบริหารธุรกิจ  ซอยเจริญรัถ 30",22,195,228,348,576
2102,"คลองต้นไทร","เขตคลองสาน",101804,"โรงอาหารวิทยาลัยเทคโนโลยีมิตรพลบริหารธุรกิจ  ซอยเจริญรัถ 30",23,155,234,289,523
2103,"คลองต้นไทร","เขตคลองสาน",101804,"โรงอาหารวิทยาลัยเทคโนโลยีมิตรพลบริหารธุรกิจ  ซอยเจริญรัถ 30",24,143,205,260,465
2104,"คลองต้นไทร","เขตคลองสาน",101804,"ห้องประชุมโรงเรียนวัดสุวรรณ",25,261,295,358,653
2105,"คลองต้นไทร","เขตคลองสาน",101804,"ห้องประชุมโรงเรียนวัดสุวรรณ",26,244,296,326,622
2106,"คลองต้นไทร","เขตคลองสาน",101804,"ห้องประชุมโรงเรียนวัดสุวรรณ",27,297,219,319,538
2107,"คลองชักพระ","เขตตลิ่งชัน",101901,"ศาลาการเปรียญวัดตลิ่งชัน",1,153,243,262,505
2108,"คลองชักพระ","เขตตลิ่งชัน",101901,"ศาลาการเปรียญวัดตลิ่งชัน",2,264,243,376,619
2109,"คลองชักพระ","เขตตลิ่งชัน",101901,"ศาลาการเปรียญวัดตลิ่งชัน",3,153,269,301,570
2110,"คลองชักพระ","เขตตลิ่งชัน",101901,"โรงเรียนวัดช่างเหล็ก",4,171,270,304,574
2111,"คลองชักพระ","เขตตลิ่งชัน",101901,"โรงเรียนวัดช่างเหล็ก",5,168,241,303,544
2112,"คลองชักพระ","เขตตลิ่งชัน",101901,"เต็นท์ข้างศาลาแดงในวัดรัชฎาธิษฐานราชวรวิหาร (วัดเงิน)",6,295,209,336,545
2113,"คลองชักพระ","เขตตลิ่งชัน",101901,"เต็นท์ข้างศาลาแดงในวัดรัชฎาธิษฐานราชวรวิหาร (วัดเงิน)",7,229,225,328,553
2114,"คลองชักพระ","เขตตลิ่งชัน",101901,"เต็นท์ข้างศาลาแดงในวัดรัชฎาธิษฐานราชวรวิหาร (วัดเงิน)",8,193,241,285,526
2115,"คลองชักพระ","เขตตลิ่งชัน",101901,"โรงเรียนวัดรัชฎาธิฐาน",9,130,258,290,548
2116,"คลองชักพระ","เขตตลิ่งชัน",101901,"โรงเรียนวัดรัชฎาธิฐาน",10,175,239,289,528
2117,"คลองชักพระ","เขตตลิ่งชัน",101901,"โรงเรียนวัดรัชฎาธิฐาน",11,187,213,280,493
2118,"คลองชักพระ","เขตตลิ่งชัน",101901,"โรงเรียนวัดรัชฎาธิฐาน",12,179,228,272,500
2119,"คลองชักพระ","เขตตลิ่งชัน",101901,"โรงเรียนวัดปากน้ำฝั่งเหนือ",13,255,203,271,474
2120,"คลองชักพระ","เขตตลิ่งชัน",101901,"โรงเรียนวัดปากน้ำฝั่งเหนือ",14,122,202,209,411
2121,"คลองชักพระ","เขตตลิ่งชัน",101901,"เต็นท์หน้าร้านดวงเดือน",15,149,197,250,447
2122,"ตลิ่งชัน","เขตตลิ่งชัน",101902,"เต็นท์บริเวณวัดนครป่าหมาก (ถนนชัยพฤกษ์)",1,168,235,292,527
2123,"ตลิ่งชัน","เขตตลิ่งชัน",101902,"เต็นท์บริเวณวัดนครป่าหมาก (ถนนชัยพฤกษ์)",2,148,253,259,512
2124,"ตลิ่งชัน","เขตตลิ่งชัน",101902,"เต็นท์บริเวณวัดนครป่าหมาก (ถนนชัยพฤกษ์)",3,150,225,249,474
2125,"ตลิ่งชัน","เขตตลิ่งชัน",101902,"เต็นท์บริเวณวัดนครป่าหมาก (ถนนชัยพฤกษ์)",4,153,228,290,518
2126,"ตลิ่งชัน","เขตตลิ่งชัน",101902,"โรงเรียนวัดไก่เตี้ย",5,331,261,379,640
2127,"ตลิ่งชัน","เขตตลิ่งชัน",101902,"โรงเรียนวัดไก่เตี้ย",6,447,274,405,679
2128,"ตลิ่งชัน","เขตตลิ่งชัน",101902,"เต็นท์ด้านข้าง 7 - ELEVEN สาขาชัยพฤกษ์ ซอย 9",7,217,235,321,556
2129,"ตลิ่งชัน","เขตตลิ่งชัน",101902,"เต็นท์ด้านข้าง 7 - ELEVEN สาขาชัยพฤกษ์ ซอย 9",8,167,238,291,529
2130,"ตลิ่งชัน","เขตตลิ่งชัน",101902,"เต็นท์ด้านข้าง 7 - ELEVEN สาขาชัยพฤกษ์ ซอย 9",9,194,248,308,556
2131,"ตลิ่งชัน","เขตตลิ่งชัน",101902,"โรงเรียนวัดชัยพฤกษมาลา",10,149,251,296,547
2132,"ตลิ่งชัน","เขตตลิ่งชัน",101902,"โรงเรียนวัดชัยพฤกษมาลา",11,210,255,308,563
2133,"ตลิ่งชัน","เขตตลิ่งชัน",101902,"โรงเรียนวัดชัยพฤกษมาลา",12,160,259,299,558
2134,"ตลิ่งชัน","เขตตลิ่งชัน",101902,"โรงเรียนวัดชัยพฤกษมาลา",13,185,277,294,571
2135,"ตลิ่งชัน","เขตตลิ่งชัน",101902,"โรงเรียนวัดชัยพฤกษมาลา",14,187,277,322,599
2136,"ตลิ่งชัน","เขตตลิ่งชัน",101902,"เต็นท์ในโรงเรียนวัดชัยพฤกษมาลา",15,187,262,318,580
2137,"ตลิ่งชัน","เขตตลิ่งชัน",101902,"โรงเรียนวรรัตน์ศึกษา",16,161,238,307,545
2138,"ตลิ่งชัน","เขตตลิ่งชัน",101902,"โรงเรียนวรรัตน์ศึกษา",17,160,268,253,521
2139,"ตลิ่งชัน","เขตตลิ่งชัน",101902,"เต็นท์บริเวณลานจอดรถสำนักงานขนส่งกรุงเทพมหานคร พื้นที่ 2 (ซอยสวนผัก 4)",18,151,257,320,577
2140,"ตลิ่งชัน","เขตตลิ่งชัน",101902,"เต็นท์บริเวณลานจอดรถสำนักงานขนส่งกรุงเทพมหานคร พื้นที่ 2 (ซอยสวนผัก 4)",19,131,252,288,540
2141,"ตลิ่งชัน","เขตตลิ่งชัน",101902,"เต็นท์บริเวณลานจอดรถสำนักงานขนส่งกรุงเทพมหานคร พื้นที่ 2 (ซอยสวนผัก 4)",20,197,267,288,555
2142,"ตลิ่งชัน","เขตตลิ่งชัน",101902,"โรงเรียนวัดตลิ่งชัน",21,188,224,282,506
2143,"ตลิ่งชัน","เขตตลิ่งชัน",101902,"โรงเรียนวัดตลิ่งชัน",22,178,241,288,529
2144,"ตลิ่งชัน","เขตตลิ่งชัน",101902,"โรงเรียนวัดตลิ่งชัน",23,220,221,289,510
2145,"ตลิ่งชัน","เขตตลิ่งชัน",101902,"โรงเรียนวัดตลิ่งชัน",24,122,223,246,469
2146,"ตลิ่งชัน","เขตตลิ่งชัน",101902,"โรงเรียนวัดตลิ่งชัน",25,147,268,313,581
2147,"ตลิ่งชัน","เขตตลิ่งชัน",101902,"หอประชุมมูลนิธิร่วมใจธรรม (ซอยสวนผัก 19)",26,217,236,298,534
2148,"ตลิ่งชัน","เขตตลิ่งชัน",101902,"หอประชุมมูลนิธิร่วมใจธรรม (ซอยสวนผัก 19)",27,204,266,354,620
2149,"ตลิ่งชัน","เขตตลิ่งชัน",101902,"หอประชุมมูลนิธิร่วมใจธรรม (ซอยสวนผัก 19)",28,163,270,315,585
2150,"ตลิ่งชัน","เขตตลิ่งชัน",101902,"หอประชุมมูลนิธิร่วมใจธรรม (ซอยสวนผัก 19)",29,185,254,329,583
2151,"ตลิ่งชัน","เขตตลิ่งชัน",101902,"หอประชุมมูลนิธิร่วมใจธรรม (ซอยสวนผัก 19)",30,228,247,334,581
2152,"ตลิ่งชัน","เขตตลิ่งชัน",101902,"หอประชุมมูลนิธิร่วมใจธรรม (ซอยสวนผัก 19)",31,184,263,287,550
2153,"ตลิ่งชัน","เขตตลิ่งชัน",101902,"โรงเรียนชุมทางตลิ่งชัน",32,171,276,318,594
2154,"ตลิ่งชัน","เขตตลิ่งชัน",101902,"โรงเรียนชุมทางตลิ่งชัน",33,176,296,322,618
2155,"ตลิ่งชัน","เขตตลิ่งชัน",101902,"เต็นท์สถานีบริการน้ำมันบางจากราชพฤกษ์-สวนผัก (ซอยราชพฤกษ์19)",34,224,211,265,476
2156,"ตลิ่งชัน","เขตตลิ่งชัน",101902,"เต็นท์สถานีบริการน้ำมันบางจากราชพฤกษ์-สวนผัก (ซอยราชพฤกษ์19)",35,202,201,250,451
2157,"ตลิ่งชัน","เขตตลิ่งชัน",101902,"เต็นท์ที่จอดรถรุ่งเจริญเมทัลชีท (ซอยราชพฤกษ์ 26)",36,163,205,253,458
2158,"ตลิ่งชัน","เขตตลิ่งชัน",101902,"เต็นท์ที่จอดรถรุ่งเจริญเมทัลชีท (ซอยราชพฤกษ์ 26)",37,166,196,247,443
2159,"ฉิมพลี","เขตตลิ่งชัน",101903,"ศาลาเฉลิมพระเกียรติวัดมณฑป",1,161,203,297,500
2160,"ฉิมพลี","เขตตลิ่งชัน",101903,"ศาลาเฉลิมพระเกียรติวัดมณฑป",2,121,214,275,489
2161,"ฉิมพลี","เขตตลิ่งชัน",101903,"ศาลาเฉลิมพระเกียรติวัดมณฑป",3,138,233,279,512
2162,"ฉิมพลี","เขตตลิ่งชัน",101903,"โรงเรียนมหรรณพาราม",4,234,316,269,585
2163,"ฉิมพลี","เขตตลิ่งชัน",101903,"โรงเรียนมหรรณพาราม",5,183,258,292,550
2164,"ฉิมพลี","เขตตลิ่งชัน",101903,"โรงเรียนมหรรณพาราม",6,187,257,300,557
2165,"ฉิมพลี","เขตตลิ่งชัน",101903,"อาคารหอพักรัชดาภิเษก ซอยบรมราชชนนี 46 (ซอยฉิมพลี 11)",7,191,276,342,618
2166,"ฉิมพลี","เขตตลิ่งชัน",101903,"อาคารหอพักรัชดาภิเษก ซอยบรมราชชนนี 46 (ซอยฉิมพลี 11)",8,219,270,331,601
2167,"ฉิมพลี","เขตตลิ่งชัน",101903,"เต็นท์ลานจอดรถพรมลิขิต แบดมินตัน (ถนนบรมราชชนนี)",9,236,251,346,597
2168,"ฉิมพลี","เขตตลิ่งชัน",101903,"เต็นท์ลานจอดรถพรมลิขิต แบดมินตัน (ถนนบรมราชชนนี)",10,188,270,320,590
2169,"ฉิมพลี","เขตตลิ่งชัน",101903,"โรงรับส่งพัสดุภัณฑ์ที่ทำการไปรษณีย์ตลิ่งชัน (ถนนบรมราชชนนี)",11,210,275,289,564
2170,"ฉิมพลี","เขตตลิ่งชัน",101903,"โรงรับส่งพัสดุภัณฑ์ที่ทำการไปรษณีย์ตลิ่งชัน (ถนนบรมราชชนนี)",12,208,246,297,543
2171,"ฉิมพลี","เขตตลิ่งชัน",101903,"เต็นท์บริเวณที่ทำการไปรษณีย์ตลิ่งชัน (ถนนบรมราชชนนี)",13,150,234,241,475
2172,"ฉิมพลี","เขตตลิ่งชัน",101903,"เต็นท์ลานจอดรถโรงรับจำนำอีซี่มันนี่ (ถนนบรมราชชนนี)",14,199,211,295,506
2173,"ฉิมพลี","เขตตลิ่งชัน",101903,"เต็นท์ลานจอดรถโรงรับจำนำอีซี่มันนี่ (ถนนบรมราชชนนี)",15,193,228,275,503
2174,"ฉิมพลี","เขตตลิ่งชัน",101903,"เต็นท์ลานจอดรถโรงรับจำนำอีซี่มันนี่ (ถนนบรมราชชนนี)",16,161,219,281,500
2175,"ฉิมพลี","เขตตลิ่งชัน",101903,"เต็นท์บริเวณปากซอยหมู่บ้านเมืองเพชร วิลเลจ 4 (ซอยทุ่งมังกร 10) ติดร้าน J&T",17,163,209,251,460
2176,"ฉิมพลี","เขตตลิ่งชัน",101903,"เต็นท์บริเวณที่จอดรถร้านครัวท่าเรือ สาขาทุ่งมังกร",18,160,197,243,440
2177,"ฉิมพลี","เขตตลิ่งชัน",101903,"เต็นท์ตลาดนัดสะพานคลองบัว (ถนนสวนผัก)",19,263,276,359,635
2178,"ฉิมพลี","เขตตลิ่งชัน",101903,"เต็นท์ตลาดนัดสะพานคลองบัว (ถนนสวนผัก)",20,234,294,325,619
2179,"ฉิมพลี","เขตตลิ่งชัน",101903,"เต็นท์ตลาดนัดสะพานคลองบัว (ถนนสวนผัก)",21,194,291,323,614
2180,"ฉิมพลี","เขตตลิ่งชัน",101903,"เต็นท์ตลาดนัดสะพานคลองบัว (ถนนสวนผัก)",22,217,254,371,625
2181,"ฉิมพลี","เขตตลิ่งชัน",101903,"เต็นท์ตลาดนัดสะพานคลองบัว (ถนนสวนผัก)",23,210,277,316,593
2182,"ฉิมพลี","เขตตลิ่งชัน",101903,"เต็นท์ลานกีฬาหมู่บ้าน 2521 โครงการ 2",24,236,276,341,617
2183,"ฉิมพลี","เขตตลิ่งชัน",101903,"โรงเรียนฉิมพลี",25,229,301,328,629
2184,"ฉิมพลี","เขตตลิ่งชัน",101903,"โรงเรียนฉิมพลี",26,208,251,331,582
2185,"ฉิมพลี","เขตตลิ่งชัน",101903,"โรงเรียนฉิมพลี",27,226,295,380,675
2186,"ฉิมพลี","เขตตลิ่งชัน",101903,"โรงเรียนฉิมพลี",28,243,265,373,638
2187,"ฉิมพลี","เขตตลิ่งชัน",101903,"โรงเรียนฉิมพลี",29,226,284,348,632
2188,"ฉิมพลี","เขตตลิ่งชัน",101903,"เต็นท์หน้าอาคารสมาคมสันนิบาตเทศบาล แห่งประเทศไทย (ถนนบรมราชชนนี)",30,266,303,365,668
2189,"ฉิมพลี","เขตตลิ่งชัน",101903,"เต็นท์หน้าอาคารสมาคมสันนิบาตเทศบาล แห่งประเทศไทย (ถนนบรมราชชนนี)",31,210,260,307,567
2190,"ฉิมพลี","เขตตลิ่งชัน",101903,"เต็นท์บริเวณศูนย์การเรียนรู้พิเศษประภาคารปัญญา(ถนนบรมราชชนนี)",32,172,285,349,634
2191,"ฉิมพลี","เขตตลิ่งชัน",101903,"เต็นท์บริเวณศูนย์การเรียนรู้พิเศษประภาคารปัญญา(ถนนบรมราชชนนี)",33,207,281,320,601
2192,"ฉิมพลี","เขตตลิ่งชัน",101903,"โรงเรียนวัดทอง (อุดมศิลปวิทยาคาร)",34,148,214,253,467
2193,"ฉิมพลี","เขตตลิ่งชัน",101903,"โรงเรียนวัดทอง (อุดมศิลปวิทยาคาร)",35,145,222,295,517
2194,"บางพรม","เขตตลิ่งชัน",101904,"โรงเรียนอุบลรัตนราชกัญญาราชวิทยาลัย กรุงเทพมหานคร",1,157,262,299,561
2195,"บางพรม","เขตตลิ่งชัน",101904,"โรงเรียนอุบลรัตนราชกัญญาราชวิทยาลัย กรุงเทพมหานคร",2,195,288,316,604
2196,"บางพรม","เขตตลิ่งชัน",101904,"โรงเรียนอุบลรัตนราชกัญญาราชวิทยาลัย กรุงเทพมหานคร",3,229,279,324,603
2197,"บางพรม","เขตตลิ่งชัน",101904,"โรงเรียนอุบลรัตนราชกัญญาราชวิทยาลัย กรุงเทพมหานคร",4,172,277,281,558
2198,"บางพรม","เขตตลิ่งชัน",101904,"โรงเรียนอุบลรัตนราชกัญญาราชวิทยาลัย กรุงเทพมหานคร",5,152,263,285,548
2199,"บางพรม","เขตตลิ่งชัน",101904,"เต็นท์บริเวณวัดศิริวัฒนาราม",6,230,353,380,733
2200,"บางพรม","เขตตลิ่งชัน",101904,"โรงเรียนอยู่เย็นวิทยา",7,150,209,245,454
2201,"บางพรม","เขตตลิ่งชัน",101904,"โรงเรียนวัดกระโจมทอง",8,226,288,333,621
2202,"บางพรม","เขตตลิ่งชัน",101904,"ศาลาวัดสะพาน",9,194,240,304,544
2203,"บางพรม","เขตตลิ่งชัน",101904,"ศาลาวัดแก้ว",10,167,221,274,495
2204,"บางพรม","เขตตลิ่งชัน",101904,"ศาลาวัดแก้ว",11,132,191,237,428
2205,"บางพรม","เขตตลิ่งชัน",101904,"ศาลาวัดแก้ว",12,180,233,314,547
2206,"บางพรม","เขตตลิ่งชัน",101904,"เต็นท์บริเวณลานกีฬาชุมชนหลังวัดรัชฎาธิษฐาน (วัดเงิน)",13,158,268,326,594
2207,"บางพรม","เขตตลิ่งชัน",101904,"โรงเรียนวัดประสาท",14,180,267,270,537
2208,"บางพรม","เขตตลิ่งชัน",101904,"โรงเรียนวัดประสาท",15,181,278,306,584
2209,"บางพรม","เขตตลิ่งชัน",101904,"โรงเรียนวัดประสาท",16,186,247,321,568
2210,"บางพรม","เขตตลิ่งชัน",101904,"โรงเรียนวัดประสาท",17,191,251,289,540
2211,"บางพรม","เขตตลิ่งชัน",101904,"ศาลาวัดเพลงกลางสวน",18,156,233,271,504
2212,"บางพรม","เขตตลิ่งชัน",101904,"ศาลาวัดเพลงกลางสวน",19,146,227,277,504
2213,"บางพรม","เขตตลิ่งชัน",101904,"ศาลาวัดเทพพล",20,197,252,324,576
2214,"บางระมาด","เขตตลิ่งชัน",101905,"โรงเรียนวัดโพธิ์",1,186,250,292,542
2215,"บางระมาด","เขตตลิ่งชัน",101905,"โรงเรียนวัดโพธิ์",2,180,272,270,542
2216,"บางระมาด","เขตตลิ่งชัน",101905,"โรงเรียนวัดโพธิ์",3,189,248,298,546
2217,"บางระมาด","เขตตลิ่งชัน",101905,"โรงเรียนวัดโพธิ์",4,201,288,313,601
2218,"บางระมาด","เขตตลิ่งชัน",101905,"โรงเรียนวัดโพธิ์",5,191,264,334,598
2219,"บางระมาด","เขตตลิ่งชัน",101905,"วัดโพธิ์",6,239,257,338,595
2220,"บางระมาด","เขตตลิ่งชัน",101905,"วัดโพธิ์",7,237,257,317,574
2221,"บางระมาด","เขตตลิ่งชัน",101905,"วัดโพธิ์",8,207,257,299,556
2222,"บางระมาด","เขตตลิ่งชัน",101905,"วัดโพธิ์",9,201,250,308,558
2223,"บางระมาด","เขตตลิ่งชัน",101905,"เต็นท์บริษัทรักษาความปลอดภัยไทยซีคอม จำกัด",10,292,275,397,672
2224,"บางระมาด","เขตตลิ่งชัน",101905,"เต็นท์บริษัทรักษาความปลอดภัยไทยซีคอม จำกัด",11,300,331,371,702
2225,"บางระมาด","เขตตลิ่งชัน",101905,"ศาลาวัดจำปา",12,200,352,404,756
2226,"บางระมาด","เขตตลิ่งชัน",101905,"เต็นท์บริเวณด้านหน้าบริษัท ยูไนเต็ด ฮอนด้า ออโตโมบิล จำกัด(ถนนราชพฤกษ์)",13,285,278,333,611
2227,"บางระมาด","เขตตลิ่งชัน",101905,"เต็นท์บริเวณด้านหน้าบริษัท ยูไนเต็ด ฮอนด้า ออโตโมบิล จำกัด(ถนนราชพฤกษ์)",14,313,276,329,605
2228,"บางระมาด","เขตตลิ่งชัน",101905,"โรงเรียนวัดมะกอก",15,172,251,236,487
2229,"บางระมาด","เขตตลิ่งชัน",101905,"โรงเรียนวัดมะกอก",16,137,234,277,511
2230,"บางระมาด","เขตตลิ่งชัน",101905,"โรงเรียนวัดมะกอก",17,119,212,213,425
2231,"บางระมาด","เขตตลิ่งชัน",101905,"เต็นท์บริเวณปากซอยแก้วเงินทอง 34 (ถนนแก้วเงินทอง)",18,192,286,318,604
2232,"บางระมาด","เขตตลิ่งชัน",101905,"อาคารเรียนพระปริยัติธรรม วัดกาญจนสิงหาสน์",19,181,279,330,609
2233,"บางระมาด","เขตตลิ่งชัน",101905,"อาคารเรียนพระปริยัติธรรม วัดกาญจนสิงหาสน์",20,169,302,353,655
2234,"บางระมาด","เขตตลิ่งชัน",101905,"อาคารเรียนพระปริยัติธรรม วัดกาญจนสิงหาสน์",21,236,291,359,650
2235,"บางระมาด","เขตตลิ่งชัน",101905,"โรงเรียนวัดอินทราวาส",22,187,243,295,538
2236,"บางระมาด","เขตตลิ่งชัน",101905,"โรงเรียนวัดอินทราวาส",23,186,238,263,501
2237,"บางระมาด","เขตตลิ่งชัน",101905,"โรงเรียนวัดอินทราวาส",24,210,250,317,567
2238,"บางระมาด","เขตตลิ่งชัน",101905,"วัดอินทราวาส",25,258,321,354,675
2239,"บางระมาด","เขตตลิ่งชัน",101905,"วัดอินทราวาส",26,173,276,297,573
2240,"บางระมาด","เขตตลิ่งชัน",101905,"เต็นท์บริเวณโครงการเชิงสะพาน (จุดกลับรถคลองบางระมาด ถนนราชพฤกษ์)",27,265,235,308,543
2241,"บางระมาด","เขตตลิ่งชัน",101905,"เต็นท์บริเวณโครงการเชิงสะพาน (จุดกลับรถคลองบางระมาด ถนนราชพฤกษ์)",28,223,250,311,561
2242,"บางเชือกหนัง","เขตตลิ่งชัน",101907,"โรงเรียนอนุบาลนกน้อย",1,167,210,246,456
2243,"บางเชือกหนัง","เขตตลิ่งชัน",101907,"เต็นท์ในซอยบางเชือกหนัง 13",2,120,219,225,444
2244,"บางเชือกหนัง","เขตตลิ่งชัน",101907,"เต็นท์ในซอยบางเชือกหนัง 13",3,175,230,262,492
2245,"บางเชือกหนัง","เขตตลิ่งชัน",101907,"เต็นท์ลานจอดรถซอยเงินอุดม (ซอยบางเชือกหนัง 9/ซอยศิริวัฒนา)",4,210,212,298,510
2246,"บางเชือกหนัง","เขตตลิ่งชัน",101907,"เต็นท์ลานจอดรถซอยเงินอุดม (ซอยบางเชือกหนัง 9/ซอยศิริวัฒนา)",5,145,225,258,483
2247,"บางเชือกหนัง","เขตตลิ่งชัน",101907,"โรงเรียนวัดพิกุล",6,222,279,320,599
2248,"บางเชือกหนัง","เขตตลิ่งชัน",101907,"โรงเรียนวัดพิกุล",7,130,251,267,518
2249,"บางเชือกหนัง","เขตตลิ่งชัน",101907,"เต็นท์ในหมู่บ้านอิ่มอัมพร 2",8,198,252,315,567
2250,"บางเชือกหนัง","เขตตลิ่งชัน",101907,"เต็นท์ในหมู่บ้านอิ่มอัมพร 2",9,201,241,335,576
2251,"บางเชือกหนัง","เขตตลิ่งชัน",101907,"เต็นท์ในหมู่บ้านอิ่มอัมพร 2",10,229,265,325,590
2252,"บางเชือกหนัง","เขตตลิ่งชัน",101907,"เต็นท์ในหมู่บ้านอิ่มอัมพร 2",11,248,273,352,625
2253,"บางเชือกหนัง","เขตตลิ่งชัน",101907,"เต็นท์ในหมู่บ้านอิ่มอัมพร 2",12,186,238,330,568
2254,"บางเชือกหนัง","เขตตลิ่งชัน",101907,"เต็นท์ในหมู่บ้านอิ่มอัมพร 2",13,211,247,305,552
2255,"บางเชือกหนัง","เขตตลิ่งชัน",101907,"เต็นท์ในหมู่บ้านอิ่มอัมพร 2",14,247,266,336,602
2256,"บางเชือกหนัง","เขตตลิ่งชัน",101907,"ศาลาวัดทองบางเชือกหนัง (ซอยราชพฤกษ์ 8)",15,264,351,417,768
2257,"บางเชือกหนัง","เขตตลิ่งชัน",101907,"ศาลาวัดทองบางเชือกหนัง (ซอยราชพฤกษ์ 8)",16,239,340,382,722
2258,"บางเชือกหนัง","เขตตลิ่งชัน",101907,"โรงเรียนวัดเกาะ",17,156,274,323,597
2259,"ศิริราช","เขตบางกอกน้อย",102004,"โรงเรียนโฆสิตสโมสร ซอยวัดระฆัง ถนนอรุณอมรินทร์",1,27,432,74,506
2260,"ศิริราช","เขตบางกอกน้อย",102004,"โรงเรียนโฆสิตสโมสร ซอยวัดระฆัง ถนนอรุณอมรินทร์",2,171,246,285,531
2261,"ศิริราช","เขตบางกอกน้อย",102004,"โรงเรียนโฆสิตสโมสร ซอยวัดระฆัง ถนนอรุณอมรินทร์",3,139,233,273,506
2262,"ศิริราช","เขตบางกอกน้อย",102004,"โรงเรียนโฆสิตสโมสร ซอยวัดระฆัง ถนนอรุณอมรินทร์",4,124,227,288,515
2263,"ศิริราช","เขตบางกอกน้อย",102004,"โรงเรียนสตรีวัดระฆัง ซอยวัดระฆัง ถนนอรุณอมรินทร์",5,195,288,342,630
2264,"ศิริราช","เขตบางกอกน้อย",102004,"เต็นท์โรงเรียนสตรีวัดระฆัง ซอยวัดระฆัง ถนนอรุณอมรินทร์",6,193,258,356,614
2265,"ศิริราช","เขตบางกอกน้อย",102004,"โรงเรียนวัดสุวรรณาราม ซอยจรัญสนิทวงศ์ 32",7,117,261,258,519
2266,"ศิริราช","เขตบางกอกน้อย",102004,"โรงเรียนวัดสุวรรณาราม ซอยจรัญสนิทวงศ์ 32",8,105,244,269,513
2267,"ศิริราช","เขตบางกอกน้อย",102004,"โรงเรียนวัดสุวรรณาราม ซอยจรัญสนิทวงศ์ 32",9,118,256,249,505
2268,"ศิริราช","เขตบางกอกน้อย",102004,"โรงเรียนวัดสุวรรณาราม ซอยจรัญสนิทวงศ์ 32",10,105,231,257,488
2269,"ศิริราช","เขตบางกอกน้อย",102004,"โรงเรียนสุวรรณารามวิทยาคม ซอยจรัญสนิทวงศ์ 32",11,200,313,377,690
2270,"ศิริราช","เขตบางกอกน้อย",102004,"โรงเรียนสุวรรณารามวิทยาคม ซอยจรัญสนิทวงศ์ 32",12,156,345,344,689
2271,"ศิริราช","เขตบางกอกน้อย",102004,"โรงเรียนวัดวิเศษการ ซอยวัดวิเศษการ ถนนวังหลัง",13,172,250,273,523
2272,"ศิริราช","เขตบางกอกน้อย",102004,"โรงเรียนวัดวิเศษการ ซอยวัดวิเศษการ ถนนวังหลัง",14,168,244,289,533
2273,"ศิริราช","เขตบางกอกน้อย",102004,"โรงเรียนวัดวิเศษการ ซอยวัดวิเศษการ ถนนวังหลัง",15,154,237,302,539
2274,"ศิริราช","เขตบางกอกน้อย",102004,"ศาลาวัดฉิมทายกาวาส ถนนรถไฟ",16,177,311,232,543
2275,"ศิริราช","เขตบางกอกน้อย",102004,"เต็นท์บริเวณหน้าบ้านเลขที่ 488 ถนนอิสรภาพ",17,110,205,233,438
2276,"บ้านช่างหล่อ","เขตบางกอกน้อย",102005,"โรงเรียนชิโนรสวิทยาลัย ถนนอิสรภาพ",1,240,334,328,662
2277,"บ้านช่างหล่อ","เขตบางกอกน้อย",102005,"โรงเรียนชิโนรสวิทยาลัย ถนนอิสรภาพ",2,74,526,115,641
2278,"บ้านช่างหล่อ","เขตบางกอกน้อย",102005,"ศาลาวัดครุฑ ซอยอิสรภาพ 35 ถนนอิสรภาพ",3,191,313,352,665
2279,"บ้านช่างหล่อ","เขตบางกอกน้อย",102005,"ศาลาแดง ซอยบ้านช่างหล่อ ถนนวังหลัง",4,210,318,393,711
2280,"บ้านช่างหล่อ","เขตบางกอกน้อย",102005,"เต็นท์ศาลาแดง ซอยบ้านช่างหล่อ ถนนวังหลัง",5,211,301,393,694
2281,"บ้านช่างหล่อ","เขตบางกอกน้อย",102005,"เต็นท์บริเวณลานจอดรถ สำนักงานคุมประพฤติ ถนนวังหลัง",6,268,325,426,751
2282,"บ้านช่างหล่อ","เขตบางกอกน้อย",102005,"โรงเรียนวัดพระยาทำ ซอยวัดพระยาทำ ถนนอรุณอมรินทร์",7,141,233,278,511
2283,"บ้านช่างหล่อ","เขตบางกอกน้อย",102005,"โรงเรียนวัดอัมพวา ซอยจรัญสนิทวงศ์ 22 ถนนจรัญสนิทวงศ์",8,200,316,384,700
2284,"บ้านช่างหล่อ","เขตบางกอกน้อย",102005,"โรงเรียนวัดอัมพวา ซอยจรัญสนิทวงศ์ 22 ถนนจรัญสนิทวงศ์",9,154,308,390,698
2285,"บ้านช่างหล่อ","เขตบางกอกน้อย",102005,"โรงเรียนวัดอัมพวา ซอยจรัญสนิทวงศ์ 22 ถนนจรัญสนิทวงศ์",10,199,298,393,691
2286,"บ้านช่างหล่อ","เขตบางกอกน้อย",102005,"โรงเรียนวัดอัมพวา ซอยจรัญสนิทวงศ์ 22 ถนนจรัญสนิทวงศ์",11,236,313,370,683
2287,"บ้านช่างหล่อ","เขตบางกอกน้อย",102005,"ศูนย์เยาวชนวัดอัมพวา ซอยจรัญสนิทวงศ์ 22",12,183,327,416,743
2288,"บ้านช่างหล่อ","เขตบางกอกน้อย",102005,"โรงเรียนสวนอนันต์ ซอยอิสรภาพ 39 ถนนอิสรภาพ",13,219,328,383,711
2289,"บ้านช่างหล่อ","เขตบางกอกน้อย",102005,"โรงเรียนวัดดงมูลเหล็ก ซอยอิสรภาพ 39 ถนนอิสรภาพ",14,196,322,389,711
2290,"บ้านช่างหล่อ","เขตบางกอกน้อย",102005,"โรงเรียนวัดดงมูลเหล็ก ซอยอิสรภาพ 39 ถนนอิสรภาพ",15,175,314,396,710
2291,"บ้านช่างหล่อ","เขตบางกอกน้อย",102005,"ศาลาวัดยางสุทธาราม ซอยวัดยางสุทธาราม ถนนพรานนก",16,219,359,430,789
2292,"บ้านช่างหล่อ","เขตบางกอกน้อย",102005,"โรงเรียนวัดยางสุทธาราม ซอยวัดยางสุทธาราม ถนนพรานนก",17,195,285,346,631
2293,"บ้านช่างหล่อ","เขตบางกอกน้อย",102005,"โรงเรียนวัดยางสุทธาราม ซอยวัดยางสุทธาราม ถนนพรานนก",18,214,316,335,651
2294,"บ้านช่างหล่อ","เขตบางกอกน้อย",102005,"โรงเรียนวัดยางสุทธาราม ซอยวัดยางสุทธาราม ถนนพรานนก",19,201,309,343,652
2295,"บ้านช่างหล่อ","เขตบางกอกน้อย",102005,"โรงเรียนวัดยางสุทธาราม ซอยวัดยางสุทธาราม ถนนพรานนก",20,190,301,353,654
2296,"บ้านช่างหล่อ","เขตบางกอกน้อย",102005,"โรงเรียนวัดยางสุทธาราม ซอยวัดยางสุทธาราม ถนนพรานนก",21,192,310,355,665
2297,"บ้านช่างหล่อ","เขตบางกอกน้อย",102005,"เต็นท์หน้าธนาคารกรุงไทย สาขาพรานนก",22,151,262,304,566
2298,"บ้านช่างหล่อ","เขตบางกอกน้อย",102005,"ที่จอดรถใต้อาคารที่ทำการไปรษณีย์บางกอกน้อย ถนนพรานนก",23,218,365,431,796
2299,"บ้านช่างหล่อ","เขตบางกอกน้อย",102005,"ที่จอดรถใต้อาคารที่ทำการไปรษณีย์บางกอกน้อย ถนนพรานนก",24,333,339,461,800
2300,"บ้านช่างหล่อ","เขตบางกอกน้อย",102005,"เต็นท์หน้าอาคารชุด ดีบุรา พรานนก ถนนอิสรภาพ",25,189,309,348,657
2301,"บ้านช่างหล่อ","เขตบางกอกน้อย",102005,"ศูนย์ฝึกอาชีพกรุงเทพมหานครวัดสุทธาวาส ถนนสุทธาวาส",26,155,321,331,652
2302,"บ้านช่างหล่อ","เขตบางกอกน้อย",102005,"ศูนย์ฝึกอาชีพกรุงเทพมหานครวัดสุทธาวาส ถนนสุทธาวาส",27,186,309,357,666
2303,"บ้านช่างหล่อ","เขตบางกอกน้อย",102005,"ศูนย์ฝึกอาชีพกรุงเทพมหานครวัดสุทธาวาส ถนนสุทธาวาส",28,144,309,339,648
2304,"บ้านช่างหล่อ","เขตบางกอกน้อย",102005,"โรงเรียนวัดโพธิ์เรียง ซอยจรัญสนิทวงศ์ 18 ถนนจรัญสนิทวงศ์",29,202,331,364,695
2305,"บ้านช่างหล่อ","เขตบางกอกน้อย",102005,"โรงเรียนวัดโพธิ์เรียง ซอยจรัญสนิทวงศ์ 18 ถนนจรัญสนิทวงศ์",30,202,301,388,689
2306,"บ้านช่างหล่อ","เขตบางกอกน้อย",102005,"เต็นท์หน้าบริษัท วี.โฮมเซ็นเตอร์ จำกัด ถนนจรัญสนิทวงศ์",31,160,194,288,482
2307,"บ้านช่างหล่อ","เขตบางกอกน้อย",102005,"เต็นท์หน้าร้านย้งจรัลผ้าเบรค ถนนจรัญสนิทวงศ์",32,139,172,240,412
2308,"บ้านช่างหล่อ","เขตบางกอกน้อย",102005,"เต็นท์หน้าร้านย้งจรัลผ้าเบรค ถนนจรัญสนิทวงศ์",33,140,178,234,412
2309,"บ้านช่างหล่อ","เขตบางกอกน้อย",102005,"เต็นท์บริเวณปากซอยจรัญสนิทวงศ์ 28/2 (ร้านข้าวขาหมูจัมโบ้) ถนนจรัญสนิทวงศ์",34,166,221,304,525
2310,"บ้านช่างหล่อ","เขตบางกอกน้อย",102005,"เต็นท์ลานจอดรถฟู้ดแลนด์ซุปเปอร์มาร์เก็ต ถนนจรัญสนิทวงศ์",35,268,301,386,687
2311,"บ้านช่างหล่อ","เขตบางกอกน้อย",102005,"เต็นท์ที่จอดรถสำนักงานประปา สาขาบางกอกน้อย ซอยจรัญสนิทงศ์ 30/1 ถนนจรัญสนิทวงศ์",36,150,180,186,366
2312,"บ้านช่างหล่อ","เขตบางกอกน้อย",102005,"เต็นท์บริเวณทางเท้าข้างร้านค้าสวัสดิการทหารเรือ ถนนอิสรภาพ",37,155,279,277,556
2313,"บางขุนนนท์","เขตบางกอกน้อย",102006,"โรงเรียนวัดศรีสุดาราม ถนนบางขุนนนท์",1,208,286,320,606
2314,"บางขุนนนท์","เขตบางกอกน้อย",102006,"โรงเรียนวัดศรีสุดาราม ถนนบางขุนนนท์",2,188,244,372,616
2315,"บางขุนนนท์","เขตบางกอกน้อย",102006,"โรงเรียนวัดศรีสุดาราม ถนนบางขุนนนท์",3,336,232,363,595
2316,"บางขุนนนท์","เขตบางกอกน้อย",102006,"โรงเรียนวัดบางขุนนนท์ ถนนบางขุนนนท์",4,273,362,401,763
2317,"บางขุนนนท์","เขตบางกอกน้อย",102006,"โรงเรียนวัดบางขุนนนท์ ถนนบางขุนนนท์",5,214,359,409,768
2318,"บางขุนนนท์","เขตบางกอกน้อย",102006,"โรงเรียนวัดเจ้าอาม ถนนบางขุนนนท์",6,232,350,427,777
2319,"บางขุนนนท์","เขตบางกอกน้อย",102006,"โรงเรียนวัดเจ้าอาม ถนนบางขุนนนท์",7,301,347,441,788
2320,"บางขุนนนท์","เขตบางกอกน้อย",102006,"ศาลาวัดเจ้าอาม (ศาลา 6) ถนนบางขุนนนท์",8,216,319,362,681
2321,"บางขุนนนท์","เขตบางกอกน้อย",102006,"ศาลาวัดเจ้าอาม (ศาลา 6) ถนนบางขุนนนท์",9,256,321,362,683
2322,"บางขุนนนท์","เขตบางกอกน้อย",102006,"ศาลาวัดเจ้าอาม (ศาลา 6) ถนนบางขุนนนท์",10,198,294,349,643
2323,"บางขุนนนท์","เขตบางกอกน้อย",102006,"ศาลาวัดเจ้าอาม (ศาลา 6) ถนนบางขุนนนท์",11,290,291,394,685
2324,"บางขุนศรี","เขตบางกอกน้อย",102007,"โรงเรียนวัดบางเสาธง ซอยจรัญสนิทวงศ์ 19 ถนนจรัญสนิทวงศ์",1,221,327,414,741
2325,"บางขุนศรี","เขตบางกอกน้อย",102007,"โรงเรียนวัดบางเสาธง ซอยจรัญสนิทวงศ์ 19 ถนนจรัญสนิทวงศ์",2,198,388,406,794
2326,"บางขุนศรี","เขตบางกอกน้อย",102007,"เต็นท์โรงเรียนนฤมลทินธนบุรี ถนนจรัญสนิทวงศ์",3,201,305,379,684
2327,"บางขุนศรี","เขตบางกอกน้อย",102007,"เต็นท์โรงเรียนนฤมลทินธนบุรี ถนนจรัญสนิทวงศ์",4,245,300,384,684
2328,"บางขุนศรี","เขตบางกอกน้อย",102007,"เต็นท์โรงเรียนนฤมลทินธนบุรี ถนนจรัญสนิทวงศ์",5,225,297,391,688
2329,"บางขุนศรี","เขตบางกอกน้อย",102007,"โรงเรียนนฤมลทินธนบุรี ถนนจรัญสนิทวงศ์",6,278,300,389,689
2330,"บางขุนศรี","เขตบางกอกน้อย",102007,"โรงเรียนนฤมลทินธนบุรี ถนนจรัญสนิทวงศ์",7,215,312,370,682
2331,"บางขุนศรี","เขตบางกอกน้อย",102007,"โรงเรียนบำรุงวิทยาธนบุรี ถนนจรัญสนิทวงศ์",8,168,214,258,472
2332,"บางขุนศรี","เขตบางกอกน้อย",102007,"เต็นท์ซอยบุปผาสวรรค์ ซอยจรัญสนิทวงศ์ 27 แยก 11",9,232,255,360,615
2333,"บางขุนศรี","เขตบางกอกน้อย",102007,"เต็นท์หน้าศาลพระภูมิ ซอยจรัญสนิทวงศ์ 27 แยก 18",10,268,317,406,723
2334,"บางขุนศรี","เขตบางกอกน้อย",102007,"เต็นท์หน้าศาลพระภูมิ ซอยจรัญสนิทวงศ์ 27 แยก18",11,383,319,419,738
2335,"บางขุนศรี","เขตบางกอกน้อย",102007,"เต็นท์หน้าอาคารเลขที่ 189/58-59 ซอยจรัญสนิทวงศ์ 29 (บริเวณลานกีฬาชุมชน)",12,239,300,388,688
2336,"บางขุนศรี","เขตบางกอกน้อย",102007,"อาคารจำหน่ายสินค้าตลาดนครหลวง ถนนจรัญสนิทวงศ์",13,204,310,346,656
2337,"บางขุนศรี","เขตบางกอกน้อย",102007,"อาคารจำหน่ายสินค้าตลาดนครหลวง ถนนจรัญสนิทวงศ์",14,270,279,362,641
2338,"บางขุนศรี","เขตบางกอกน้อย",102007,"เต็นท์บริเวณอาคารจำหน่ายสินค้าตลาดนครหลวง ถนนจรัญสนิทวงศ์",15,245,324,363,687
2339,"บางขุนศรี","เขตบางกอกน้อย",102007,"เต็นท์บริเวณอาคารจำหน่ายสินค้าตลาดนครหลวง ถนนจรัญสนิทวงศ์",16,267,312,358,670
2340,"บางขุนศรี","เขตบางกอกน้อย",102007,"เต็นท์บริเวณที่จอดรถ สำนักงานโครงการก่อสร้างอุโมงค์ลอดทางแยกไฟฉาย ถนนจรัญสนิทวงศ์",17,124,158,184,342
2341,"บางขุนศรี","เขตบางกอกน้อย",102007,"ศาลาวัดรวกสุทธาราม ซอยจรัญสนิทวงศ์ 33",18,140,235,312,547
2342,"บางขุนศรี","เขตบางกอกน้อย",102007,"ศาลาวัดรวกสุทธาราม ซอยจรัญสนิทวงศ์ 33",19,158,249,318,567
2343,"บางขุนศรี","เขตบางกอกน้อย",102007,"ศาลาวัดรวกสุทธาราม ซอยจรัญสนิทวงศ์ 33",20,176,270,282,552
2344,"บางขุนศรี","เขตบางกอกน้อย",102007,"เต็นท์หน้าร้านค้าหมู่บ้านสินชัย 3 ซอยจรัญสนิทวงศ์ 35",21,230,276,343,619
2345,"บางขุนศรี","เขตบางกอกน้อย",102007,"เต็นท์หน้าร้านค้าหมู่บ้านสินชัย 3 ซอยจรัญสนิทวงศ์ 35",22,240,282,341,623
2346,"บางขุนศรี","เขตบางกอกน้อย",102007,"เต็นท์หน้าร้านค้าหมู่บ้านสินชัย 3 ซอยจรัญสนิทวงศ์ 35",23,246,255,367,622
2347,"บางขุนศรี","เขตบางกอกน้อย",102007,"เต็นท์หน้าร้านค้าหมู่บ้านสินชัย 3 ซอยจรัญสนิทวงศ์ 35",24,232,266,350,616
2348,"บางขุนศรี","เขตบางกอกน้อย",102007,"ที่จอดรถอาคารจรัญแมนชั่น ซอยจรัญสนิทวงศ์ 35",25,219,233,305,538
2349,"บางขุนศรี","เขตบางกอกน้อย",102007,"ที่จอดรถอาคารจรัญแมนชั่น ซอยจรัญสนิทวงศ์ 35",26,154,228,275,503
2350,"บางขุนศรี","เขตบางกอกน้อย",102007,"เต็นท์ในหมู่บ้านสินชัย 2 ซอยจรัญสนิทวงศ์ 35 แยก 17",27,202,234,295,529
2351,"บางขุนศรี","เขตบางกอกน้อย",102007,"เต็นท์ในหมู่บ้านสินชัย 2 ซอยจรัญสนิทวงศ์ 35 แยก 17",28,193,232,289,521
2352,"บางขุนศรี","เขตบางกอกน้อย",102007,"โรงเรียนวัดมะลิ ซอยจรัญสนิทวงศ์ 37 ถนนจรัญสนิทวงศ์",29,156,254,267,521
2353,"บางขุนศรี","เขตบางกอกน้อย",102007,"เต็นท์ในวัดเพลงวิปัสสนา ซอยจรัญสนิทวงศ์ 37",30,214,372,421,793
2354,"บางขุนศรี","เขตบางกอกน้อย",102007,"เต็นท์ในวัดเพลงวิปัสสนา ซอยจรัญสนิทวงศ์ 37",31,285,326,426,752
2355,"บางขุนศรี","เขตบางกอกน้อย",102007,"เต็นท์ในวัดเพลงวิปัสสนา ซอยจรัญสนิทวงศ์ 37",32,251,325,407,732
2356,"บางขุนศรี","เขตบางกอกน้อย",102007,"โรงเรียนมงคลวิจิตรวิทยา ซอยจรัญสนิทวงศ์ 37",33,156,206,251,457
2357,"บางขุนศรี","เขตบางกอกน้อย",102007,"โรงเรียนมงคลวิจิตรวิทยา ซอยจรัญสนิทวงศ์ 37",34,147,188,263,451
2358,"บางขุนศรี","เขตบางกอกน้อย",102007,"บริเวณใต้อาคารห้างสรรพสินค้าแม็คโคร ถนนจรัญสนิทวงศ์",35,292,338,437,775
2359,"บางขุนศรี","เขตบางกอกน้อย",102007,"บริเวณใต้อาคารห้างสรรพสินค้าแม็คโคร ถนนจรัญสนิทวงศ์",36,288,321,436,757
2360,"บางขุนศรี","เขตบางกอกน้อย",102007,"บริเวณใต้อาคารห้างสรรพสินค้าแม็คโคร ถนนจรัญสนิทวงศ์",37,500,321,452,773
2361,"บางขุนศรี","เขตบางกอกน้อย",102007,"ศาลาวัดไชยทิศ ซอยจรัญสนิทวงศ์ 37 ถนนจรัญสนิทวงศ์",38,216,293,366,659
2362,"บางขุนศรี","เขตบางกอกน้อย",102007,"ศาลาวัดไชยทิศ ซอยจรัญสนิทวงศ์ 37 ถนนจรัญสนิทวงศ์",39,314,329,398,727
2363,"บางขุนศรี","เขตบางกอกน้อย",102007,"ศาลาวัดไชยทิศ ซอยจรัญสนิทวงศ์ 37 ถนนจรัญสนิทวงศ์",40,247,330,416,746
2364,"บางขุนศรี","เขตบางกอกน้อย",102007,"ศาลาวัดไชยทิศ ซอยจรัญสนิทวงศ์ 37 ถนนจรัญสนิทวงศ์",41,253,329,403,732
2365,"อรุณอมรินทร์","เขตบางกอกน้อย",102009,"โรงเรียนวัดดุสิตาราม ซอยวัดดุสิตาราม ถนนสมเด็จพระปิ่นเกล้า",1,128,279,297,576
2366,"อรุณอมรินทร์","เขตบางกอกน้อย",102009,"โรงเรียนวัดดุสิตาราม ซอยวัดดุสิตาราม ถนนสมเด็จพระปิ่นเกล้า",2,147,250,306,556
2367,"อรุณอมรินทร์","เขตบางกอกน้อย",102009,"โรงเรียนวัดดุสิตาราม ซอยวัดดุสิตาราม ถนนสมเด็จพระปิ่นเกล้า",3,212,291,320,611
2368,"อรุณอมรินทร์","เขตบางกอกน้อย",102009,"เต็นท์หน้าบริษัทซาบีน่า ถนนอรุณอมรินทร์",4,206,326,328,654
2369,"อรุณอมรินทร์","เขตบางกอกน้อย",102009,"อาคารสโมสรกองเรือเล็ก ถนนอรุณอมรินทร์",5,130,261,335,596
2370,"อรุณอมรินทร์","เขตบางกอกน้อย",102009,"อาคารสโมสรกองเรือเล็ก ถนนอรุณอมรินทร์",6,155,289,305,594
2371,"อรุณอมรินทร์","เขตบางกอกน้อย",102009,"เต็นท์หน้าบริษัทอีซูซุมหานคร จำกัด (ปิ่นเกล้า) ถนนอรุณอมรินทร์",7,230,307,361,668
2372,"อรุณอมรินทร์","เขตบางกอกน้อย",102009,"เต็นท์หน้าร้านสหกรณ์กรุงเทพ ถนนสมเด็จพระปิ่นเกล้า",8,407,318,464,782
2373,"อรุณอมรินทร์","เขตบางกอกน้อย",102009,"ที่จอดรถอาคารมานะสัมพันธ์ ถนนจรัญสนิทวงศ์",9,157,220,245,465
2374,"อรุณอมรินทร์","เขตบางกอกน้อย",102009,"ที่จอดรถอาคารมานะสัมพันธ์ ถนนจรัญสนิทวงศ์",10,164,191,272,463
2375,"อรุณอมรินทร์","เขตบางกอกน้อย",102009,"ที่จอดรถอาคารมานะสัมพันธ์ ถนนจรัญสนิทวงศ์",11,173,203,260,463
2376,"อรุณอมรินทร์","เขตบางกอกน้อย",102009,"เต็นท์โรงเรียนวัดปฐมบุตรอิศราราม ซอยจรัญสนิทวงศ์ 45",12,295,328,458,786
2377,"อรุณอมรินทร์","เขตบางกอกน้อย",102009,"เต็นท์ในวัดปฐมบุตรอิศราราม ซอยจรัญสนิทวงศ์ 45",13,289,336,423,759
2378,"อรุณอมรินทร์","เขตบางกอกน้อย",102009,"เต็นท์ในวัดปฐมบุตรอิศราราม ซอยจรัญสนิทวงศ์ 45",14,299,344,449,793
2379,"อรุณอมรินทร์","เขตบางกอกน้อย",102009,"เต็นท์หน้าห้างเทสโก้โลตัส สาขาปิ่นเกล้า ถนนบรมราชชนนี",15,249,274,362,636
2380,"อรุณอมรินทร์","เขตบางกอกน้อย",102009,"เต็นท์หน้าห้างเทสโก้โลตัส สาขาปิ่นเกล้า ถนนบรมราชชนนี",16,244,272,345,617
2381,"อรุณอมรินทร์","เขตบางกอกน้อย",102009,"ลานจอดรถเอกชนบ้านเลขที่ 657/136 ซอยจรัญสนิทวงศ์ 41",17,268,330,426,756
2382,"อรุณอมรินทร์","เขตบางกอกน้อย",102009,"ลานจอดรถเอกชนบ้านเลขที่ 657/136 ซอยจรัญสนิทวงศ์ 41",18,227,328,419,747
2383,"อรุณอมรินทร์","เขตบางกอกน้อย",102009,"วัดนายโรง ซอยบรมราชชนนี 15 ถนนบรมราชชนนี",19,180,256,313,569
2384,"อรุณอมรินทร์","เขตบางกอกน้อย",102009,"วัดนายโรง ซอยบรมราชชนนี 15 ถนนบรมราชชนนี",20,169,260,268,528
2385,"อรุณอมรินทร์","เขตบางกอกน้อย",102009,"เต็นท์อาคารลุมพินีเพลส ปิ่นเกล้า 2 ถนนบรมราชชนนี",21,391,261,410,671
2386,"อรุณอมรินทร์","เขตบางกอกน้อย",102009,"เต็นท์ที่จอดรถร้านนิตยาไก่ย่าง ถนนบรมราชชนนี",22,302,273,381,654
2387,"อรุณอมรินทร์","เขตบางกอกน้อย",102009,"เต็นท์ที่จอดรถร้านนิตยาไก่ย่าง ถนนบรมราชชนนี",23,315,285,363,648
2388,"อรุณอมรินทร์","เขตบางกอกน้อย",102009,"โรงเรียนวัดสุวรรณคีรี ซอยโรงพยาบาลเจ้าพระยา ถนนบรมราชชนนี",24,507,351,486,837
2389,"อรุณอมรินทร์","เขตบางกอกน้อย",102009,"โรงเรียนวัดสุวรรณคีรี ซอยโรงพยาบาลเจ้าพระยา ถนนบรมราชชนนี",25,492,355,486,841
2390,"ท่าข้าม","เขตบางขุนเทียน",102105,"โรงเรียนวัดเลา",1,252,319,355,674
2391,"ท่าข้าม","เขตบางขุนเทียน",102105,"โรงเรียนวัดเลา",2,254,287,345,632
2392,"ท่าข้าม","เขตบางขุนเทียน",102105,"โรงเรียนวัดเลา",3,275,314,348,662
2393,"ท่าข้าม","เขตบางขุนเทียน",102105,"โรงเรียนวัดเลา",4,292,341,370,711
2394,"ท่าข้าม","เขตบางขุนเทียน",102105,"เต็นท์บริเวณวัดเลา",5,207,255,352,607
2395,"ท่าข้าม","เขตบางขุนเทียน",102105,"เต็นท์บริเวณวัดเลา",6,267,281,358,639
2396,"ท่าข้าม","เขตบางขุนเทียน",102105,"เต็นท์บริเวณวัดเลา",7,258,296,317,613
2397,"ท่าข้าม","เขตบางขุนเทียน",102105,"โรงเรียนวัดกก",8,285,411,467,878
2398,"ท่าข้าม","เขตบางขุนเทียน",102105,"ศาลาวัดบัวผัน",9,225,441,423,864
2399,"ท่าข้าม","เขตบางขุนเทียน",102105,"โรงเรียนวัดท่าข้าม",10,434,381,516,897
2400,"ท่าข้าม","เขตบางขุนเทียน",102105,"โรงเรียนวัดท่าข้าม",11,390,401,506,907
2401,"ท่าข้าม","เขตบางขุนเทียน",102105,"โรงเรียนวัดท่าข้าม",12,325,401,447,848
2402,"ท่าข้าม","เขตบางขุนเทียน",102105,"โรงเรียนวัดท่าข้าม",13,249,345,427,772
2403,"ท่าข้าม","เขตบางขุนเทียน",102105,"โรงเรียนวัดท่าข้าม",14,257,367,404,771
2404,"ท่าข้าม","เขตบางขุนเทียน",102105,"โรงเรียนวัดท่าข้าม",15,272,358,418,776
2405,"ท่าข้าม","เขตบางขุนเทียน",102105,"โรงเรียนวัดท่าข้าม",16,400,438,529,967
2406,"ท่าข้าม","เขตบางขุนเทียน",102105,"โรงเรียนวัดท่าข้าม",17,324,348,426,774
2407,"ท่าข้าม","เขตบางขุนเทียน",102105,"โรงเรียนวัดท่าข้าม",18,266,357,402,759
2408,"ท่าข้าม","เขตบางขุนเทียน",102105,"เต็นท์หน้าศูนย์ชุมชนบ้านเอื้ออาทรบางขุนเทียนโครงการ 1ซอยอนามัยงามเจริญ 31",19,330,314,377,691
2409,"ท่าข้าม","เขตบางขุนเทียน",102105,"เต็นท์หน้าศูนย์ชุมชนบ้านเอื้ออาทรบางขุนเทียนโครงการ 1ซอยอนามัยงามเจริญ 31",20,348,340,412,752
2410,"ท่าข้าม","เขตบางขุนเทียน",102105,"เต็นท์หน้าศูนย์ชุมชนบ้านเอื้ออาทรบางขุนเทียนโครงการ 1ซอยอนามัยงามเจริญ 31",21,349,339,390,729
2411,"ท่าข้าม","เขตบางขุนเทียน",102105,"ในศูนย์ชุมชนบ้านเอื้ออาทรบางขุนเทียนโครงการ 2ซอยอนามัยงามเจริญ 31",22,313,309,367,676
2412,"ท่าข้าม","เขตบางขุนเทียน",102105,"ในศูนย์ชุมชนบ้านเอื้ออาทรบางขุนเทียนโครงการ 2ซอยอนามัยงามเจริญ 31",23,335,310,383,693
2413,"ท่าข้าม","เขตบางขุนเทียน",102105,"ในศูนย์ชุมชนบ้านเอื้ออาทรบางขุนเทียนโครงการ 2ซอยอนามัยงามเจริญ 31",24,344,322,362,684
2414,"ท่าข้าม","เขตบางขุนเทียน",102105,"ในศูนย์ชุมชนบ้านเอื้ออาทรบางขุนเทียนโครงการ 2ซอยอนามัยงามเจริญ 31",25,334,324,371,695
2415,"ท่าข้าม","เขตบางขุนเทียน",102105,"เต็นท์บริเวณสวนหย่อมในหมู่บ้านสินทวีการ์เด้นท์",26,251,316,379,695
2416,"ท่าข้าม","เขตบางขุนเทียน",102105,"เต็นท์บริเวณสวนหย่อมในหมู่บ้านสินทวีการ์เด้นท์",27,232,283,338,621
2417,"ท่าข้าม","เขตบางขุนเทียน",102105,"เต็นท์บริเวณที่ว่างปากทางเข้าหมู่บ้านสินทวีงามเจริญ",28,220,272,324,596
2418,"ท่าข้าม","เขตบางขุนเทียน",102105,"เต็นท์บริเวณที่ว่างปากทางเข้าหมู่บ้านสินทวีงามเจริญ",29,223,279,325,604
2419,"ท่าข้าม","เขตบางขุนเทียน",102105,"เต็นท์บริเวณที่ว่างปากทางเข้าหมู่บ้านสินทวีงามเจริญ",30,260,342,385,727
2420,"ท่าข้าม","เขตบางขุนเทียน",102105,"เต็นท์บริเวณที่ว่างปากทางเข้าหมู่บ้านสินทวีงามเจริญ",31,246,330,389,719
2421,"ท่าข้าม","เขตบางขุนเทียน",102105,"เต็นท์บริเวณหน้าแกรนด์วิลเลจสปอร์ตคลับในหมู่บ้านสินทวีแกรนด์วิลเลจ",32,187,254,295,549
2422,"ท่าข้าม","เขตบางขุนเทียน",102105,"เต็นท์บริเวณหน้าแกรนด์วิลเลจสปอร์ตคลับในหมู่บ้านสินทวีแกรนด์วิลเลจ",33,187,242,306,548
2423,"ท่าข้าม","เขตบางขุนเทียน",102105,"เต็นท์บริเวณศาลเจ้าแม่ทับทิม",34,401,381,525,906
2424,"ท่าข้าม","เขตบางขุนเทียน",102105,"เต็นท์บริเวณศาลเจ้าแม่ทับทิม",35,420,429,545,974
2425,"ท่าข้าม","เขตบางขุนเทียน",102105,"เต็นท์บริเวณศาลเจ้าแม่ทับทิม",36,313,445,477,922
2426,"ท่าข้าม","เขตบางขุนเทียน",102105,"เต็นท์ลานกีฬาชุมชนหมู่บ้านพัฒนา",37,280,421,461,882
2427,"ท่าข้าม","เขตบางขุนเทียน",102105,"เต็นท์ลานกีฬาชุมชนหมู่บ้านพัฒนา",38,357,428,522,950
2428,"ท่าข้าม","เขตบางขุนเทียน",102105,"เต็นท์บริเวณลานอเนกประสงค์คลองเฉลิมชัยพัฒนา (สวนบวรประชานันท์)",39,520,418,535,953
2429,"ท่าข้าม","เขตบางขุนเทียน",102105,"เต็นท์บริเวณลานอเนกประสงค์คลองเฉลิมชัยพัฒนา(สวนบวรประชานันท์)",40,370,341,425,766
2430,"ท่าข้าม","เขตบางขุนเทียน",102105,"เต็นท์บริเวณลานอเนกประสงค์คลองเฉลิมชัยพัฒนา(สวนบวรประชานันท์)",41,344,378,442,820
2431,"ท่าข้าม","เขตบางขุนเทียน",102105,"เต็นท์บริเวณลานอเนกประสงค์คลองเฉลิมชัยพัฒนา(สวนบวรประชานันท์)",42,352,368,445,813
2432,"ท่าข้าม","เขตบางขุนเทียน",102105,"เต็นท์บริเวณลานอเนกประสงค์คลองเฉลิมชัยพัฒนา(สวนบวรประชานันท์)",43,362,322,408,730
2433,"ท่าข้าม","เขตบางขุนเทียน",102105,"เต็นท์บริเวณลานอเนกประสงค์คลองเฉลิมชัยพัฒนา(สวนบวรประชานันท์)",44,613,503,674,1177
2434,"ท่าข้าม","เขตบางขุนเทียน",102105,"โรงเรียนวัดหัวกระบือ",45,361,387,449,836
2435,"ท่าข้าม","เขตบางขุนเทียน",102105,"โรงเรียนวัดหัวกระบือ",46,326,376,443,819
2436,"ท่าข้าม","เขตบางขุนเทียน",102105,"โรงเรียนวัดหัวกระบือ",47,247,355,405,760
2437,"ท่าข้าม","เขตบางขุนเทียน",102105,"โรงเรียนวัดหัวกระบือ",48,300,397,470,867
2438,"ท่าข้าม","เขตบางขุนเทียน",102105,"โรงเรียนวัดหัวกระบือ",49,164,269,332,601
2439,"ท่าข้าม","เขตบางขุนเทียน",102105,"บริเวณลานอเนกประสงค์วิทยาลัยเทคโนโลยีปทีปพลีผล",50,376,391,495,886
2440,"ท่าข้าม","เขตบางขุนเทียน",102105,"บริเวณลานอเนกประสงค์วิทยาลัยเทคโนโลยีปทีปพลีผล",51,291,376,453,829
2441,"ท่าข้าม","เขตบางขุนเทียน",102105,"บริเวณลานอเนกประสงค์วิทยาลัยเทคโนโลยีปทีปพลีผล",52,367,416,396,812
2442,"ท่าข้าม","เขตบางขุนเทียน",102105,"บริเวณลานอเนกประสงค์วิทยาลัยเทคโนโลยีปทีปพลีผล",53,305,370,422,792
2443,"ท่าข้าม","เขตบางขุนเทียน",102105,"บริเวณลานอเนกประสงค์วิทยาลัยเทคโนโลยีปทีปพลีผล",54,481,438,546,984
2444,"ท่าข้าม","เขตบางขุนเทียน",102105,"เต็นท์บริเวณหน้าหมู่บ้านคุณาลัย",55,331,347,479,826
2445,"ท่าข้าม","เขตบางขุนเทียน",102105,"เต็นท์บริเวณหน้าหมู่บ้านคุณาลัย",56,330,370,434,804
2446,"ท่าข้าม","เขตบางขุนเทียน",102105,"เต็นท์บริเวณหน้าหมู่บ้านคุณาลัย",57,319,387,416,803
2447,"ท่าข้าม","เขตบางขุนเทียน",102105,"โรงเรียนแก้วขำทับอุปถัมภ์",58,203,435,447,882
2448,"ท่าข้าม","เขตบางขุนเทียน",102105,"โรงเรียนวัดประชาบำรุง",59,153,223,286,509
2449,"ท่าข้าม","เขตบางขุนเทียน",102105,"โรงเรียนวัดประชาบำรุง",60,111,239,262,501
2450,"ท่าข้าม","เขตบางขุนเทียน",102105,"โรงเรียนคลองพิทยาลงกรณ์",61,208,300,325,625
2451,"ท่าข้าม","เขตบางขุนเทียน",102105,"โรงเรียนคลองพิทยาลงกรณ์",62,164,259,283,542
2452,"ท่าข้าม","เขตบางขุนเทียน",102105,"โรงเรียนคลองพิทยาลงกรณ์",63,206,315,330,645
2453,"แสมดำ","เขตบางขุนเทียน",102107,"โรงเรียนราชมนตรี (ปลื้ม-เชื่อมนุกูล)",1,351,377,481,858
2454,"แสมดำ","เขตบางขุนเทียน",102107,"โรงเรียนราชมนตรี (ปลื้ม-เชื่อมนุกูล)",2,384,430,515,945
2455,"แสมดำ","เขตบางขุนเทียน",102107,"โรงเรียนราชมนตรี (ปลื้ม-เชื่อมนุกูล)",3,374,421,505,926
2456,"แสมดำ","เขตบางขุนเทียน",102107,"โรงเรียนราชมนตรี (ปลื้ม-เชื่อมนุกูล)",4,446,464,576,1040
2457,"แสมดำ","เขตบางขุนเทียน",102107,"โรงเรียนวัดกำแพง",5,281,336,418,754
2458,"แสมดำ","เขตบางขุนเทียน",102107,"โรงเรียนวัดกำแพง",6,138,341,402,743
2459,"แสมดำ","เขตบางขุนเทียน",102107,"โรงเรียนวัดกำแพง",7,327,338,432,770
2460,"แสมดำ","เขตบางขุนเทียน",102107,"โรงเรียนจารุวัฒนานุกูล",8,277,300,360,660
2461,"แสมดำ","เขตบางขุนเทียน",102107,"โรงเรียนจารุวัฒนานุกูล",9,435,307,422,729
2462,"แสมดำ","เขตบางขุนเทียน",102107,"โรงเรียนจารุวัฒนานุกูล",10,288,349,400,749
2463,"แสมดำ","เขตบางขุนเทียน",102107,"โรงเรียนวรรณสว่างจิต หมู่บ้านสุดจิตต์นิเวศน์",11,190,219,278,497
2464,"แสมดำ","เขตบางขุนเทียน",102107,"โรงเรียนวรรณสว่างจิต หมู่บ้านสุดจิตต์นิเวศน์",12,191,239,287,526
2465,"แสมดำ","เขตบางขุนเทียน",102107,"โรงเรียนสมิทธิพงษ์",13,390,411,518,929
2466,"แสมดำ","เขตบางขุนเทียน",102107,"โรงเรียนสมิทธิพงษ์",14,232,364,385,749
2467,"แสมดำ","เขตบางขุนเทียน",102107,"เต็นท์บริเวณสนามเด็กเล่นในหมู่บ้านพิศาล ถนนท่าข้าม",15,190,308,329,637
2468,"แสมดำ","เขตบางขุนเทียน",102107,"เต็นท์บริเวณสนามเด็กเล่นในหมู่บ้านพิศาล ถนนท่าข้าม",16,187,288,321,609
2469,"แสมดำ","เขตบางขุนเทียน",102107,"เต็นท์บริเวณสนามเด็กเล่นในหมู่บ้านพิศาล ถนนท่าข้าม",17,241,310,366,676
2470,"แสมดำ","เขตบางขุนเทียน",102107,"เต็นท์บริเวณสนามเด็กเล่นในหมู่บ้านพิศาล ถนนท่าข้าม",18,301,336,400,736
2471,"แสมดำ","เขตบางขุนเทียน",102107,"เต็นท์บริเวณสนามเด็กเล่นในหมู่บ้านพิศาล ถนนท่าข้าม",19,257,312,404,716
2472,"แสมดำ","เขตบางขุนเทียน",102107,"เต็นท์บริเวณสนามเด็กเล่นในหมู่บ้านพิศาล ถนนท่าข้าม",20,241,302,389,691
2473,"แสมดำ","เขตบางขุนเทียน",102107,"เต็นท์บริเวณสนามเด็กเล่นในหมู่บ้านพิศาล ถนนท่าข้าม",21,275,318,437,755
2474,"แสมดำ","เขตบางขุนเทียน",102107,"เต็นท์บริเวณสนามเด็กเล่นในหมู่บ้านพิศาล ถนนท่าข้าม",22,258,322,405,727
2475,"แสมดำ","เขตบางขุนเทียน",102107,"เต็นท์บริเวณสนามเด็กเล่นในหมู่บ้านพิศาล ถนนท่าข้าม",23,262,330,404,734
2476,"แสมดำ","เขตบางขุนเทียน",102107,"เต็นท์บริเวณสนามเด็กเล่นในหมู่บ้านพิศาล ถนนท่าข้าม",24,241,290,385,675
2477,"แสมดำ","เขตบางขุนเทียน",102107,"เต็นท์บริเวณสนามเด็กเล่นในหมู่บ้านพิศาล ถนนท่าข้าม",25,312,305,424,729
2478,"แสมดำ","เขตบางขุนเทียน",102107,"เต็นท์บริเวณสนามเด็กเล่นในหมู่บ้านพิศาล ถนนท่าข้าม",26,298,338,438,776
2479,"แสมดำ","เขตบางขุนเทียน",102107,"เต็นท์บริเวณที่ว่างฝั่งตรงข้ามระหว่างซอยท่าข้าม 8 และท่าข้าม 10 ถนนท่าข้าม",27,311,389,365,754
2480,"แสมดำ","เขตบางขุนเทียน",102107,"เต็นท์บริเวณที่ว่างฝั่งตรงข้ามระหว่างซอยท่าข้าม 8 และท่าข้าม 10 ถนนท่าข้าม",28,385,327,447,774
2481,"แสมดำ","เขตบางขุนเทียน",102107,"เต็นท์บริเวณที่ว่างฝั่งตรงข้ามระหว่างซอยท่าข้าม 8 และท่าข้าม 10 ถนนท่าข้าม",29,290,330,403,733
2482,"แสมดำ","เขตบางขุนเทียน",102107,"เต็นท์บริเวณที่ว่างฝั่งตรงข้ามระหว่างซอยท่าข้าม 8 และท่าข้าม 10 ถนนท่าข้าม",30,266,329,406,735
2483,"แสมดำ","เขตบางขุนเทียน",102107,"เต็นท์บริเวณลานจอดรถหน้าโรงเบียร์ฮอลแลนด์ ริมถนนพระรามที่ 2",31,326,338,421,759
2484,"แสมดำ","เขตบางขุนเทียน",102107,"เต็นท์บริเวณลานจอดรถหน้าโรงเบียร์ฮอลแลนด์ ริมถนนพระรามที่ 2",32,171,346,376,722
2485,"แสมดำ","เขตบางขุนเทียน",102107,"เต็นท์บริเวณลานจอดรถหน้าโรงเบียร์ฮอลแลนด์ ริมถนนพระรามที่ 2",33,237,323,406,729
2486,"แสมดำ","เขตบางขุนเทียน",102107,"โรงเรียนวัดสะแกงาม",34,366,423,443,866
2487,"แสมดำ","เขตบางขุนเทียน",102107,"โรงเรียนวัดสะแกงาม",35,365,386,438,824
2488,"แสมดำ","เขตบางขุนเทียน",102107,"โรงเรียนวัดสะแกงาม",36,286,363,426,789
2489,"แสมดำ","เขตบางขุนเทียน",102107,"โรงเรียนวัดสะแกงาม",37,252,402,439,841
2490,"แสมดำ","เขตบางขุนเทียน",102107,"โรงเรียนวัดสะแกงาม",38,312,394,450,844
2491,"แสมดำ","เขตบางขุนเทียน",102107,"โรงเรียนวัดสะแกงาม",39,405,366,489,855
2492,"แสมดำ","เขตบางขุนเทียน",102107,"โรงเรียนวัดสะแกงาม",40,329,375,468,843
2493,"แสมดำ","เขตบางขุนเทียน",102107,"โรงเรียนวัดสะแกงาม",41,253,410,429,839
2494,"แสมดำ","เขตบางขุนเทียน",102107,"โรงเรียนวัดสะแกงาม",42,208,421,417,838
2495,"แสมดำ","เขตบางขุนเทียน",102107,"โรงเรียนวัดสะแกงาม",43,280,412,431,843
2496,"แสมดำ","เขตบางขุนเทียน",102107,"โรงเรียนวัดสะแกงาม",44,353,384,457,841
2497,"แสมดำ","เขตบางขุนเทียน",102107,"โรงเรียนวัดสะแกงาม",45,281,375,412,787
2498,"แสมดำ","เขตบางขุนเทียน",102107,"เต็นท์บริเวณในซอยเทียนทะเล 18",46,302,338,384,722
2499,"แสมดำ","เขตบางขุนเทียน",102107,"เต็นท์บริเวณในหมู่บ้านสินทวี 1 ซอยเทียนทะเล 20",47,329,353,423,776
2500,"แสมดำ","เขตบางขุนเทียน",102107,"เต็นท์บริเวณในหมู่บ้านสินทวี 1 ซอยเทียนทะเล 20",48,362,335,457,792
2501,"แสมดำ","เขตบางขุนเทียน",102107,"เต็นท์บริเวณในหมู่บ้านสินทวี 1 ซอยเทียนทะเล 20",49,300,351,444,795
2502,"แสมดำ","เขตบางขุนเทียน",102107,"เต็นท์บริเวณในหมู่บ้านสินทวี 1 ซอยเทียนทะเล 20",50,219,349,394,743
2503,"แสมดำ","เขตบางขุนเทียน",102107,"เต็นท์บริเวณในหมู่บ้านพิศาล เทียนทะเล โครงการ 1  ซอยเทียนทะเล 20",51,348,363,454,817
2504,"แสมดำ","เขตบางขุนเทียน",102107,"เต็นท์บริเวณในหมู่บ้านพิศาล เทียนทะเล โครงการ 1  ซอยเทียนทะเล 20",52,280,352,425,777
2505,"แสมดำ","เขตบางขุนเทียน",102107,"เต็นท์บริเวณในหมู่บ้านพิศาล เทียนทะเล โครงการ 1 ซอยเทียนทะเล 20",53,192,324,330,654
2506,"แสมดำ","เขตบางขุนเทียน",102107,"ศูนย์พัฒนาเด็กเล็กก่อนวัยเรียน ซอยเทียนทะเล 20 แยก 8",54,132,253,262,515
2507,"แสมดำ","เขตบางขุนเทียน",102107,"เต็นท์หน้าศูนย์พัฒนาเด็กเล็กก่อนวัยเรียน ซอยเทียนทะเล 20 แยก 8",55,152,238,285,523
2508,"แสมดำ","เขตบางขุนเทียน",102107,"เต็นท์บริเวณหมู่บ้านเอื้ออาทรบางขุนเทียน 3 ซอยเทียนทะเล 28",56,393,384,455,839
2509,"แสมดำ","เขตบางขุนเทียน",102107,"เต็นท์บริเวณหมู่บ้านเอื้ออาทรบางขุนเทียน 3 ซอยเทียนทะเล 28",57,448,391,441,832
2510,"แสมดำ","เขตบางขุนเทียน",102107,"เต็นท์บริเวณหมู่บ้านเอื้ออาทรบางขุนเทียน 3 ซอยเทียนทะเล 28",58,411,420,455,875
2511,"แสมดำ","เขตบางขุนเทียน",102107,"เต็นท์ลานกีฬาบ้านเอื้ออาทรบางขุนเทียน 3 ซอยเทียนทะเล 28",59,413,387,432,819
2512,"แสมดำ","เขตบางขุนเทียน",102107,"เต็นท์ในซอยบางกระดี่ 15 (ซอยดอกรัก)",60,228,350,368,718
2513,"แสมดำ","เขตบางขุนเทียน",102107,"เต็นท์ในซอยบางกระดี่ 15 (ซอยดอกรัก)",61,270,370,376,746
2514,"แสมดำ","เขตบางขุนเทียน",102107,"เต็นท์ในซอยบางกระดี่ 15 (ซอยดอกรัก)",62,241,385,404,789
2515,"แสมดำ","เขตบางขุนเทียน",102107,"ศาลาวัดบางกระดี่",63,205,325,386,711
2516,"แสมดำ","เขตบางขุนเทียน",102107,"ศาลาวัดบางกระดี่",64,171,347,354,701
2517,"แสมดำ","เขตบางขุนเทียน",102107,"ศาลาวัดบางกระดี่",65,202,347,361,708
2518,"แสมดำ","เขตบางขุนเทียน",102107,"ศาลาวัดบางกระดี่",66,244,354,402,756
2519,"แสมดำ","เขตบางขุนเทียน",102107,"ศาลาวัดบางกระดี่",67,294,354,412,766
2520,"แสมดำ","เขตบางขุนเทียน",102107,"โรงเรียนวัดบางกระดี่",68,294,348,435,783
2521,"แสมดำ","เขตบางขุนเทียน",102107,"โรงเรียนวัดบางกระดี่",69,288,327,410,737
2522,"แสมดำ","เขตบางขุนเทียน",102107,"โรงเรียนวัดบางกระดี่",70,308,362,382,744
2523,"แสมดำ","เขตบางขุนเทียน",102107,"โรงเรียนวัดบางกระดี่",71,433,347,463,810
2524,"แสมดำ","เขตบางขุนเทียน",102107,"โรงเรียนวัดบางกระดี่",72,357,368,381,749
2525,"แสมดำ","เขตบางขุนเทียน",102107,"โรงเรียนวัดบางกระดี่",73,200,359,399,758
2526,"แสมดำ","เขตบางขุนเทียน",102107,"โรงเรียนวัดบางกระดี่",74,177,326,368,694
2527,"แสมดำ","เขตบางขุนเทียน",102107,"โรงเรียนวัดแสมดำ",75,301,389,439,828
2528,"แสมดำ","เขตบางขุนเทียน",102107,"โรงเรียนวัดแสมดำ",76,177,325,380,705
2529,"แสมดำ","เขตบางขุนเทียน",102107,"เต็นท์ลานกีฬาบ้านเอื้ออาทร  ซอยแสมดำ 17",77,266,289,329,618
2530,"แสมดำ","เขตบางขุนเทียน",102107,"เต็นท์ลานกีฬาบ้านเอื้ออาทร  ซอยแสมดำ 17",78,318,301,355,656
2531,"แสมดำ","เขตบางขุนเทียน",102107,"เต็นท์ลานกีฬาบ้านเอื้ออาทร  ซอยแสมดำ 17",79,334,293,334,627
2532,"แสมดำ","เขตบางขุนเทียน",102107,"โรงเรียนหมู่บ้านเกาะโพธิ์",80,104,183,224,407
2533,"แสมดำ","เขตบางขุนเทียน",102107,"เต็นท์บริเวณวัดพรหมรังษี",81,304,335,421,756
2534,"แสมดำ","เขตบางขุนเทียน",102107,"เต็นท์บริเวณวัดพรหมรังษี",82,189,328,377,705
2535,"แสมดำ","เขตบางขุนเทียน",102107,"เต็นท์บริเวณวัดพรหมรังษี",83,228,368,376,744
2536,"แสมดำ","เขตบางขุนเทียน",102107,"เต็นท์บริเวณวัดพรหมรังษี",84,265,345,407,752
2537,"แสมดำ","เขตบางขุนเทียน",102107,"เต็นท์บริเวณวัดพรหมรังษี",85,262,386,432,818
2538,"แสมดำ","เขตบางขุนเทียน",102107,"เต็นท์ลานกีฬาชุมชนทรัพย์สินพัฒนา",86,184,317,367,684
2539,"แสมดำ","เขตบางขุนเทียน",102107,"เต็นท์ลานกีฬาชุมชนทรัพย์สินพัฒนา",87,202,396,399,795
2540,"แสมดำ","เขตบางขุนเทียน",102107,"เต็นท์ลานกีฬาชุมชนทรัพย์สินพัฒนา",88,207,372,404,776
2541,"แสมดำ","เขตบางขุนเทียน",102107,"เต็นท์ลานกีฬาชุมชนทรัพย์สินพัฒนา",89,192,361,406,767
2542,"แสมดำ","เขตบางขุนเทียน",102107,"เต็นท์บริเวณปั๊มน้ำมันปากทางเข้าถนนบางกระดี่ ริมถนนพระรามที่ 2",90,272,340,378,718
2543,"แสมดำ","เขตบางขุนเทียน",102107,"เต็นท์บริเวณปั๊มน้ำมันปากทางเข้าถนนบางกระดี่ริมถนนพระรามที่ 2",91,256,314,363,677
2544,"แสมดำ","เขตบางขุนเทียน",102107,"เต็นท์บริเวณที่ว่างในซอยบางกระดี่ 3 แยก 5 (ชุมชนเพชรทองคำ)",92,194,304,369,673
2545,"แสมดำ","เขตบางขุนเทียน",102107,"เต็นท์บริเวณที่ว่างในซอยบางกระดี่ 3 แยก 5 (ชุมชนเพชรทองคำ)",93,229,323,393,716
2546,"แสมดำ","เขตบางขุนเทียน",102107,"อาคารศูนย์บริการผู้สูงอายุเพชรทองคำ ในชุมชนเพชรทองคำ",94,188,281,374,655
2547,"แสมดำ","เขตบางขุนเทียน",102107,"เต็นท์บริเวณที่ทำการไปรษณีย์นำจ่าย สาขาบางขุนเทียนถนนพระรามที่ 2 ซอย 82",95,276,339,398,737
2548,"แสมดำ","เขตบางขุนเทียน",102107,"เต็นท์บริเวณที่ทำการไปรษณีย์นำจ่าย สาขาบางขุนเทียนถนนพระรามที่ 2 ซอย 82",96,329,316,351,667
2549,"แสมดำ","เขตบางขุนเทียน",102107,"เต็นท์บริเวณที่ทำการไปรษณีย์นำจ่าย สาขาบางขุนเทียนถนนพระรามที่ 2 ซอย 82",97,218,323,368,691
2550,"แสมดำ","เขตบางขุนเทียน",102107,"เต็นท์บริเวณสวนหย่อมในหมู่บ้านพระราม 2 ถนนพระราม 2 ซอย 76 (ศาลตายาย)",98,240,317,350,667
2551,"แสมดำ","เขตบางขุนเทียน",102107,"เต็นท์บริเวณลานจอดรถร้านอาหารบ้านพลอย ซอยเทียนทะเล 12",99,371,428,481,909
2552,"แสมดำ","เขตบางขุนเทียน",102107,"โรงเรียนศาลเจ้า (ห้าวนุกูลวิทยา)",100,350,373,458,831
2553,"แสมดำ","เขตบางขุนเทียน",102107,"โรงเรียนศาลเจ้า (ห้าวนุกูลวิทยา)",101,260,362,452,814
2554,"แสมดำ","เขตบางขุนเทียน",102107,"โรงเรียนศาลเจ้า (ห้าวนุกูลวิทยา)",102,404,332,436,768
2555,"แสมดำ","เขตบางขุนเทียน",102107,"โรงเรียนศาลเจ้า (ห้าวนุกูลวิทยา)",103,619,328,534,862
2556,"แสมดำ","เขตบางขุนเทียน",102107,"เต็นท์บริเวณลานกีฬาหมู่บ้านการเคหะธนบุรีโครงการ 1 ส่วนที่ 1  (พระรามที่ 2 ซอย 69)",104,258,323,382,705
2557,"แสมดำ","เขตบางขุนเทียน",102107,"เต็นท์บริเวณลานกีฬาหมู่บ้านการเคหะธนบุรีโครงการ 1 ส่วนที่ 1  (พระรามที่ 2 ซอย 69)",105,273,310,406,716
2558,"แสมดำ","เขตบางขุนเทียน",102107,"โรงเรียนบางขุนเทียนศึกษา",106,327,336,406,742
2559,"แสมดำ","เขตบางขุนเทียน",102107,"โรงเรียนบางขุนเทียนศึกษา",107,263,342,446,788
2560,"แสมดำ","เขตบางขุนเทียน",102107,"โรงเรียนบางขุนเทียนศึกษา",108,201,325,382,707
2561,"แสมดำ","เขตบางขุนเทียน",102107,"โรงเรียนบางขุนเทียนศึกษา",109,215,311,385,696
2562,"แสมดำ","เขตบางขุนเทียน",102107,"โรงเรียนบางขุนเทียนศึกษา",110,230,315,355,670
2563,"แสมดำ","เขตบางขุนเทียน",102107,"เต็นท์บริเวณสนามกีฬาหมู่บ้านการเคหะฯ โครงการ 1 ส่วน 4 (พระรามที่ 2 ซอย 69 แยก 4-1)",111,304,373,422,795
2564,"แสมดำ","เขตบางขุนเทียน",102107,"เต็นท์บริเวณสนามกีฬาหมู่บ้านการเคหะฯ โครงการ 1 ส่วน 4 (พระรามที่ 2 ซอย 69 แยก 4-1)",112,273,331,397,728
2565,"แสมดำ","เขตบางขุนเทียน",102107,"เต็นท์บริเวณสนามกีฬาหมู่บ้านการเคหะฯ โครงการ 1 ส่วน 4 (พระรามที่ 2 ซอย 69 แยก 4-1)",113,234,320,386,706
2566,"แสมดำ","เขตบางขุนเทียน",102107,"เต็นท์บริเวณสนามกีฬาหมู่บ้านการเคหะฯ โครงการ 1 ส่วน 4 (พระรามที่ 2 ซอย 69 แยก 4-1)",114,238,318,353,671
2567,"แสมดำ","เขตบางขุนเทียน",102107,"เต็นท์บริเวณสนามกีฬาหมู่บ้านการเคหะฯ โครงการ 1 ส่วน 4 (พระรามที่ 2 ซอย 69 แยก 4-1)",115,221,283,344,627
2568,"แสมดำ","เขตบางขุนเทียน",102107,"เต็นท์บริเวณศูนย์กีฬาบางขุนเทียน ชุมชนเคหะธนบุรี 3 (พระรามที่ 2 ซอย 62)",116,383,366,508,874
2569,"แสมดำ","เขตบางขุนเทียน",102107,"เต็นท์บริเวณศูนย์กีฬาบางขุนเทียน ชุมชนเคหะธนบุรี 3 (พระรามที่ 2 ซอย 62)",117,341,322,426,748
2570,"แสมดำ","เขตบางขุนเทียน",102107,"เต็นท์บริเวณศูนย์กีฬาบางขุนเทียน ชุมชนเคหะธนบุรี 3 (พระรามที่ 2 ซอย 62)",118,313,372,453,825
2571,"แสมดำ","เขตบางขุนเทียน",102107,"เต็นท์บริเวณศูนย์กีฬาบางขุนเทียน ชุมชนเคหะธนบุรี 3 (พระรามที่ 2 ซอย 62)",119,271,332,437,769
2572,"แสมดำ","เขตบางขุนเทียน",102107,"เต็นท์บริเวณศูนย์กีฬาบางขุนเทียน ชุมชนเคหะธนบุรี 3 (พระรามที่ 2 ซอย 62)",120,275,336,424,760
2573,"แสมดำ","เขตบางขุนเทียน",102107,"เต็นท์บริเวณศูนย์กีฬาบางขุนเทียน ชุมชนเคหะธนบุรี 3 (พระรามที่ 2 ซอย 62)",121,278,348,431,779
2574,"แสมดำ","เขตบางขุนเทียน",102107,"เต็นท์บริเวณศูนย์กีฬาบางขุนเทียน ชุมชนเคหะธนบุรี 3 (พระรามที่ 2 ซอย 62)",122,367,351,463,814
2575,"แสมดำ","เขตบางขุนเทียน",102107,"เต็นท์บริเวณลานจอดรถข้างสำนักงานดูแลเคหะชุมชนธนบุรี(การไฟฟ้านครหลวง)",123,418,288,453,741
2576,"แสมดำ","เขตบางขุนเทียน",102107,"เต็นท์บริเวณลานจอดรถข้างสำนักงานดูแลเคหะชุมชนธนบุรี(การไฟฟ้านครหลวง)",124,311,325,413,738
2577,"แสมดำ","เขตบางขุนเทียน",102107,"เต็นท์บริเวณลานจอดรถข้างสำนักงานดูแลเคหะชุมชนธนบุรี (การไฟฟ้านครหลวง)",125,310,306,382,688
2578,"แสมดำ","เขตบางขุนเทียน",102107,"เต็นท์บริเวณลานจอดรถข้างสำนักงานดูแลเคหะชุมชนธนบุรี(การไฟฟ้านครหลวง)",126,330,322,408,730
2579,"แสมดำ","เขตบางขุนเทียน",102107,"เต็นท์บริเวณลานจอดรถข้างสำนักงานดูแลเคหะชุมชนธนบุรี (การไฟฟ้านครหลวง)",127,406,288,464,752
2580,"แสมดำ","เขตบางขุนเทียน",102107,"เต็นท์บริเวณลานจอดรถข้างสำนักงานดูแลเคหะชุมชนธนบุรี(การไฟฟ้านครหลวง)",128,408,284,465,749
2581,"บางหว้า","เขตภาษีเจริญ",102201,"โรงเรียนวัดอ่างแก้ว",1,199,231,296,527
2582,"บางหว้า","เขตภาษีเจริญ",102201,"โรงเรียนวัดอ่างแก้ว",2,148,263,264,527
2583,"บางหว้า","เขตภาษีเจริญ",102201,"โรงเรียนวัดโคนอน",3,165,289,326,615
2584,"บางหว้า","เขตภาษีเจริญ",102201,"โรงเรียนวัดโคนอน",4,174,298,342,640
2585,"บางหว้า","เขตภาษีเจริญ",102201,"โรงเรียนวัดโคนอน",5,162,294,307,601
2586,"บางหว้า","เขตภาษีเจริญ",102201,"โรงเรียนวัดโคนอน",6,154,266,327,593
2587,"บางหว้า","เขตภาษีเจริญ",102201,"โรงเรียนวัดรางบัว",7,207,269,346,615
2588,"บางหว้า","เขตภาษีเจริญ",102201,"โรงเรียนวัดรางบัว",8,244,245,342,587
2589,"บางหว้า","เขตภาษีเจริญ",102201,"โรงเรียนวัดรางบัว",9,158,257,318,575
2590,"บางหว้า","เขตภาษีเจริญ",102201,"โรงเรียนวัดรางบัว",10,150,278,288,566
2591,"บางหว้า","เขตภาษีเจริญ",102201,"โรงเรียนวัดรางบัว",11,171,293,341,634
2592,"บางหว้า","เขตภาษีเจริญ",102201,"โรงจอดรถตรงข้ามซอยเทอดไท 77 แยก 1 (สวนอาหารส้มโอ)",12,193,234,287,521
2593,"บางหว้า","เขตภาษีเจริญ",102201,"โรงจอดรถตรงข้ามซอยเทอดไท 77 แยก 1 (สวนอาหารส้มโอ)",13,184,216,295,511
2594,"บางหว้า","เขตภาษีเจริญ",102201,"อาคารอเนกประสงค์หน้าบ้านพักนิคมทวีสุข  บางแค",14,225,284,338,622
2595,"บางหว้า","เขตภาษีเจริญ",102201,"อาคารอเนกประสงค์หน้าบ้านพักนิคมทวีสุข  บางแค",15,234,268,343,611
2596,"บางหว้า","เขตภาษีเจริญ",102201,"อาคารอเนกประสงค์หน้าบ้านพักนิคมทวีสุข  บางแค",16,206,246,331,577
2597,"บางหว้า","เขตภาษีเจริญ",102201,"อาคารอเนกประสงค์หน้าบ้านพักนิคมทวีสุข  บางแค",17,177,297,321,618
2598,"บางหว้า","เขตภาษีเจริญ",102201,"เต็นท์หน้าร้านเซเว่นอีเลฟเว่น ปากซอยศาลธนบุรี 44/4",18,265,398,450,848
2599,"บางหว้า","เขตภาษีเจริญ",102201,"เต็นท์หน้าร้านเซเว่นอีเลฟเว่น ปากซอยศาลธนบุรี 44/4",19,392,355,496,851
2600,"บางหว้า","เขตภาษีเจริญ",102201,"เต็นท์หน้าร้านเซเว่นอีเลฟเว่น ปากซอยศาลธนบุรี 44/4",20,389,366,448,814
2601,"บางหว้า","เขตภาษีเจริญ",102201,"อาคารสงเคราะห์ข้าราชการกรุงเทพมหานคร ซอยศาลธนบุรี 17 แยก 7",21,230,295,314,609
2602,"บางหว้า","เขตภาษีเจริญ",102201,"อาคารสงเคราะห์ข้าราชการกรุงเทพมหานคร ซอยศาลธนบุรี 17 แยก 7",22,189,248,319,567
2603,"บางหว้า","เขตภาษีเจริญ",102201,"อาคารสงเคราะห์ข้าราชการกรุงเทพมหานคร ซอยศาลธนบุรี 17 แยก 7",23,190,259,296,555
2604,"บางหว้า","เขตภาษีเจริญ",102201,"อาคารสงเคราะห์ข้าราชการกรุงเทพมหานคร ซอยศาลธนบุรี 17 แยก 7",24,196,281,309,590
2605,"บางหว้า","เขตภาษีเจริญ",102201,"อาคารสงเคราะห์ข้าราชการกรุงเทพมหานคร ซอยศาลธนบุรี 17 แยก 7",25,199,265,300,565
2606,"บางหว้า","เขตภาษีเจริญ",102201,"อาคารสงเคราะห์ข้าราชการกรุงเทพมหานคร ซอยศาลธนบุรี 17 แยก 7",26,166,247,259,506
2607,"บางหว้า","เขตภาษีเจริญ",102201,"อาคารสงเคราะห์ข้าราชการกรุงเทพมหานคร ซอยศาลธนบุรี 17 แยก 7",27,207,266,301,567
2608,"บางหว้า","เขตภาษีเจริญ",102201,"อาคารสงเคราะห์ข้าราชการกรุงเทพมหานคร ซอยศาลธนบุรี 17 แยก 7",28,194,272,323,595
2609,"บางหว้า","เขตภาษีเจริญ",102201,"อาคารสงเคราะห์ข้าราชการกรุงเทพมหานคร ซอยศาลธนบุรี 17 แยก 7",29,169,258,301,559
2610,"บางหว้า","เขตภาษีเจริญ",102201,"เต็นท์ปั๊มน้ำมัน ปตท. ถนนกัลปพฤกษ์",30,155,187,224,411
2611,"บางหว้า","เขตภาษีเจริญ",102201,"เต็นท์ข้างสำนักงาน เมโทร พาร์ค สาทร ถนนกัลปพฤกษ์",31,487,246,398,644
2612,"บางหว้า","เขตภาษีเจริญ",102201,"เต็นท์ข้างสำนักงาน เมโทร พาร์ค สาทร ถนนกัลปพฤกษ์",32,447,225,384,609
2613,"บางหว้า","เขตภาษีเจริญ",102201,"เต็นท์ข้างสำนักงาน เมโทร พาร์ค สาทร ถนนกัลปพฤกษ์",33,465,237,415,652
2614,"บางหว้า","เขตภาษีเจริญ",102201,"เต็นท์ข้างสำนักงาน เมโทร พาร์ค สาทร ถนนกัลปพฤกษ์",34,440,251,411,662
2615,"บางหว้า","เขตภาษีเจริญ",102201,"เต็นท์หน้าอาคารมัลเบอรี่เพลส (ใกล้ซอยเพชรเกษม 42)",35,531,317,463,780
2616,"บางหว้า","เขตภาษีเจริญ",102201,"เต็นท์หน้าอาคารมัลเบอรี่เพลส (ใกล้ซอยเพชรเกษม 42)",36,251,336,465,801
2617,"บางหว้า","เขตภาษีเจริญ",102201,"เต็นท์หน้าเดอะคีย์คอนโด ปากซอยเพชรเกษม 46/2",37,154,222,236,458
2618,"บางหว้า","เขตภาษีเจริญ",102201,"เต็นท์หน้าเดอะคีย์คอนโด ปากซอยเพชรเกษม 46/2",38,130,178,227,405
2619,"บางหว้า","เขตภาษีเจริญ",102201,"เต็นท์หน้าเดอะคีย์คอนโด ปากซอยเพชรเกษม 46/2",39,265,254,283,537
2620,"บางหว้า","เขตภาษีเจริญ",102201,"เต็นท์หน้าเดอะคีย์คอนโด ปากซอยเพชรเกษม 46/2",40,169,234,283,517
2621,"บางหว้า","เขตภาษีเจริญ",102201,"อาคารจอดรถศูนย์บริการรถยนต์ซูซูกิ (ใกล้ซอยเพชรเกษม 31)",41,244,228,288,516
2622,"บางหว้า","เขตภาษีเจริญ",102201,"เต็นท์ในปั๊มน้ำมัน ปตท. ปากซอยเพชรเกษม 50",42,259,273,310,583
2623,"บางหว้า","เขตภาษีเจริญ",102201,"เต็นท์ปากซอยเพชรเกษม 50/2",43,196,299,360,659
2624,"บางหว้า","เขตภาษีเจริญ",102201,"เต็นท์บริเวณทางเข้าศูนย์สรรพสินค้าซีคอน บางแค",44,337,214,272,486
2625,"บางหว้า","เขตภาษีเจริญ",102201,"เต็นท์บริเวณทางเข้าศูนย์สรรพสินค้าซีคอน บางแค",45,173,204,267,471
2626,"บางหว้า","เขตภาษีเจริญ",102201,"เต็นท์บริเวณทางเข้าศูนย์สรรพสินค้าซีคอน บางแค",46,219,252,307,559
2627,"บางหว้า","เขตภาษีเจริญ",102201,"เต็นท์บริเวณทางเข้าศูนย์สรรพสินค้าซีคอน บางแค",47,156,253,270,523
2628,"บางหว้า","เขตภาษีเจริญ",102201,"โรงอาหารศูนย์พัฒนาการจัดสวัสดิการสังคมผู้สูงอายุ บ้านบางแค",48,122,213,276,489
2629,"บางหว้า","เขตภาษีเจริญ",102201,"เต็นท์ตรงข้ามไอคอนโด ซอยเพชรเกษม 39 (โรงเรียนนีรนารถเดิม)",49,288,204,282,486
2630,"บางหว้า","เขตภาษีเจริญ",102201,"เต็นท์ตรงข้ามไอคอนโด ซอยเพชรเกษม 39 (โรงเรียนนีรนารถเดิม)",50,99,223,247,470
2631,"บางหว้า","เขตภาษีเจริญ",102201,"เต็นท์ปากซอยเพชรเกษม 58/1",51,311,243,370,613
2632,"บางด้วน","เขตภาษีเจริญ",102202,"เต็นท์โรงเรียนวัดจันทร์ประดิษฐาราม",1,139,254,306,560
2633,"บางด้วน","เขตภาษีเจริญ",102202,"เต็นท์โรงเรียนวัดจันทร์ประดิษฐาราม",2,241,247,310,557
2634,"บางด้วน","เขตภาษีเจริญ",102202,"เต็นท์โรงเรียนวัดจันทร์ประดิษฐาราม",3,131,268,323,591
2635,"บางด้วน","เขตภาษีเจริญ",102202,"เต็นท์โรงเรียนวัดจันทร์ประดิษฐาราม",4,126,244,321,565
2636,"บางด้วน","เขตภาษีเจริญ",102202,"เต็นท์โรงเรียนวัดจันทร์ประดิษฐาราม",5,144,287,325,612
2637,"บางด้วน","เขตภาษีเจริญ",102202,"เต็นท์โรงเรียนวัดจันทร์ประดิษฐาราม",6,148,261,285,546
2638,"บางด้วน","เขตภาษีเจริญ",102202,"เต็นท์โรงเรียนวัดจันทร์ประดิษฐาราม",7,230,254,343,597
2639,"บางด้วน","เขตภาษีเจริญ",102202,"เต็นท์โรงเรียนวัดจันทร์ประดิษฐาราม",8,208,264,326,590
2640,"บางด้วน","เขตภาษีเจริญ",102202,"เต็นท์โรงเรียนวัดจันทร์ประดิษฐาราม",9,113,232,203,435
2641,"บางด้วน","เขตภาษีเจริญ",102202,"เต็นท์โรงเรียนวัดจันทร์ประดิษฐาราม",10,198,247,289,536
2642,"บางด้วน","เขตภาษีเจริญ",102202,"เต็นท์ศูนย์บริการสาธารณสุข 47 สาขายายทวดมาก ตันศิริอนุสรณ์ (ซอยร่วมพัฒนา 4-7)",11,162,292,310,602
2643,"บางด้วน","เขตภาษีเจริญ",102202,"เต็นท์ศูนย์บริการสาธารณสุข 47 สาขายายทวดมาก ตันศิริอนุสรณ์ (ซอยร่วมพัฒนา 4-7)",12,211,263,338,601
2644,"บางด้วน","เขตภาษีเจริญ",102202,"โรงจอดรถคริสตจักรสานสัมพันธ์ธนบุรี ใกล้ร้านอาหารตะเกียงดาว",13,155,205,242,447
2645,"บางด้วน","เขตภาษีเจริญ",102202,"โรงจอดรถคริสตจักรสานสัมพันธ์ธนบุรี ใกล้ร้านอาหารตะเกียงดาว",14,230,231,320,551
2646,"บางด้วน","เขตภาษีเจริญ",102202,"โรงจอดรถคริสตจักรสานสัมพันธ์ธนบุรี ใกล้ร้านอาหารตะเกียงดาว",15,150,251,294,545
2647,"บางด้วน","เขตภาษีเจริญ",102202,"ศาลเจ้าเจี่ยเทพธิดา",16,286,309,363,672
2648,"บางด้วน","เขตภาษีเจริญ",102202,"ศาลเจ้าเจี่ยเทพธิดา",17,225,313,354,667
2649,"บางด้วน","เขตภาษีเจริญ",102202,"ศาลเจ้าเจี่ยเทพธิดา",18,245,283,376,659
2650,"บางด้วน","เขตภาษีเจริญ",102202,"ศาลเจ้าเจี่ยเทพธิดา",19,254,297,386,683
2651,"บางด้วน","เขตภาษีเจริญ",102202,"ศาลาอเนกประสงค์ชุมชนวัดจันทร์ประดิษฐาราม เขต 1 หมู่ 3",20,116,220,246,466
2652,"บางด้วน","เขตภาษีเจริญ",102202,"เต็นท์บริเวณตลาดแม่อุทัย ซอยเพชรเกษม 58 แยก 10",21,117,222,272,494
2653,"บางด้วน","เขตภาษีเจริญ",102202,"ศาลาอเนกประสงค์ชุมชนแป๊ะกงร่วมใจ",22,163,259,256,515
2654,"บางด้วน","เขตภาษีเจริญ",102202,"โรงเรียนอนุบาลดารวี",23,219,287,391,678
2655,"บางด้วน","เขตภาษีเจริญ",102202,"โรงเรียนผดุงกิจวิทยา",24,127,196,220,416
2656,"บางด้วน","เขตภาษีเจริญ",102202,"โรงเรียนผดุงกิจวิทยา",25,161,217,242,459
2657,"บางด้วน","เขตภาษีเจริญ",102202,"โรงเรียนอนุบาลบ้านสวน",26,186,240,321,561
2658,"บางด้วน","เขตภาษีเจริญ",102202,"โรงเรียนอนุบาลบ้านสวน",27,205,274,319,593
2659,"บางด้วน","เขตภาษีเจริญ",102202,"เต็นท์ลานจอดรถยุวพุทธิกสมาคมแห่งประเทศไทยในพระบรมราชูปถัมภ์ซอยเพชรเกษม 54 แยก 6",28,93,194,214,408
2660,"บางด้วน","เขตภาษีเจริญ",102202,"เต็นท์ลานจอดรถยุวพุทธิกสมาคมแห่งประเทศไทยในพระบรมราชูปถัมภ์ซอยเพชรเกษม 54 แยก 6",29,117,160,196,356
2661,"บางด้วน","เขตภาษีเจริญ",102202,"เต็นท์บริเวณที่จอดรถห้องสมุดเพื่อการเรียนรู้ ภาษีเจริญ",30,193,325,392,717
2662,"บางด้วน","เขตภาษีเจริญ",102202,"โรงจอดรถบ้านเลขที่ 1 ซอยเพชรเกษม 56",31,64,94,119,213
2663,"บางด้วน","เขตภาษีเจริญ",102202,"เต็นท์สนามเด็กเล่นชุมชนริมคลองราชมนตรี หมู่ 10",32,184,245,288,533
2664,"บางด้วน","เขตภาษีเจริญ",102202,"เต็นท์สนามเด็กเล่นชุมชนริมคลองราชมนตรี หมู่ 10",33,145,236,303,539
2665,"บางด้วน","เขตภาษีเจริญ",102202,"เต็นท์สนามเด็กเล่นชุมชนริมคลองราชมนตรี หมู่ 10",34,163,259,277,536
2666,"บางด้วน","เขตภาษีเจริญ",102202,"เต็นท์หน้า เดอะโพรดิจี้คอนโด ซอยเพชรเกษม 62 (บ่อหลาเดิม)",35,169,296,331,627
2667,"บางด้วน","เขตภาษีเจริญ",102202,"เต็นท์หน้า เดอะโพรดิจี้คอนโด ซอยเพชรเกษม 62 (บ่อหลาเดิม)",36,295,315,335,650
2668,"บางด้วน","เขตภาษีเจริญ",102202,"โรงเรียนจันทร์ประดิษฐารามวิทยาคม",37,204,255,332,587
2669,"บางด้วน","เขตภาษีเจริญ",102202,"โรงเรียนจันทร์ประดิษฐารามวิทยาคม",38,158,256,271,527
2670,"บางด้วน","เขตภาษีเจริญ",102202,"โรงเรียนจันทร์ประดิษฐารามวิทยาคม",39,163,276,301,577
2671,"บางด้วน","เขตภาษีเจริญ",102202,"โรงเรียนจันทร์ประดิษฐารามวิทยาคม",40,158,258,303,561
2672,"บางด้วน","เขตภาษีเจริญ",102202,"โรงเรียนจันทร์ประดิษฐารามวิทยาคม",41,177,250,319,569
2673,"บางจาก","เขตภาษีเจริญ",102206,"เต็นท์วัดโบสถ์อินทรสารเพชร",1,254,251,283,534
2674,"บางจาก","เขตภาษีเจริญ",102206,"เต็นท์วัดโบสถ์อินทรสารเพชร",2,248,271,341,612
2675,"บางจาก","เขตภาษีเจริญ",102206,"เต็นท์วัดโบสถ์อินทรสารเพชร",3,246,221,324,545
2676,"บางจาก","เขตภาษีเจริญ",102206,"ศาลาวัดยาง",4,118,195,215,410
2677,"บางจาก","เขตภาษีเจริญ",102206,"เต็นท์บริเวณลานอเนกประสงค์มหาวิทยาลัยสยาม (ลานหัวช้าง)",5,179,278,328,606
2678,"บางจาก","เขตภาษีเจริญ",102206,"เต็นท์บริเวณลานอเนกประสงค์มหาวิทยาลัยสยาม (ลานหัวช้าง)",6,244,303,345,648
2679,"บางจาก","เขตภาษีเจริญ",102206,"เต็นท์บริเวณลานอเนกประสงค์มหาวิทยาลัยสยาม (ลานหัวช้าง)",7,184,234,325,559
2680,"บางจาก","เขตภาษีเจริญ",102206,"เต็นท์บริเวณบ้านเลขที่ 33 ซอยเพชรเกษม 42",8,149,177,248,425
2681,"บางจาก","เขตภาษีเจริญ",102206,"เต็นท์บริเวณบ้านเลขที่ 33 ซอยเพชรเกษม 42",9,126,198,215,413
2682,"บางจาก","เขตภาษีเจริญ",102206,"โรงเรียนบางจาก (โกมลประเสริฐอุทิศ)",10,173,223,264,487
2683,"บางจาก","เขตภาษีเจริญ",102206,"โรงเรียนบางจาก (โกมลประเสริฐอุทิศ)",11,179,252,288,540
2684,"บางจาก","เขตภาษีเจริญ",102206,"เต็นท์ข้างบ้านโต๊ะหมู่บูชา ปลายซอยเพชรเกษม 40",12,315,372,457,829
2685,"บางแวก","เขตภาษีเจริญ",102207,"บริเวณศาลาการเปรียญวัดตะโน",1,183,324,357,681
2686,"บางแวก","เขตภาษีเจริญ",102207,"บริเวณศาลาการเปรียญวัดตะโน",2,255,314,368,682
2687,"บางแวก","เขตภาษีเจริญ",102207,"วิทยาลัยพณิชยการธนบุรี",3,126,213,255,468
2688,"บางแวก","เขตภาษีเจริญ",102207,"วิทยาลัยพณิชยการธนบุรี",4,191,224,281,505
2689,"บางแวก","เขตภาษีเจริญ",102207,"โรงเรียนวัดโตนด",5,163,256,321,577
2690,"บางแวก","เขตภาษีเจริญ",102207,"ศูนย์สุขภาพชุมชน ชุมชนหมู่ 4 บางแวก",6,112,177,206,383
2691,"บางแวก","เขตภาษีเจริญ",102207,"เต็นท์ศูนย์โตโยต้า สาขาราชพฤกษ์ ใกล้หมู่บ้านลดาวัลย์",7,298,256,368,624
2692,"บางแวก","เขตภาษีเจริญ",102207,"โรงเรียนวัดชัยฉิมพลี",8,256,323,360,683
2693,"บางแวก","เขตภาษีเจริญ",102207,"โรงเรียนวัดชัยฉิมพลี",9,262,320,403,723
2694,"บางแวก","เขตภาษีเจริญ",102207,"โรงเรียนวัดชัยฉิมพลี",10,228,306,398,704
2695,"บางแวก","เขตภาษีเจริญ",102207,"เต็นท์โรงเรียนไชยฉิมพลีวิทยาคม (มัธยม)",11,414,269,361,630
2696,"บางแวก","เขตภาษีเจริญ",102207,"เต็นท์โรงเรียนไชยฉิมพลีวิทยาคม (มัธยม)",12,244,300,368,668
2697,"บางแวก","เขตภาษีเจริญ",102207,"เต็นท์โรงเรียนไชยฉิมพลีวิทยาคม (มัธยม)",13,289,289,358,647
2698,"บางแวก","เขตภาษีเจริญ",102207,"เต็นท์โรงเรียนไชยฉิมพลีวิทยาคม (มัธยม)",14,164,310,332,642
2699,"บางแวก","เขตภาษีเจริญ",102207,"เต็นท์โรงเรียนไชยฉิมพลีวิทยาคม (มัธยม)",15,219,291,358,649
2700,"บางแวก","เขตภาษีเจริญ",102207,"เต็นท์บริเวณปั๊มน้ำมัน ปตท. ตรงข้ามซอยบางแวก 60",16,263,303,385,688
2701,"บางแวก","เขตภาษีเจริญ",102207,"เต็นท์บริเวณปั๊มน้ำมัน ปตท. ตรงข้ามซอยบางแวก 60",17,293,301,393,694
2702,"บางแวก","เขตภาษีเจริญ",102207,"โรงเรียนวัดกำแพง",18,201,225,278,503
2703,"บางแวก","เขตภาษีเจริญ",102207,"โรงเรียนวัดกำแพง",19,206,245,262,507
2704,"บางแวก","เขตภาษีเจริญ",102207,"โรงเรียนวัดกำแพง",20,155,223,270,493
2705,"บางแวก","เขตภาษีเจริญ",102207,"โรงเรียนวัดกำแพง",21,167,230,258,488
2706,"บางแวก","เขตภาษีเจริญ",102207,"โรงเรียนวัดกำแพง",22,281,218,281,499
2707,"บางแวก","เขตภาษีเจริญ",102207,"บ้านสวนสหคลีนิก (ปากซอยบางแวก 22)",23,144,144,217,361
2708,"บางแวก","เขตภาษีเจริญ",102207,"บ้านสวนสหคลีนิก (ปากซอยบางแวก 22)",24,136,162,202,364
2709,"บางแวก","เขตภาษีเจริญ",102207,"โรงเรียนอนุบาลธีรานุรักษ์",25,162,196,233,429
2710,"บางแวก","เขตภาษีเจริญ",102207,"โรงเรียนอนุบาลธีรานุรักษ์",26,189,235,266,501
2711,"บางแวก","เขตภาษีเจริญ",102207,"เต็นท์วัดปากน้ำฝั่งใต้",27,195,311,347,658
2712,"คลองขวาง","เขตภาษีเจริญ",102208,"โรงเรียนวัดตะล่อม",1,205,216,288,504
2713,"คลองขวาง","เขตภาษีเจริญ",102208,"เต็นท์หน้าปากซอยพุทธมณฑลสาย 1 ซอย 13",2,187,283,340,623
2714,"คลองขวาง","เขตภาษีเจริญ",102208,"เต็นท์หน้าปากซอยพุทธมณฑลสาย 1 ซอย 13",3,137,271,261,532
2715,"คลองขวาง","เขตภาษีเจริญ",102208,"เต็นท์หน้าปากซอยพุทธมณฑลสาย 1 ซอย 13",4,135,216,260,476
2716,"คลองขวาง","เขตภาษีเจริญ",102208,"เต็นท์ข้างสโมสรหมู่บ้านนิศาชล",5,261,312,380,692
2717,"คลองขวาง","เขตภาษีเจริญ",102208,"เต็นท์ข้างสโมสรหมู่บ้านนิศาชล",6,275,323,402,725
2718,"คลองขวาง","เขตภาษีเจริญ",102208,"เต็นท์ข้างสโมสรหมู่บ้านนิศาชล",7,278,344,410,754
2719,"คลองขวาง","เขตภาษีเจริญ",102208,"ศูนย์สุขภาพชุมชนพูนบำเพ็ญ ซอยบางแวก 116",8,121,175,238,413
2720,"คลองขวาง","เขตภาษีเจริญ",102208,"ศูนย์สุขภาพชุมชนพูนบำเพ็ญ ซอยบางแวก 116",9,130,190,223,413
2721,"คลองขวาง","เขตภาษีเจริญ",102208,"เต็นท์หมู่บ้านศุภาลัย",10,323,338,460,798
2722,"คลองขวาง","เขตภาษีเจริญ",102208,"โรงอาหารโรงเรียนเซ็นต์ปีเตอร์ธนบุรี (ตรีมิตรวิทยา)",11,194,327,415,742
2723,"คลองขวาง","เขตภาษีเจริญ",102208,"โรงเรียนวัดมะพร้าวเตี้ย",12,194,344,397,741
2724,"คลองขวาง","เขตภาษีเจริญ",102208,"โรงเรียนวัดมะพร้าวเตี้ย",13,237,355,383,738
2725,"คลองขวาง","เขตภาษีเจริญ",102208,"เต็นท์หน้าร้านเซเว่นอีเลฟเว่น ปากซอยราชมนตรี 6",14,225,308,328,636
2726,"ปากคลองภาษีเจริญ","เขตภาษีเจริญ",102209,"โรงเรียนสตรีวัดอัปสรสวรรค์",1,206,345,384,729
2727,"ปากคลองภาษีเจริญ","เขตภาษีเจริญ",102209,"โรงเรียนสตรีวัดอัปสรสวรรค์",2,191,317,392,709
2728,"ปากคลองภาษีเจริญ","เขตภาษีเจริญ",102209,"โรงเรียนวัดนาคปรก",3,141,218,232,450
2729,"ปากคลองภาษีเจริญ","เขตภาษีเจริญ",102209,"โรงเรียนวัดนาคปรก",4,126,173,245,418
2730,"ปากคลองภาษีเจริญ","เขตภาษีเจริญ",102209,"เต็นท์วัดเพลง",5,159,244,296,540
2731,"ปากคลองภาษีเจริญ","เขตภาษีเจริญ",102209,"เต็นท์วัดเพลง",6,173,259,308,567
2732,"ปากคลองภาษีเจริญ","เขตภาษีเจริญ",102209,"เต็นท์ข้างศาลหมู่บ้านเพิ่มทรัพย์ ซอยเทอดไท 48",7,642,394,540,934
2733,"ปากคลองภาษีเจริญ","เขตภาษีเจริญ",102209,"โรงเรียนสถาพรศึกษา",8,106,182,218,400
2734,"ปากคลองภาษีเจริญ","เขตภาษีเจริญ",102209,"โรงเรียนสถาพรศึกษา",9,186,196,262,458
2735,"ปากคลองภาษีเจริญ","เขตภาษีเจริญ",102209,"โรงเรียนวัดนวลนรดิศ",10,157,211,264,475
2736,"ปากคลองภาษีเจริญ","เขตภาษีเจริญ",102209,"โรงเรียนวัดนวลนรดิศ",11,127,230,256,486
2737,"ปากคลองภาษีเจริญ","เขตภาษีเจริญ",102209,"โรงเรียนสุภาคมศึกษา",12,155,223,288,511
2738,"ปากคลองภาษีเจริญ","เขตภาษีเจริญ",102209,"โรงเรียนวัดทองศาลางาม",13,166,284,306,590
2739,"ปากคลองภาษีเจริญ","เขตภาษีเจริญ",102209,"โรงเรียนวัดทองศาลางาม",14,175,259,335,594
2740,"ปากคลองภาษีเจริญ","เขตภาษีเจริญ",102209,"โรงเรียนวัดทองศาลางาม",15,180,244,314,558
2741,"ปากคลองภาษีเจริญ","เขตภาษีเจริญ",102209,"โรงเรียนวัดทองศาลางาม",16,200,259,309,568
2742,"ปากคลองภาษีเจริญ","เขตภาษีเจริญ",102209,"โรงเรียนวัดทองศาลางาม",17,202,257,326,583
2743,"ปากคลองภาษีเจริญ","เขตภาษีเจริญ",102209,"โรงเรียนวัดทองศาลางาม",18,177,234,298,532
2744,"ปากคลองภาษีเจริญ","เขตภาษีเจริญ",102209,"โรงเรียนวัดประดู่บางจาก (พ่วงอุทิศ)",19,156,177,229,406
2745,"ปากคลองภาษีเจริญ","เขตภาษีเจริญ",102209,"โรงเรียนวัดประดู่บางจาก (พ่วงอุทิศ)",20,115,166,153,319
2746,"ปากคลองภาษีเจริญ","เขตภาษีเจริญ",102209,"เต็นท์ปั๊มน้ำมันพีที ใกล้ซอยเพชรเกษม 25",21,285,363,465,828
2747,"ปากคลองภาษีเจริญ","เขตภาษีเจริญ",102209,"เต็นท์ปั๊มน้ำมันพีที ใกล้ซอยเพชรเกษม 25",22,748,339,517,856
2748,"คูหาสวรรค์","เขตภาษีเจริญ",102210,"ศาลาวัดยาง",1,217,358,410,768
2749,"คูหาสวรรค์","เขตภาษีเจริญ",102210,"โรงเรียนเปี่ยมสุวรรณวิทยา",2,128,221,246,467
2750,"คูหาสวรรค์","เขตภาษีเจริญ",102210,"โรงเรียนเปี่ยมสุวรรณวิทยา",3,168,243,276,519
2751,"คูหาสวรรค์","เขตภาษีเจริญ",102210,"โรงเรียนเปี่ยมสุวรรณวิทยา",4,106,203,249,452
2752,"คูหาสวรรค์","เขตภาษีเจริญ",102210,"เต็นท์วัดโบสถ์อินทรสารเพชร",5,164,289,382,671
2753,"คูหาสวรรค์","เขตภาษีเจริญ",102210,"วิทยาลัยพณิชยการธนบุรี",6,142,256,301,557
2754,"คูหาสวรรค์","เขตภาษีเจริญ",102210,"โรงเรียนวัดวิจิตรการนิมิตร",7,186,319,369,688
2755,"คูหาสวรรค์","เขตภาษีเจริญ",102210,"โรงเรียนวัดวิจิตรการนิมิตร",8,225,295,360,655
2756,"คูหาสวรรค์","เขตภาษีเจริญ",102210,"โรงเรียนวัดประดู่บางจาก (พ่วงอุทิศ)",9,60,90,119,209
2757,"หนองแขม","เขตหนองแขม",102302,"เต็นท์ทางเข้าหมู่บ้านพุทธชาด (ซอยเพชรเกษม 81)",1,355,340,451,791
2758,"หนองแขม","เขตหนองแขม",102302,"เต็นท์ทางเข้าหมู่บ้านพุทธชาด (ซอยเพชรเกษม 81)",2,288,313,390,703
2759,"หนองแขม","เขตหนองแขม",102302,"เต็นท์ทางเข้าหมู่บ้านพุทธชาด (ซอยเพชรเกษม 81)",3,264,282,391,673
2760,"หนองแขม","เขตหนองแขม",102302,"เต็นท์ลานกีฬาชุมชนหรรษา 1 (ซอยเพชรเกษม 81)",4,216,296,365,661
2761,"หนองแขม","เขตหนองแขม",102302,"เต็นท์ลานกีฬาชุมชนหรรษา 1 (ซอยเพชรเกษม 81)",5,136,265,308,573
2762,"หนองแขม","เขตหนองแขม",102302,"เต็นท์ลานกีฬาชุมชนหรรษา 1 (ซอยเพชรเกษม 81)",6,175,305,378,683
2763,"หนองแขม","เขตหนองแขม",102302,"เต็นท์หน้าสโมสรหมู่บ้านชัยพฤกษ์ (ซอยเพชรเกษม 81)",7,353,338,482,820
2764,"หนองแขม","เขตหนองแขม",102302,"เต็นท์ลานกีฬาหมู่บ้านพุดตาน (ซอยเพชรเกษม 81)",8,290,309,431,740
2765,"หนองแขม","เขตหนองแขม",102302,"เต็นท์ลานกีฬาหมู่บ้านพุดตาน (ซอยเพชรเกษม 81)",9,279,281,455,736
2766,"หนองแขม","เขตหนองแขม",102302,"เต็นท์ลานกีฬาหมู่บ้านพุดตาน (ซอยเพชรเกษม 81)",10,270,351,412,763
2767,"หนองแขม","เขตหนองแขม",102302,"เต็นท์ลานกีฬาหมู่บ้านพุดตาน (ซอยเพชรเกษม 81)",11,286,311,431,742
2768,"หนองแขม","เขตหนองแขม",102302,"เต็นท์ลานจอดรถเพชรเอกชัยพลาซ่า (ซอยเพชรเกษม 81)",12,405,366,536,902
2769,"หนองแขม","เขตหนองแขม",102302,"เต็นท์ลานจอดรถเพชรเอกชัยพลาซ่า (ซอยเพชรเกษม 81)",13,343,372,493,865
2770,"หนองแขม","เขตหนองแขม",102302,"เต็นท์ลานจอดรถเพชรเอกชัยพลาซ่า (ซอยเพชรเกษม 81)",14,247,374,456,830
2771,"หนองแขม","เขตหนองแขม",102302,"เต็นท์หน้าซอยเลียบฯ ฝั่งเหนือ 9",15,193,342,394,736
2772,"หนองแขม","เขตหนองแขม",102302,"เต็นท์หน้าซอยเลียบฯ ฝั่งเหนือ 9",16,264,301,414,715
2773,"หนองแขม","เขตหนองแขม",102302,"เต็นท์ลานกีฬาบ้านเอื้ออาทร (ซอยเลียบฯ ฝั่งเหนือ 34)",17,350,353,441,794
2774,"หนองแขม","เขตหนองแขม",102302,"เต็นท์ลานกีฬาบ้านเอื้ออาทร (ซอยเลียบฯ ฝั่งเหนือ 34)",18,350,358,404,762
2775,"หนองแขม","เขตหนองแขม",102302,"เต็นท์ลานกีฬาบ้านเอื้ออาทร (ซอยเลียบฯ ฝั่งเหนือ 34)",19,350,363,391,754
2776,"หนองแขม","เขตหนองแขม",102302,"เต็นท์ลานกีฬาบ้านเอื้ออาทร (ซอยเลียบฯ ฝั่งเหนือ 34)",20,368,394,451,845
2777,"หนองแขม","เขตหนองแขม",102302,"โรงเรียนวัดหนองแขม (ถนนเลียบคลองภาษีเจริญฝั่งใต้)",21,237,357,350,707
2778,"หนองแขม","เขตหนองแขม",102302,"โรงเรียนวัดหนองแขม (ถนนเลียบคลองภาษีเจริญฝั่งใต้)",22,264,350,426,776
2779,"หนองแขม","เขตหนองแขม",102302,"โรงเรียนวัดหนองแขม (ถนนเลียบคลองภาษีเจริญฝั่งใต้)",23,263,320,424,744
2780,"หนองแขม","เขตหนองแขม",102302,"โรงเรียนวัดหนองแขม (ถนนเลียบคลองภาษีเจริญฝั่งใต้)",24,177,343,421,764
2781,"หนองแขม","เขตหนองแขม",102302,"โรงเรียนวัดศรีนวลธรรมวิมล (ถนนหนองแขม-วัดศรีนวล)",25,216,321,405,726
2782,"หนองแขม","เขตหนองแขม",102302,"เต็นท์หน้าบริษัท ควอลิตี้ ไพพ์ จำกัด (ถนนบางบอน 5)",26,214,331,393,724
2783,"หนองแขม","เขตหนองแขม",102302,"เต็นท์หน้าบริษัท ควอลิตี้ ไพพ์ จำกัด (ถนนบางบอน 5)",27,222,343,359,702
2784,"หนองแขม","เขตหนองแขม",102302,"เต็นท์หน้าบริษัท ควอลิตี้ ไพพ์ จำกัด (ถนนบางบอน 5)",28,307,336,438,774
2785,"หนองแขม","เขตหนองแขม",102302,"เต็นท์หน้าทางเข้าหมู่บ้านเพชรมณฑลกรีน (ถนนบางบอน 5)",29,277,337,456,793
2786,"หนองแขม","เขตหนองแขม",102302,"เต็นท์ลานอเนกประสงค์หมู่บ้านเพชรมณฑลกรีน (ถนนบางบอน 5)",30,299,353,416,769
2787,"หนองแขม","เขตหนองแขม",102302,"ศาลาเอนกประสงค์หมู่บ้านพระปิ่น 4 (ถนนบางบอน 5)",31,258,304,416,720
2788,"หนองแขม","เขตหนองแขม",102302,"เต็นท์ลานกีฬาหมู่บ้านพระปิ่น 4 (ถนนบางบอน 5)",32,266,335,382,717
2789,"หนองแขม","เขตหนองแขม",102302,"เต็นท์ศาลเจ้าแม่กวนอิม (ถนนบางบอน 5 สายเดิม)",33,203,374,385,759
2790,"หนองแขม","เขตหนองแขม",102302,"เต็นท์ศาลเจ้าแม่กวนอิม (ถนนบางบอน 5 สายเดิม)",34,186,391,419,810
2791,"หนองแขม","เขตหนองแขม",102302,"เต็นท์หมู่บ้านเพชรสยาม (ซอยเลียบฯ ฝั่งใต้ 5/3)",35,376,460,538,998
2792,"หนองแขม","เขตหนองแขม",102302,"เต็นท์หมู่บ้านเพชรสยาม (ซอยเลียบฯ ฝั่งใต้ 5/3)",36,452,458,592,1050
2793,"หนองแขม","เขตหนองแขม",102302,"เต็นท์ลานอเนกประสงค์หมู่บ้าน พี เอส (ซอยเลียบฯ ฝั่งใต้ 5/1)",37,177,225,266,491
2794,"หนองแขม","เขตหนองแขม",102302,"เต็นท์ลานอเนกประสงค์หมู่บ้าน พี เอส (ซอยเลียบฯ ฝั่งใต้ 5/1)",38,158,196,264,460
2795,"หนองแขม","เขตหนองแขม",102302,"ศาลาวัดหลักสาม (ถนนเลียบคลองภาษีเจริญฝั่งใต้)",39,366,361,465,826
2796,"หนองแขม","เขตหนองแขม",102302,"ศาลาวัดหลักสาม (ถนนเลียบคลองภาษีเจริญฝั่งใต้)",40,200,371,409,780
2797,"หนองแขม","เขตหนองแขม",102302,"เต็นท์บริเวณวัดหลักสาม (ถนนเลียบคลองภาษีเจริญฝั่งใต้)",41,328,338,436,774
2798,"หนองแขม","เขตหนองแขม",102302,"เต็นท์บริเวณวัดหลักสาม (ถนนเลียบคลองภาษีเจริญฝั่งใต้)",42,185,333,388,721
2799,"หนองแขม","เขตหนองแขม",102302,"เต็นท์ข้างโรงงานนาโกย่า เดิม (ถนนเลียบคลองภาษีเจริญฝั่งใต้)",43,263,325,395,720
2800,"หนองแขม","เขตหนองแขม",102302,"เต็นท์ข้างโรงงานนาโกย่า เดิม (ถนนเลียบคลองภาษีเจริญฝั่งใต้)",44,221,383,427,810
2801,"หนองแขม","เขตหนองแขม",102302,"เต็นท์ลานว่างข้างซอยเลียบฯ ฝั่งใต้ 2",45,295,351,409,760
2802,"หนองแขม","เขตหนองแขม",102302,"เต็นท์ลานว่างข้างซอยเลียบฯ ฝั่งใต้ 2",46,227,326,367,693
2803,"หนองแขม","เขตหนองแขม",102302,"เต็นท์ลานว่างข้างซอยเลียบฯ ฝั่งใต้ 2",47,209,304,381,685
2804,"หนองแขม","เขตหนองแขม",102302,"เต็นท์ที่ว่างข้างโรงเรียนกรพิทักษ์ศึกษา (ถนนบางบอน 3)",48,297,376,424,800
2805,"หนองแขม","เขตหนองแขม",102302,"เต็นท์ที่ว่างข้างโรงเรียนกรพิทักษ์ศึกษา (ถนนบางบอน 3)",49,325,333,432,765
2806,"หนองแขม","เขตหนองแขม",102302,"เต็นท์ที่ว่างข้างโรงเรียนกรพิทักษ์ศึกษา (ถนนบางบอน 3)",50,283,367,466,833
2807,"หนองแขม","เขตหนองแขม",102302,"เต็นท์ลานอเนกประสงค์หมู่บ้านพฤกษาการ์เด้นโฮม(ซอยเลียบฯ ฝั่งเหนือ 8)",51,225,282,314,596
2808,"หนองแขม","เขตหนองแขม",102302,"เต็นท์ลานอเนกประสงค์หมู่บ้านพฤกษาการ์เด้นโฮม(ซอยเลียบฯ ฝั่งเหนือ 8)",52,210,318,339,657
2809,"หนองแขม","เขตหนองแขม",102302,"เต็นท์ลานกีฬาหมู่บ้านอรุณทอง 2 (ซอยเลียบฯ ฝั่งเหนือ 8/1)",53,237,273,356,629
2810,"หนองแขม","เขตหนองแขม",102302,"เต็นท์ลานกีฬาหมู่บ้านอรุณทอง 2 (ซอยเลียบฯ ฝั่งเหนือ 8/1)",54,241,258,362,620
2811,"หนองแขม","เขตหนองแขม",102302,"เต็นท์ลานกีฬาหมู่บ้านอรุณทอง 2 (ซอยเลียบฯ ฝั่งเหนือ 8/1)",55,234,259,348,607
2812,"หนองแขม","เขตหนองแขม",102302,"โรงเรียนประชาบำรุง (ถนนเลียบคลองภาษีเจริญฝั่งเหนือ)",56,366,397,518,915
2813,"หนองแขม","เขตหนองแขม",102302,"โรงเรียนประชาบำรุง (ถนนเลียบคลองภาษีเจริญฝั่งเหนือ)",57,372,400,492,892
2814,"หนองแขม","เขตหนองแขม",102302,"โรงเรียนประชาบำรุง (ถนนเลียบคลองภาษีเจริญฝั่งเหนือ)",58,436,402,548,950
2815,"หนองแขม","เขตหนองแขม",102302,"โรงเรียนประชาบำรุง (ถนนเลียบคลองภาษีเจริญฝั่งเหนือ)",59,322,385,446,831
2816,"หนองแขม","เขตหนองแขม",102302,"โรงเรียนประชาบำรุง (ถนนเลียบคลองภาษีเจริญฝั่งเหนือ)",60,267,361,432,793
2817,"หนองแขม","เขตหนองแขม",102302,"โรงเรียนประชาบำรุง (ถนนเลียบคลองภาษีเจริญฝั่งเหนือ)",61,289,324,477,801
2818,"หนองแขม","เขตหนองแขม",102302,"โรงเรียนประชาบำรุง (ถนนเลียบคลองภาษีเจริญฝั่งเหนือ)",62,264,357,426,783
2819,"หนองแขม","เขตหนองแขม",102302,"เต็นท์สวนหย่อมหมู่บ้านธนาภิรมย์ (ถนนเลียบฯ ฝั่งเหนือ)",63,353,376,510,886
2820,"หนองแขม","เขตหนองแขม",102302,"อาคารสวัสดิการข้าราชการ กทม. (ถนนเลียบฯ ฝั่งเหนือ)",64,204,271,323,594
2821,"หนองแขม","เขตหนองแขม",102302,"อาคารสวัสดิการข้าราชการ กทม. (ถนนเลียบฯ ฝั่งเหนือ)",65,213,305,315,620
2822,"หนองแขม","เขตหนองแขม",102302,"อาคารสวัสดิการข้าราชการ กทม. (ถนนเลียบฯ ฝั่งเหนือ)",66,228,267,338,605
2823,"หนองแขม","เขตหนองแขม",102302,"อาคารสวัสดิการข้าราชการ กทม. (ถนนเลียบฯ ฝั่งเหนือ)",67,271,299,376,675
2824,"หนองแขม","เขตหนองแขม",102302,"อาคารสวัสดิการข้าราชการ กทม. (ถนนเลียบฯ ฝั่งเหนือ)",68,198,284,352,636
2825,"หนองแขม","เขตหนองแขม",102302,"เต็นท์ลานกีฬาสวัสดิการ ถนนสวัสดิการ 1 (ซอยเพชรเกษม 77)",69,230,311,372,683
2826,"หนองแขม","เขตหนองแขม",102302,"เต็นท์ลานกีฬาสวัสดิการ ถนนสวัสดิการ 1 (ซอยเพชรเกษม 77)",70,177,319,386,705
2827,"หนองแขม","เขตหนองแขม",102302,"เต็นท์ลานกีฬาสวัสดิการ ถนนสวัสดิการ 1 (ซอยเพชรเกษม 77)",71,169,351,358,709
2828,"หนองแขม","เขตหนองแขม",102302,"เต็นท์ลานกีฬาสวัสดิการ ถนนสวัสดิการ 1 (ซอยเพชรเกษม 77)",72,230,329,377,706
2829,"หนองแขม","เขตหนองแขม",102302,"เต็นท์ลานกีฬาสวัสดิการ ถนนสวัสดิการ 1 (ซอยเพชรเกษม 77)",73,295,332,388,720
2830,"หนองแขม","เขตหนองแขม",102302,"เต็นท์ลานอเนกประสงค์หมู่บ้านวังทอง ถนนสวัสดิการ 2(ซอยเพชรเกษม 77)",74,188,238,301,539
2831,"หนองแขม","เขตหนองแขม",102302,"เต็นท์ลานอเนกประสงค์หมู่บ้านวังทอง ถนนสวัสดิการ 2(ซอยเพชรเกษม 77)",75,199,269,336,605
2832,"หนองแขม","เขตหนองแขม",102302,"เต็นท์หมู่บ้านเปรมปรีดิ์ (ซอยเพชรเกษม 79)",76,143,230,271,501
2833,"หนองแขม","เขตหนองแขม",102302,"เต็นท์หมู่บ้านเปรมปรีดิ์ (ซอยเพชรเกษม 79)",77,123,207,248,455
2834,"หนองแขม","เขตหนองแขม",102302,"เต็นท์ข้างโรงเรียนอนุบาลยูรดา (ซอยเพชรเกษม 79)",78,188,293,347,640
2835,"หนองแขม","เขตหนองแขม",102302,"เต็นท์ที่ว่างหน้าศูนย์วิชาการเรือนไทย ยูรดา (ซอยเพชรเกษม 79)",79,185,286,357,643
2836,"หนองแขม","เขตหนองแขม",102302,"เต็นท์ที่ว่างหน้าศูนย์วิชาการเรือนไทย ยูรดา (ซอยเพชรเกษม 79)",80,218,328,363,691
2837,"หนองแขม","เขตหนองแขม",102302,"เต็นท์หน้าบ้านเลขที่ 234 - 236 ซอยเพชรเกษม 79 แยก 28",81,291,374,477,851
2838,"หนองแขม","เขตหนองแขม",102302,"บ้านนายพลกฤษณ (ซอยเพชรเกษม 69)",82,287,357,449,806
2839,"หนองแขม","เขตหนองแขม",102302,"บ้านนายพลกฤษณ (ซอยเพชรเกษม 69)",83,292,361,478,839
2840,"หนองแขม","เขตหนองแขม",102302,"บ้านนายพลกฤษณ (ซอยเพชรเกษม 69)",84,372,388,508,896
2841,"หนองแขม","เขตหนองแขม",102302,"บ้านนายพลกฤษณ (ซอยเพชรเกษม 69)",85,304,340,469,809
2842,"หนองแขม","เขตหนองแขม",102302,"บ้านนายพลกฤษณ (ซอยเพชรเกษม 69)",86,254,365,443,808
2843,"หนองแขม","เขตหนองแขม",102302,"บ้านนายพลกฤษณ (ซอยเพชรเกษม 69)",87,277,383,421,804
2844,"หนองค้างพลู","เขตหนองแขม",102303,"เต็นท์หน้าบริษัท นันยางการทออุตสาหกรรม จำกัด (ถนนเพชรเกษม)",1,244,295,369,664
2845,"หนองค้างพลู","เขตหนองแขม",102303,"เต็นท์หน้าบริษัท นันยางการทออุตสาหกรรม จำกัด (ถนนเพชรเกษม)",2,213,285,337,622
2846,"หนองค้างพลู","เขตหนองแขม",102303,"เต็นท์หน้าบริษัท นันยางการทออุตสาหกรรม จำกัด (ถนนเพชรเกษม)",3,341,272,369,641
2847,"หนองค้างพลู","เขตหนองแขม",102303,"เต็นท์ที่ว่างข้างบ้านเลขที่ 55/1 ซอยเพชรเกษม 69 แยก 6",4,173,317,328,645
2848,"หนองค้างพลู","เขตหนองแขม",102303,"เต็นท์ที่ว่างข้างบ้านเลขที่ 55/1 ซอยเพชรเกษม 69 แยก 6",5,153,283,345,628
2849,"หนองค้างพลู","เขตหนองแขม",102303,"เต็นท์ที่ว่างข้างบ้านเลขที่ 55/1 ซอยเพชรเกษม 69 แยก 6",6,192,328,385,713
2850,"หนองค้างพลู","เขตหนองแขม",102303,"เต็นท์สวนพุทธรักษ์ (ซอยเพชรเกษม 77)",7,284,372,425,797
2851,"หนองค้างพลู","เขตหนองแขม",102303,"เต็นท์สวนพุทธรักษ์ (ซอยเพชรเกษม 77)",8,289,353,414,767
2852,"หนองค้างพลู","เขตหนองแขม",102303,"เต็นท์สวนพุทธรักษ์ (ซอยเพชรเกษม 77)",9,244,347,406,753
2853,"หนองค้างพลู","เขตหนองแขม",102303,"โรงเรียนอนุบาลเลิศหล้า (ถนนเพชรเกษม)",10,198,255,303,558
2854,"หนองค้างพลู","เขตหนองแขม",102303,"เต็นท์หน้าซอยเพชรเกษม 77/8 (ถนนเพชรเกษม)",11,204,243,291,534
2855,"หนองค้างพลู","เขตหนองแขม",102303,"เต็นท์หน้าซอยเพชรเกษม 77/8 (ถนนเพชรเกษม)",12,254,296,380,676
2856,"หนองค้างพลู","เขตหนองแขม",102303,"โรงเรียนวัดอุดมรังสี (ถนนเพชรเกษม)",13,217,354,376,730
2857,"หนองค้างพลู","เขตหนองแขม",102303,"โรงเรียนวัดอุดมรังสี (ถนนเพชรเกษม)",14,283,335,462,797
2858,"หนองค้างพลู","เขตหนองแขม",102303,"โรงเรียนวัดอุดมรังสี (ถนนเพชรเกษม)",15,246,352,421,773
2859,"หนองค้างพลู","เขตหนองแขม",102303,"โรงเรียนวัดอุดมรังสี (ถนนเพชรเกษม)",16,258,336,417,753
2860,"หนองค้างพลู","เขตหนองแขม",102303,"เต็นท์สถานีบริการน้ำมัน เอสโซ่ (ซอยเพชรเกษม 81)",17,331,367,408,775
2861,"หนองค้างพลู","เขตหนองแขม",102303,"เต็นท์สถานีบริการน้ำมัน เอสโซ่ (ซอยเพชรเกษม 81)",18,330,366,450,816
2862,"หนองค้างพลู","เขตหนองแขม",102303,"เต็นท์ลานกีฬาหมู่บ้านพงษ์ศิริชัย 4 (ซอยเพชรเกษม 81)",19,267,333,372,705
2863,"หนองค้างพลู","เขตหนองแขม",102303,"เต็นท์ลานกีฬาหมู่บ้านพงษ์ศิริชัย 4 (ซอยเพชรเกษม 81)",20,234,350,409,759
2864,"หนองค้างพลู","เขตหนองแขม",102303,"เต็นท์ลานกีฬาหมู่บ้านพงษ์ศิริชัย 4 (ซอยเพชรเกษม 81)",21,227,342,400,742
2865,"หนองค้างพลู","เขตหนองแขม",102303,"เต็นท์ลานกีฬาหมู่บ้านพงษ์ศิริชัย 4 (ซอยเพชรเกษม 81)",22,274,350,450,800
2866,"หนองค้างพลู","เขตหนองแขม",102303,"เต็นท์ลานกีฬาหมู่บ้านพงษ์ศิริชัย 4 (ซอยเพชรเกษม 81)",23,268,346,398,744
2867,"หนองค้างพลู","เขตหนองแขม",102303,"เต็นท์ลานกีฬาหมู่บ้านพงษ์ศิริชัย 4 (ซอยเพชรเกษม 81)",24,263,365,429,794
2868,"หนองค้างพลู","เขตหนองแขม",102303,"เต็นท์ลานกีฬาหมู่บ้านพงษ์ศิริชัย 4 (ซอยเพชรเกษม 81)",25,252,371,450,821
2869,"หนองค้างพลู","เขตหนองแขม",102303,"เต็นท์หน้าสถานีบริการน้ำมัน พีที (ถนนเพชรเกษม )",26,213,329,357,686
2870,"หนองค้างพลู","เขตหนองแขม",102303,"เต็นท์หน้าสถานีบริการน้ำมัน พีที (ถนนเพชรเกษม )",27,233,304,397,701
2871,"หนองค้างพลู","เขตหนองแขม",102303,"เต็นท์หน้าสถานีบริการน้ำมัน พีที (ถนนเพชรเกษม )",28,349,298,391,689
2872,"หนองค้างพลู","เขตหนองแขม",102303,"เต็นท์หน้าสถานีบริการน้ำมัน พีที (ถนนเพชรเกษม )",29,249,313,376,689
2873,"หนองค้างพลู","เขตหนองแขม",102303,"เต็นท์หน้าสถานีบริการน้ำมัน พีที (ถนนเพชรเกษม )",30,164,332,376,708
2874,"หนองค้างพลู","เขตหนองแขม",102303,"เต็นท์หน้าธนาคารอาคารสงเคราะห์ (ถนนเพชรเกษม )",31,261,328,368,696
2875,"หนองค้างพลู","เขตหนองแขม",102303,"เต็นท์หน้าธนาคารอาคารสงเคราะห์ (ถนนเพชรเกษม )",32,246,299,383,682
2876,"หนองค้างพลู","เขตหนองแขม",102303,"เต็นท์หน้าธนาคารอาคารสงเคราะห์ (ถนนเพชรเกษม )",33,231,306,378,684
2877,"หนองค้างพลู","เขตหนองแขม",102303,"เต็นท์หน้าธนาคารอาคารสงเคราะห์ (ถนนเพชรเกษม )",34,281,320,427,747
2878,"หนองค้างพลู","เขตหนองแขม",102303,"เต็นท์หน้าธนาคารอาคารสงเคราะห์ (ถนนเพชรเกษม )",35,279,324,420,744
2879,"หนองค้างพลู","เขตหนองแขม",102303,"เต็นท์หน้าบ้านเลขที่ 88/140-146 (ซอยเพชรเกษม 116/1)",36,300,380,423,803
2880,"หนองค้างพลู","เขตหนองแขม",102303,"เต็นท์หน้าบ้านเลขที่ 88/140-146 (ซอยเพชรเกษม 116/1)",37,206,336,424,760
2881,"หนองค้างพลู","เขตหนองแขม",102303,"เต็นท์หน้าบ้านเลขที่ 88/140-146 (ซอยเพชรเกษม 116/1)",38,300,373,424,797
2882,"หนองค้างพลู","เขตหนองแขม",102303,"เต็นท์ลานอเนกประสงค์หมู่บ้านเกษมทอง (ซอยเพชรเกษม 114)",39,254,308,382,690
2883,"หนองค้างพลู","เขตหนองแขม",102303,"เต็นท์หน้าคอนโดหนองแขม (ซอยเพชรเกษม 114)",40,273,334,411,745
2884,"หนองค้างพลู","เขตหนองแขม",102303,"วิทยาลัยเทคโนโลยีหมู่บ้านครู (ซอยเพชรเกษม 112)",41,271,327,405,732
2885,"หนองค้างพลู","เขตหนองแขม",102303,"วิทยาลัยเทคโนโลยีหมู่บ้านครู (ซอยเพชรเกษม 112)",42,236,356,420,776
2886,"หนองค้างพลู","เขตหนองแขม",102303,"เต็นท์ลานอเนกประสงค์หมู่บ้านณัฐกานต์ (ซอยเพชรเกษม 112)",43,208,239,361,600
2887,"หนองค้างพลู","เขตหนองแขม",102303,"เต็นท์ลานอเนกประสงค์หมู่บ้านณัฐกานต์ (ซอยเพชรเกษม 112)",44,230,276,339,615
2888,"หนองค้างพลู","เขตหนองแขม",102303,"มหาวิทยาลัยธนบุรี (ซอยเพชรเกษม 110)",45,287,346,390,736
2889,"หนองค้างพลู","เขตหนองแขม",102303,"มหาวิทยาลัยธนบุรี (ซอยเพชรเกษม 110)",46,214,353,400,753
2890,"หนองค้างพลู","เขตหนองแขม",102303,"มหาวิทยาลัยธนบุรี (ซอยเพชรเกษม 110)",47,205,368,404,772
2891,"หนองค้างพลู","เขตหนองแขม",102303,"มหาวิทยาลัยธนบุรี (ซอยเพชรเกษม 110)",48,231,345,448,793
2892,"หนองค้างพลู","เขตหนองแขม",102303,"มหาวิทยาลัยธนบุรี (ซอยเพชรเกษม 110)",49,281,348,442,790
2893,"หนองค้างพลู","เขตหนองแขม",102303,"มหาวิทยาลัยธนบุรี (ซอยเพชรเกษม 110)",50,283,305,421,726
2894,"หนองค้างพลู","เขตหนองแขม",102303,"โรงเรียนบ้านขุนประเทศ (ซอยเพชรเกษม 110)",51,217,339,423,762
2895,"หนองค้างพลู","เขตหนองแขม",102303,"โรงเรียนบ้านขุนประเทศ (ซอยเพชรเกษม 110)",52,190,371,391,762
2896,"หนองค้างพลู","เขตหนองแขม",102303,"โรงเรียนบ้านขุนประเทศ (ซอยเพชรเกษม 110)",53,202,366,388,754
2897,"หนองค้างพลู","เขตหนองแขม",102303,"โรงเรียนบ้านขุนประเทศ (ซอยเพชรเกษม 110)",54,211,364,392,756
2898,"หนองค้างพลู","เขตหนองแขม",102303,"โรงเรียนบ้านขุนประเทศ (ซอยเพชรเกษม 110)",55,281,356,419,775
2899,"หนองค้างพลู","เขตหนองแขม",102303,"เต็นท์วัดไผ่เลี้ยง (ซอยเพชรเกษม 110)",56,259,373,436,809
2900,"หนองค้างพลู","เขตหนองแขม",102303,"เต็นท์วัดไผ่เลี้ยง (ซอยเพชรเกษม 110)",57,273,364,447,811
2901,"หนองค้างพลู","เขตหนองแขม",102303,"ศาลาศูนย์ถ่ายทอดเทคโนโลยีการเกษตร (ซอยเพชรเกษม 110)",58,148,270,232,502
2902,"หนองค้างพลู","เขตหนองแขม",102303,"ลานอเนกประสงค์รัฐเอื้อราษฎร์ กองทัพเรือ (ซอยเพชรเกษม 110)",59,389,417,401,818
2903,"หนองค้างพลู","เขตหนองแขม",102303,"ลานอเนกประสงค์รัฐเอื้อราษฎร์ กองทัพเรือ (ซอยเพชรเกษม 110)",60,405,428,386,814
2904,"หนองค้างพลู","เขตหนองแขม",102303,"ลานอเนกประสงค์รัฐเอื้อราษฎร์ กองทัพเรือ (ซอยเพชรเกษม 110)",61,311,447,446,893
2905,"หนองค้างพลู","เขตหนองแขม",102303,"เต็นท์ศูนย์อีซูซุ หน้าซอยเพชรเกษม 108",62,217,327,348,675
2906,"หนองค้างพลู","เขตหนองแขม",102303,"โรงเรียนวีรสุนทร (ซอยเพชรเกษม 108)",63,228,312,366,678
2907,"หนองค้างพลู","เขตหนองแขม",102303,"เต็นท์ลานกีฬาหมู่บ้านชมเดือน (ซอยเพชรเกษม 108)",64,266,401,459,860
2908,"หนองค้างพลู","เขตหนองแขม",102303,"เต็นท์ลานกีฬาหมู่บ้านชมเดือน (ซอยเพชรเกษม 108)",65,433,413,578,991
2909,"หนองค้างพลู","เขตหนองแขม",102303,"เต็นท์วัดวงษ์ลาภาราม (ซอยเพชรเกษม 106)",66,283,283,404,687
2910,"หนองค้างพลู","เขตหนองแขม",102303,"เต็นท์วัดวงษ์ลาภาราม (ซอยเพชรเกษม 106)",67,216,312,359,671
2911,"หนองค้างพลู","เขตหนองแขม",102303,"เต็นท์วัดวงษ์ลาภาราม (ซอยเพชรเกษม 106)",68,110,302,309,611
2912,"หนองค้างพลู","เขตหนองแขม",102303,"เต็นท์ที่ว่างข้างมหาวิทยาลัยเอเชียอาคเนย์ (ถนนเพชรเกษม)",69,273,309,398,707
2913,"หนองค้างพลู","เขตหนองแขม",102303,"เต็นท์ที่ว่างข้างมหาวิทยาลัยเอเชียอาคเนย์ (ถนนเพชรเกษม)",70,271,287,388,675
2914,"หนองค้างพลู","เขตหนองแขม",102303,"เต็นท์ที่ว่างข้างมหาวิทยาลัยเอเชียอาคเนย์ (ถนนเพชรเกษม)",71,263,301,369,670
2915,"หนองค้างพลู","เขตหนองแขม",102303,"เต็นท์ที่ว่างข้างมหาวิทยาลัยเอเชียอาคเนย์ (ถนนเพชรเกษม)",72,240,303,376,679
2916,"หนองค้างพลู","เขตหนองแขม",102303,"เต็นท์ที่ว่างข้างมหาวิทยาลัยเอเชียอาคเนย์ (ถนนเพชรเกษม)",73,235,301,367,668
2917,"หนองค้างพลู","เขตหนองแขม",102303,"ศูนย์กำจัดขยะมูลฝอย (ถนนพุทธมณฑลสาย 3)",74,281,475,461,936
2918,"หนองค้างพลู","เขตหนองแขม",102303,"ศูนย์กำจัดขยะมูลฝอย (ถนนพุทธมณฑลสาย 3)",75,364,396,502,898
2919,"หนองค้างพลู","เขตหนองแขม",102303,"เต็นท์ลานอเนกประสงค์หมู่บ้านสุชา (ถนนทวีวัฒนา)",76,250,326,444,770
2920,"หนองค้างพลู","เขตหนองแขม",102303,"เต็นท์ลานอเนกประสงค์หมู่บ้านสุชา (ถนนทวีวัฒนา)",77,277,378,405,783
2921,"หนองค้างพลู","เขตหนองแขม",102303,"เต็นท์ทางเข้าหมู่บ้านเพชรเกษม 4 (ถนนทวีวัฒนา)",78,294,363,425,788
2922,"หนองค้างพลู","เขตหนองแขม",102303,"เต็นท์ทางเข้าหมู่บ้านเพชรเกษม 4 (ถนนทวีวัฒนา)",79,330,359,438,797
2923,"หนองค้างพลู","เขตหนองแขม",102303,"ศาลาเอนกประสงค์ชุมชนฉัตรชัยเสริมโชค (ถนนทวีวัฒนา)",80,243,422,437,859
2924,"หนองค้างพลู","เขตหนองแขม",102303,"เต็นท์ลานอเนกประสงค์ชุมชนฉัตรชัยเสริมโชค (ถนนทวีวัฒนา)",81,235,401,467,868
2925,"ราษฎร์บูรณะ","เขตราษฎร์บูรณะ",102401,"ห้องสันทนาการภายในอาคารชุด แชปเตอร์วัน โมเดิร์นดัทช์ ถนนราษฎร์บูรณะ",1,574,272,409,681
2926,"ราษฎร์บูรณะ","เขตราษฎร์บูรณะ",102401,"โรงเรียนวัดแจงร้อน (โรงอาหาร)",2,120,260,269,529
2927,"ราษฎร์บูรณะ","เขตราษฎร์บูรณะ",102401,"โรงเรียนวัดแจงร้อน (โรงอาหาร)",3,151,297,295,592
2928,"ราษฎร์บูรณะ","เขตราษฎร์บูรณะ",102401,"เต็นท์บริเวณหน้าอาคารสำนักงานการไฟฟ้านครหลวง เขตราษฎร์บูรณะ",4,248,323,392,715
2929,"ราษฎร์บูรณะ","เขตราษฎร์บูรณะ",102401,"เต็นท์บริเวณหน้าอาคารสำนักงานการไฟฟ้านครหลวง เขตราษฎร์บูรณะ",5,231,314,373,687
2930,"ราษฎร์บูรณะ","เขตราษฎร์บูรณะ",102401,"ศาลาวัดสน",6,281,243,302,545
2931,"ราษฎร์บูรณะ","เขตราษฎร์บูรณะ",102401,"ศาลาวัดสน",7,206,317,357,674
2932,"ราษฎร์บูรณะ","เขตราษฎร์บูรณะ",102401,"ศาลาวัดสน",8,182,293,333,626
2933,"ราษฎร์บูรณะ","เขตราษฎร์บูรณะ",102401,"โรงเรียนวัดสน (สนามกีฬาในร่ม)",9,195,256,319,575
2934,"ราษฎร์บูรณะ","เขตราษฎร์บูรณะ",102401,"โรงเรียนวัดสน (สนามกีฬาในร่ม)",10,176,265,327,592
2935,"ราษฎร์บูรณะ","เขตราษฎร์บูรณะ",102401,"โรงเรียนวัดสน (สนามกีฬาในร่ม)",11,156,239,300,539
2936,"ราษฎร์บูรณะ","เขตราษฎร์บูรณะ",102401,"เต็นท์บริเวณแฟลตสมฤดี กลางซอยราษฎร์บูรณะ 26",12,188,307,360,667
2937,"ราษฎร์บูรณะ","เขตราษฎร์บูรณะ",102401,"เต็นท์บริเวณแฟลตสมฤดี กลางซอยราษฎร์บูรณะ 26",13,148,284,334,618
2938,"ราษฎร์บูรณะ","เขตราษฎร์บูรณะ",102401,"เต็นท์บริเวณสถานีดับเพลิงและกู้ภัยราษฎร์บูรณะ ปากซอยราษฎร์บูรณะ 22",14,166,279,311,590
2939,"ราษฎร์บูรณะ","เขตราษฎร์บูรณะ",102401,"เต็นท์บริเวณสถานีดับเพลิงและกู้ภัยราษฎร์บูรณะ ปากซอยราษฎร์บูรณะ 22",15,151,272,326,598
2940,"ราษฎร์บูรณะ","เขตราษฎร์บูรณะ",102401,"เต็นท์บริเวณฝ่ายรักษาความสะอาดฯ ใกล้ปากซอยราษฎร์บูรณะ 22",16,139,320,354,674
2941,"ราษฎร์บูรณะ","เขตราษฎร์บูรณะ",102401,"เต็นท์บริเวณฝ่ายรักษาความสะอาดฯ ใกล้ปากซอยราษฎร์บูรณะ 22",17,148,206,240,446
2942,"ราษฎร์บูรณะ","เขตราษฎร์บูรณะ",102401,"เต็นท์บริเวณฝ่ายรักษาความสะอาดฯ ใกล้ปากซอยราษฎร์บูรณะ 22",18,141,212,241,453
2943,"ราษฎร์บูรณะ","เขตราษฎร์บูรณะ",102401,"เต็นท์บริเวณสวนวงแหวนสุขสวัสดิ์ ใต้สะพานภูมิพล ถนนสุขสวัสดิ์",19,194,276,350,626
2944,"ราษฎร์บูรณะ","เขตราษฎร์บูรณะ",102401,"เต็นท์บริเวณสวนวงแหวนสุขสวัสดิ์ ใต้สะพานภูมิพล ถนนสุขสวัสดิ์",20,158,268,344,612
2945,"ราษฎร์บูรณะ","เขตราษฎร์บูรณะ",102401,"เต็นท์บริเวณสวนวงแหวนสุขสวัสดิ์ ใต้สะพานภูมิพล ถนนสุขสวัสดิ์",21,131,243,273,516
2946,"ราษฎร์บูรณะ","เขตราษฎร์บูรณะ",102401,"เต็นท์บริเวณธนาคารกรุงศรีอยุธยา สาขาราษฎร์บูรณะ ซอยสุขสวัสดิ์ 52/1",22,222,348,388,736
2947,"ราษฎร์บูรณะ","เขตราษฎร์บูรณะ",102401,"เต็นท์บริเวณธนาคารกรุงศรีอยุธยา สาขาราษฎร์บูรณะ ซอยสุขสวัสดิ์ 52/1",23,157,253,276,529
2948,"ราษฎร์บูรณะ","เขตราษฎร์บูรณะ",102401,"อาคารโรงเรียนเมตตาวิทยา",24,229,251,321,572
2949,"ราษฎร์บูรณะ","เขตราษฎร์บูรณะ",102401,"เต็นท์บริเวณโรงเรียนเมตตาวิทยา",25,153,246,305,551
2950,"ราษฎร์บูรณะ","เขตราษฎร์บูรณะ",102401,"เต็นท์บริเวณโรงเรียนเมตตาวิทยา",26,155,278,271,549
2951,"ราษฎร์บูรณะ","เขตราษฎร์บูรณะ",102401,"เต็นท์บริเวณโรงเรียนเมตตาวิทยา",27,134,211,250,461
2952,"ราษฎร์บูรณะ","เขตราษฎร์บูรณะ",102401,"เต็นท์บริเวณที่จอดรถ ซอย 15 (สุดซอยประชาอุทิศ 15)",28,177,335,401,736
2953,"ราษฎร์บูรณะ","เขตราษฎร์บูรณะ",102401,"เต็นท์บริเวณที่จอดรถ ซอย 15 (สุดซอยประชาอุทิศ 15)",29,187,345,372,717
2954,"ราษฎร์บูรณะ","เขตราษฎร์บูรณะ",102401,"อาคารโรงเรียนอนุบาลบูรณะศึกษา ซอยประชาอุทิศ 17",30,207,299,372,671
2955,"ราษฎร์บูรณะ","เขตราษฎร์บูรณะ",102401,"เต็นท์บริเวณอาคารราษฎร์บูรณะคอนโดทาวน์ (ซอยประชาอุทิศ 17)",31,167,189,224,413
2956,"ราษฎร์บูรณะ","เขตราษฎร์บูรณะ",102401,"เต็นท์ในซอยประชาอุทิศ 27 แยก 2 (ตลาดนัดเดิม)",32,181,226,277,503
2957,"ราษฎร์บูรณะ","เขตราษฎร์บูรณะ",102401,"เต็นท์ในซอยประชาอุทิศ 27 แยก 2 (ตลาดนัดเดิม)",33,200,244,269,513
2958,"ราษฎร์บูรณะ","เขตราษฎร์บูรณะ",102401,"เต็นท์บริเวณลานจอดรถ โรงเรียนขจรโรจน์วิทยา",34,169,245,319,564
2959,"ราษฎร์บูรณะ","เขตราษฎร์บูรณะ",102401,"เต็นท์บริเวณลานจอดรถ โรงเรียนขจรโรจน์วิทยา",35,195,190,244,434
2960,"ราษฎร์บูรณะ","เขตราษฎร์บูรณะ",102401,"เต็นท์บริเวณลานจอดรถ บริษัท ไทยแมนอินดัสตรีส์ จำกัด (ใกล้ปากซอยประชาอุทิศ 20)",36,276,337,428,765
2961,"ราษฎร์บูรณะ","เขตราษฎร์บูรณะ",102401,"เต็นท์บริเวณลานจอดรถ บริษัท ไทยแมนอินดัสตรีส์ จำกัด (ใกล้ปากซอยประชาอุทิศ 20)",37,295,356,453,809
2962,"ราษฎร์บูรณะ","เขตราษฎร์บูรณะ",102401,"วิทยาลัยพณิชยการเชตุพน (สนามหน้าอาคาร 2)",38,233,325,368,693
2963,"ราษฎร์บูรณะ","เขตราษฎร์บูรณะ",102401,"วิทยาลัยพณิชยการเชตุพน (สนามหน้าอาคาร 2)",39,236,285,399,684
2964,"ราษฎร์บูรณะ","เขตราษฎร์บูรณะ",102401,"วิทยาลัยพณิชยการเชตุพน (สนามหน้าอาคาร 2)",40,197,310,335,645
2965,"ราษฎร์บูรณะ","เขตราษฎร์บูรณะ",102401,"วิทยาลัยพณิชยการเชตุพน (สนามหน้าอาคาร 2)",41,199,299,389,688
2966,"บางปะกอก","เขตราษฎร์บูรณะ",102402,"อาคารโรงเรียนวัดประเสริฐสุทธาวาส",1,136,185,232,417
2967,"บางปะกอก","เขตราษฎร์บูรณะ",102402,"อาคารโรงเรียนวัดประเสริฐสุทธาวาส",2,131,213,234,447
2968,"บางปะกอก","เขตราษฎร์บูรณะ",102402,"เต็นท์ในตลาดสุขสวัสดิ์ 40",3,242,371,408,779
2969,"บางปะกอก","เขตราษฎร์บูรณะ",102402,"เต็นท์หน้าธนาคารไทยพาณิชย์ สาขาถนนสุขสวัสดิ์",4,186,249,280,529
2970,"บางปะกอก","เขตราษฎร์บูรณะ",102402,"เต็นท์ข้างศาลเจ้าปุงเฒ่ากง ซอยสุขสวัสดิ์ 30 แยก 2",5,239,320,415,735
2971,"บางปะกอก","เขตราษฎร์บูรณะ",102402,"เต็นท์บริเวณลานจอดรถเคหะสุขสวัสดิ์ ซอยสุขสวัสดิ์ 38 อาคารแอล",6,210,224,239,463
2972,"บางปะกอก","เขตราษฎร์บูรณะ",102402,"เต็นท์บริเวณลานจอดรถเคหะสุขสวัสดิ์ ซอยสุขสวัสดิ์ 38 อาคารแอล",7,234,254,303,557
2973,"บางปะกอก","เขตราษฎร์บูรณะ",102402,"เต็นท์บริเวณลานจอดรถเคหะสุขสวัสดิ์ ซอยสุขสวัสดิ์ 38 อาคารแอล",8,235,237,284,521
2974,"บางปะกอก","เขตราษฎร์บูรณะ",102402,"เต็นท์บริเวณลานจอดรถเคหะสุขสวัสดิ์ ซอยสุขสวัสดิ์ 38 อาคารแอล",9,223,243,280,523
2975,"บางปะกอก","เขตราษฎร์บูรณะ",102402,"เต็นท์บริเวณลานจอดรถเคหะสุขสวัสดิ์ ซอยสุขสวัสดิ์ 38 อาคารแอล",10,275,277,335,612
2976,"บางปะกอก","เขตราษฎร์บูรณะ",102402,"เต็นท์บริเวณที่ว่างในบริษัท ฮงเส็งการทอ จำกัด (ซอยสุขสวัสดิ์ 30)",11,168,301,332,633
2977,"บางปะกอก","เขตราษฎร์บูรณะ",102402,"เต็นท์บริเวณที่ว่างในบริษัท ฮงเส็งการทอ จำกัด (ซอยสุขสวัสดิ์ 30)",12,129,217,230,447
2978,"บางปะกอก","เขตราษฎร์บูรณะ",102402,"เต็นท์บริเวณที่ว่างในบริษัท ฮงเส็งการทอ จำกัด (ซอยสุขสวัสดิ์ 30)",13,117,223,250,473
2979,"บางปะกอก","เขตราษฎร์บูรณะ",102402,"เต็นท์บริเวณที่ว่างในบริษัท ฮงเส็งการทอ จำกัด (ซอยสุขสวัสดิ์ 30)",14,184,298,325,623
2980,"บางปะกอก","เขตราษฎร์บูรณะ",102402,"เต็นท์บริเวณที่ว่างในบริษัท ฮงเส็งการทอ จำกัด (ซอยสุขสวัสดิ์ 30)",15,123,199,236,435
2981,"บางปะกอก","เขตราษฎร์บูรณะ",102402,"เต็นท์บริเวณโรงเรียนรัตนจีนะอุทิศ",16,177,352,378,730
2982,"บางปะกอก","เขตราษฎร์บูรณะ",102402,"เต็นท์บริเวณโรงเรียนรัตนจีนะอุทิศ",17,182,321,367,688
2983,"บางปะกอก","เขตราษฎร์บูรณะ",102402,"เต็นท์บริเวณโรงเรียนรัตนจีนะอุทิศ",18,148,228,266,494
2984,"บางปะกอก","เขตราษฎร์บูรณะ",102402,"เต็นท์บริเวณโรงเรียนรัตนจีนะอุทิศ",19,187,303,342,645
2985,"บางปะกอก","เขตราษฎร์บูรณะ",102402,"เต็นท์บริเวณโรงเรียนรัตนจีนะอุทิศ",20,236,407,430,837
2986,"บางปะกอก","เขตราษฎร์บูรณะ",102402,"เต็นท์บริเวณโรงเรียนรัตนจีนะอุทิศ",21,319,417,507,924
2987,"บางปะกอก","เขตราษฎร์บูรณะ",102402,"เต็นท์บริเวณโรงเรียนรัตนจีนะอุทิศ",22,295,382,443,825
2988,"บางปะกอก","เขตราษฎร์บูรณะ",102402,"เต็นท์บริเวณโรงเรียนรัตนจีนะอุทิศ",23,349,380,426,806
2989,"บางปะกอก","เขตราษฎร์บูรณะ",102402,"เต็นท์ในสวนส่วนกลางข้างสำนักงานนิติบุคคลหมู่บ้านจัดสรร เดอะ พลีโน่ สุขสวัสดิ์ 30",24,257,227,334,561
2990,"บางปะกอก","เขตราษฎร์บูรณะ",102402,"เต็นท์ในสวนส่วนกลางข้างสำนักงานนิติบุคคลหมู่บ้านจัดสรร เดอะ พลีโน่ สุขสวัสดิ์ 30",25,321,294,368,662
2991,"บางปะกอก","เขตราษฎร์บูรณะ",102402,"บริเวณชั้น 1 อาคารที่พักอาศัยส่วนกลางกองทัพเรือ สุขสวัสดิ์ 26 อาคาร 2 (แฟลตทหารเรือ)",26,276,379,444,823
2992,"บางปะกอก","เขตราษฎร์บูรณะ",102402,"บริเวณชั้น 1 อาคารที่พักอาศัยส่วนกลางกองทัพเรือ สุขสวัสดิ์ 26 อาคาร 2 (แฟลตทหารเรือ)",27,262,254,342,596
2993,"บางปะกอก","เขตราษฎร์บูรณะ",102402,"บริเวณชั้น 1 อาคารที่พักอาศัยส่วนกลางกองทัพเรือ สุขสวัสดิ์ 26 อาคาร 2 (แฟลตทหารเรือ)",28,177,262,315,577
2994,"บางปะกอก","เขตราษฎร์บูรณะ",102402,"บริเวณชั้น 1 อาคารที่พักอาศัยส่วนกลางกองทัพเรือ สุขสวัสดิ์ 26 อาคาร 2 (แฟลตทหารเรือ)",29,408,441,493,934
2995,"บางปะกอก","เขตราษฎร์บูรณะ",102402,"บริเวณชั้น 1 อาคารที่พักอาศัยส่วนกลางกองทัพเรือ สุขสวัสดิ์  26 อาคาร 8 (แฟลตทหารเรือ)",30,385,411,280,691
2996,"บางปะกอก","เขตราษฎร์บูรณะ",102402,"บริเวณชั้น 1 อาคารที่พักอาศัยส่วนกลางกองทัพเรือ สุขสวัสดิ์ 26 อาคาร 9 (แฟลตทหารเรือ)",31,289,333,228,561
2997,"บางปะกอก","เขตราษฎร์บูรณะ",102402,"บริเวณชั้น 1 อาคารที่พักอาศัยส่วนกลางกองทัพเรือ สุขสวัสดิ์ 26 อาคาร 13 (แฟลตทหารเรือ)",32,337,379,229,608
2998,"บางปะกอก","เขตราษฎร์บูรณะ",102402,"บริเวณชั้น 1 อาคารที่พักอาศัยส่วนกลางกองทัพเรือ สุขสวัสดิ์ 26 อาคาร 20 (แฟลตทหารเรือ)",33,331,368,245,613
2999,"บางปะกอก","เขตราษฎร์บูรณะ",102402,"เต็นท์บนทางเท้าหน้าอาคารเลขที่ 226-456 ซอยสุขสวัสดิ์ 26 (มหาทุนพลาซ่า)",34,275,371,465,836
3000,"บางปะกอก","เขตราษฎร์บูรณะ",102402,"เต็นท์บนทางเท้าหน้าอาคารเลขที่ 226-456 ซอยสุขสวัสดิ์ 26 (มหาทุนพลาซ่า)",35,233,418,468,886
3001,"บางปะกอก","เขตราษฎร์บูรณะ",102402,"เต็นท์บนทางเท้าหน้าอาคารเลขที่ 226-456 ซอยสุขสวัสดิ์ 26 (มหาทุนพลาซ่า)",36,162,305,315,620
3002,"บางปะกอก","เขตราษฎร์บูรณะ",102402,"เต็นท์บนทางเท้าหน้าอาคารเลขที่ 226-456 ซอยสุขสวัสดิ์ 26 (มหาทุนพลาซ่า)",37,216,335,362,697
3003,"บางปะกอก","เขตราษฎร์บูรณะ",102402,"ศาลเจ้าทีกง ซอยสุขสวัสดิ์ 26",38,239,375,452,827
3004,"บางปะกอก","เขตราษฎร์บูรณะ",102402,"เต็นท์หน้าบริษัท ศรีพูนทอง จำกัด (ร้านเหล็ก) ใกล้ปั๊มน้ำมันเอสโซ่ ถนนสุขสวัสดิ์",39,173,262,336,598
3005,"บางปะกอก","เขตราษฎร์บูรณะ",102402,"เต็นท์หน้าบริษัท ศรีพูนทอง จำกัด (ร้านเหล็ก) ใกล้ปั๊มน้ำมันเอสโซ่ ถนนสุขสวัสดิ์",40,177,317,313,630
3006,"บางปะกอก","เขตราษฎร์บูรณะ",102402,"เต็นท์บริเวณลานจอดรถในชุมชนรุ่งอรุณ (ซอยสุขสวัสดิ์ 1)",41,178,272,286,558
3007,"บางปะกอก","เขตราษฎร์บูรณะ",102402,"เต็นท์บริเวณลานจอดรถในชุมชนรุ่งอรุณ (ซอยสุขสวัสดิ์ 1)",42,144,232,249,481
3008,"บางปะกอก","เขตราษฎร์บูรณะ",102402,"เต็นท์บริเวณลานจอดรถในชุมชนรุ่งอรุณ (ซอยสุขสวัสดิ์ 1)",43,172,229,266,495
3009,"บางปะกอก","เขตราษฎร์บูรณะ",102402,"เต็นท์บริเวณทางเท้าหน้าบริษัท พรพรรณโลหะกิจ จำกัด (ซอยสุขสวัสดิ์ 7)",44,161,237,247,484
3010,"บางปะกอก","เขตราษฎร์บูรณะ",102402,"เต็นท์บริเวณทางเท้าหน้าบริษัท แสงสว่าง 89 จำกัด ถนนสุขสวัสดิ์",45,234,376,422,798
3011,"บางปะกอก","เขตราษฎร์บูรณะ",102402,"เต็นท์กลางซอยสุขสวัสดิ์ 13",46,150,205,230,435
3012,"บางปะกอก","เขตราษฎร์บูรณะ",102402,"เต็นท์กลางซอยสุขสวัสดิ์ 13",47,431,211,350,561
3013,"บางปะกอก","เขตราษฎร์บูรณะ",102402,"โรงเรียนวัดบางปะกอก (สนามกีฬาในร่ม)",48,432,308,474,782
3014,"บางปะกอก","เขตราษฎร์บูรณะ",102402,"โรงเรียนวัดบางปะกอก (สนามกีฬาในร่ม)",49,297,282,426,708
3015,"บางปะกอก","เขตราษฎร์บูรณะ",102402,"โรงเรียนวัดบางปะกอก (สนามกีฬาในร่ม)",50,139,275,338,613
3016,"บางปะกอก","เขตราษฎร์บูรณะ",102402,"เต็นท์บริเวณสถานีบริการน้ำมัน ปตท.สุขสวัสดิ์ ขาออก (ใกล้ปากซอยสุขสวัสดิ์ 23)",51,197,249,326,575
3017,"บางปะกอก","เขตราษฎร์บูรณะ",102402,"เต็นท์บริเวณลานจอดรถศูนย์บริการลูกค้า เอ็นที ราษฎร์บูรณะ (ทีโอที เดิม)",52,233,317,399,716
3018,"บางปะกอก","เขตราษฎร์บูรณะ",102402,"เต็นท์บริเวณลานจอดรถศูนย์บริการลูกค้า เอ็นที ราษฎร์บูรณะ (ทีโอที เดิม)",53,221,273,393,666
3019,"บางปะกอก","เขตราษฎร์บูรณะ",102402,"เต็นท์ในสถานีบริการน้ำมันบางจาก ถนนราษฎร์บูรณะ (ปั๊มน้ำมันพีที เดิม)",54,180,249,256,505
3020,"บางปะกอก","เขตราษฎร์บูรณะ",102402,"เต็นท์ในสถานีบริการน้ำมันบางจาก ถนนราษฎร์บูรณะ (ปั๊มน้ำมันพีที เดิม)",55,328,228,287,515
3021,"บางปะกอก","เขตราษฎร์บูรณะ",102402,"เต็นท์บริเวณหลังห้างสรรพสินค้าบิ๊กซี ซูเปอร์เซ็นเตอร์ สาขาราษฎร์บูรณะ",56,469,407,405,812
3022,"บางปะกอก","เขตราษฎร์บูรณะ",102402,"เต็นท์บริเวณหลังห้างสรรพสินค้าบิ๊กซี ซูเปอร์เซ็นเตอร์ สาขาราษฎร์บูรณะ",57,143,345,336,681
3023,"บางปะกอก","เขตราษฎร์บูรณะ",102402,"เต็นท์บริเวณวัดราษฎร์บูรณะ",58,148,245,267,512
3024,"บางปะกอก","เขตราษฎร์บูรณะ",102402,"เต็นท์บริเวณวัดราษฎร์บูรณะ",59,137,262,279,541
3025,"บางปะกอก","เขตราษฎร์บูรณะ",102402,"เต็นท์บริเวณวัดราษฎร์บูรณะ",60,77,215,232,447
3026,"บางพลัด","เขตบางพลัด",102501,"เต็นท์หน้าโรงแรมรอยัลริเวอร์",1,320,328,424,752
3027,"บางพลัด","เขตบางพลัด",102501,"เต็นท์หน้าโรงแรมรอยัลริเวอร์",2,232,276,362,638
3028,"บางพลัด","เขตบางพลัด",102501,"วิทยาลัยสารพัดช่างนครหลวง (ซอยจรัญสนิทวงศ์ 68)",3,227,268,326,594
3029,"บางพลัด","เขตบางพลัด",102501,"วิทยาลัยสารพัดช่างนครหลวง (ซอยจรัญสนิทวงศ์ 68 )",4,182,329,347,676
3030,"บางพลัด","เขตบางพลัด",102501,"โรงเรียนวัดเทพากร",5,150,242,292,534
3031,"บางพลัด","เขตบางพลัด",102501,"โรงเรียนวัดเทพากร",6,111,238,257,495
3032,"บางพลัด","เขตบางพลัด",102501,"โรงเรียนวัดอาวุธวิกสิตาราม",7,120,199,208,407
3033,"บางพลัด","เขตบางพลัด",102501,"โรงเรียนวัดอาวุธวิกสิตาราม",8,98,210,204,414
3034,"บางพลัด","เขตบางพลัด",102501,"เต็นท์หน้าสำนักงานคณะวิทยาศาสตร์และเทคโนโลยีอาคารกรุงธนเมืองแก้ว ถนนสิรินธร",9,179,201,260,461
3035,"บางพลัด","เขตบางพลัด",102501,"เต็นท์หน้าสำนักงานคณะวิทยาศาสตร์และเทคโนโลยีอาคารกรุงธนเมืองแก้ว ถนนสิริธร",10,188,231,275,506
3036,"บางพลัด","เขตบางพลัด",102501,"เต็นท์บริเวณลานจอดรถออฟฟิศเมท (ใกล้ซอยจรัสลาภ ถนนสิรินธร)",11,257,323,391,714
3037,"บางพลัด","เขตบางพลัด",102501,"เต็นท์บริเวณลานจอดรถออฟฟิศเมท (ใกล้ซอยจรัสลาภ ถนนสิรินธร)",12,309,288,406,694
3038,"บางพลัด","เขตบางพลัด",102501,"โรงเรียนพิมลวิทย์",13,225,266,340,606
3039,"บางพลัด","เขตบางพลัด",102501,"โรงเรียนพิมลวิทย์",14,189,220,320,540
3040,"บางพลัด","เขตบางพลัด",102501,"วิทยาลัยเทคโนโลยีไทยอาชีวศึกษา  (ซอยจรัญสนิทวงศ์ 71)",15,254,324,389,713
3041,"บางพลัด","เขตบางพลัด",102501,"วิทยาลัยเทคโนโลยีไทยอาชีวศึกษา  (ซอยจรัญสนิทวงศ์ 71)",16,225,278,360,638
3042,"บางพลัด","เขตบางพลัด",102501,"โรงเรียนบูรณวิทย์",17,194,231,324,555
3043,"บางพลัด","เขตบางพลัด",102501,"โรงเรียนบูรณวิทย์",18,187,334,354,688
3044,"บางพลัด","เขตบางพลัด",102501,"โรงเรียนบูรณวิทย์",19,235,275,364,639
3045,"บางพลัด","เขตบางพลัด",102501,"โรงเรียนบูรณวิทย์",20,204,258,326,584
3046,"บางพลัด","เขตบางพลัด",102501,"เต็นท์ในบริเวณวัดเพลง",21,186,238,321,559
3047,"บางพลัด","เขตบางพลัด",102501,"เต็นท์ในบริเวณวัดเพลง",22,203,252,327,579
3048,"บางพลัด","เขตบางพลัด",102501,"เต็นท์ในบริเวณวัดเพลง",23,197,271,327,598
3049,"บางพลัด","เขตบางพลัด",102501,"เต็นท์ในบริเวณวัดเพลง",24,149,215,290,505
3050,"บางพลัด","เขตบางพลัด",102501,"เต็นท์ในบริเวณวัดเพลง",25,197,248,349,597
3051,"บางพลัด","เขตบางพลัด",102501,"เต็นท์ในบริเวณวัดเพลง",26,206,271,302,573
3052,"บางพลัด","เขตบางพลัด",102501,"โรงเรียนวัดบางพลัด",27,162,220,264,484
3053,"บางพลัด","เขตบางพลัด",102501,"โรงเรียนวัดบางพลัด",28,222,195,297,492
3054,"บางพลัด","เขตบางพลัด",102501,"โรงเรียนวัดบางพลัด",29,132,279,285,564
3055,"บางพลัด","เขตบางพลัด",102501,"โรงเรียนวัดบางพลัด",30,158,271,311,582
3056,"บางพลัด","เขตบางพลัด",102501,"โรงเรียนวัดบางพลัด",31,154,278,285,563
3057,"บางพลัด","เขตบางพลัด",102501,"โรงเรียนวัดบางพลัด",32,156,260,309,569
3058,"บางอ้อ","เขตบางพลัด",102502,"เต็นท์บริเวณปากซอยจรัญสนิทวงศ์ 74/1",1,226,396,456,852
3059,"บางอ้อ","เขตบางพลัด",102502,"เต็นท์หน้าอาคารโชว์รูมอิซูซุ",2,256,249,284,533
3060,"บางอ้อ","เขตบางพลัด",102502,"เต็นท์ในสถานบริการน้ำมัน PT (ใกล้ปากซอยจรัญสนิทวงศ์ 80)",3,127,229,230,459
3061,"บางอ้อ","เขตบางพลัด",102502,"เต็นท์ในสถานบริการน้ำมัน PT (ใกล้ปากซอยจรัญสนิทวงศ์ 80)",4,113,215,254,469
3062,"บางอ้อ","เขตบางพลัด",102502,"เต็นท์ในบริเวณโรงเรียนบางอ้อศึกษา",5,172,318,376,694
3063,"บางอ้อ","เขตบางพลัด",102502,"เต็นท์ในบริเวณโรงเรียนบางอ้อศึกษา",6,235,273,365,638
3064,"บางอ้อ","เขตบางพลัด",102502,"เต็นท์ในบริเวณโรงเรียนบางอ้อศึกษา",7,165,277,356,633
3065,"บางอ้อ","เขตบางพลัด",102502,"เต็นท์ในบริเวณโรงเรียนบางอ้อศึกษา",8,198,264,318,582
3066,"บางอ้อ","เขตบางพลัด",102502,"เต็นท์ในบริเวณโรงเรียนบางอ้อศึกษา",9,216,269,358,627
3067,"บางอ้อ","เขตบางพลัด",102502,"เต็นท์ในบริเวณลานจอดรถโรงพยาบาลยันฮี (ในซอยจรัญสนิทวงศ์ 92)",10,185,245,303,548
3068,"บางอ้อ","เขตบางพลัด",102502,"เต็นท์ในบริเวณลานจอดรถโรงพยาบาลยันฮี (ในซอยจรัญสนิทวงศ์ 92)",11,196,291,355,646
3069,"บางอ้อ","เขตบางพลัด",102502,"เต็นท์ในบริเวณลานจอดรถโรงพยาบาลยันฮี (ในซอยจรัญสนิทวงศ์ 92)",12,145,222,308,530
3070,"บางอ้อ","เขตบางพลัด",102502,"โรงเรียนวัดฉัตรแก้วจงกลณี",13,201,339,379,718
3071,"บางอ้อ","เขตบางพลัด",102502,"วิทยาลัยเทคโนโลยีพระรามหก",14,332,241,389,630
3072,"บางอ้อ","เขตบางพลัด",102502,"วิทยาลัยเทคโนโลยีพระรามหก",15,358,259,372,631
3073,"บางอ้อ","เขตบางพลัด",102502,"วิทยาลัยเทคโนโลยีพระรามหก",16,262,292,312,604
3074,"บางอ้อ","เขตบางพลัด",102502,"เต็นท์ในบริเวณโรงเรียนวัดวิมุตยาราม",17,338,328,445,773
3075,"บางอ้อ","เขตบางพลัด",102502,"เต็นท์ในบริเวณโรงเรียนวัดวิมุตยาราม",18,212,345,429,774
3076,"บางอ้อ","เขตบางพลัด",102502,"โรงเรียนวัดสามัคคีสุทธาวาส",19,241,310,425,735
3077,"บางอ้อ","เขตบางพลัด",102502,"โรงเรียนวัดสามัคคีสุทธาวาส",20,172,343,361,704
3078,"บางอ้อ","เขตบางพลัด",102502,"โรงเรียนวัดสามัคคีสุทธาวาส",21,196,328,382,710
3079,"บางอ้อ","เขตบางพลัด",102502,"โรงเรียนวัดสามัคคีสุทธาวาส",22,225,326,386,712
3080,"บางอ้อ","เขตบางพลัด",102502,"โรงเรียนวัดสามัคคีสุทธาวาส",23,171,322,390,712
3081,"บางอ้อ","เขตบางพลัด",102502,"โรงเรียนวัดสามัคคีสุทธาวาส",24,142,317,367,684
3082,"บางอ้อ","เขตบางพลัด",102502,"โรงเรียนวัดสามัคคีสุทธาวาส",25,212,346,371,717
3083,"บางอ้อ","เขตบางพลัด",102502,"บางอ้อคาร์เซ็นเตอร์",26,507,310,433,743
3084,"บางอ้อ","เขตบางพลัด",102502,"ซิตี้โฮมคอนโด",27,632,319,519,838
3085,"บางอ้อ","เขตบางพลัด",102502,"ใต้อาคารโชว์รูม ซูซูกิ สาขาบางอ้อ (ติดปั๊มน้ำมันบางจาก)",28,363,248,366,614
3086,"บางอ้อ","เขตบางพลัด",102502,"ใต้อาคารโชว์รูม ซูซูกิ สาขาบางอ้อ (ติดปั๊มน้ำมันบางจาก)",29,214,257,369,626
3087,"บางอ้อ","เขตบางพลัด",102502,"ใต้อาคารโชว์รูม ซูซูกิ สาขาบางอ้อ (ติดปั๊มน้ำมันบางจาก)",30,182,260,340,600
3088,"บางบำหรุ","เขตบางพลัด",102503,"เต็นท์หน้าโรงภาพยนตร์ธนบุรีรามา",1,502,326,531,857
3089,"บางบำหรุ","เขตบางพลัด",102503,"เต็นท์หน้าบริษัท ไฮไฟทาวเวอร์ จำกัด (ใกล้เมเจอร์ปิ่นเกล้า)",2,235,292,296,588
3090,"บางบำหรุ","เขตบางพลัด",102503,"โถงบริเวณข้างนิติบุคคล อาคารชุดลุมพินีปาร์ค ปิ่นเกล้า",3,690,273,571,844
3091,"บางบำหรุ","เขตบางพลัด",102503,"เต็นท์หน้าอาคารนิด้าแฟคตอรี่ (ใกล้กระทรวงวัฒนธรรม)",4,324,240,367,607
3092,"บางบำหรุ","เขตบางพลัด",102503,"เต็นท์หน้าอาคารนิด้าแฟคตอรี่ (ใกล้กระทรวงวัฒนธรรม)",5,275,246,367,613
3093,"บางบำหรุ","เขตบางพลัด",102503,"เต็นท์บริเวณปากทางเข้าถนนรุ่งประชา",6,288,283,384,667
3094,"บางบำหรุ","เขตบางพลัด",102503,"เต็นท์ข้างอาคารชุดคอมมอนเวลธ์",7,319,249,380,629
3095,"บางบำหรุ","เขตบางพลัด",102503,"เต็นท์ข้างอาคารชุดคอมมอนเวลธ์",8,231,214,307,521
3096,"บางบำหรุ","เขตบางพลัด",102503,"โรงเรียนวัดรวก",9,211,321,402,723
3097,"บางบำหรุ","เขตบางพลัด",102503,"โรงเรียนวัดรวก",10,238,283,400,683
3098,"บางบำหรุ","เขตบางพลัด",102503,"โรงเรียนวัดรวก",11,235,296,380,676
3099,"บางบำหรุ","เขตบางพลัด",102503,"โรงเรียนวัดรวก",12,250,292,351,643
3100,"บางบำหรุ","เขตบางพลัด",102503,"โรงเรียนวัดรวก",13,250,328,422,750
3101,"บางบำหรุ","เขตบางพลัด",102503,"โรงเรียนวัดรวก",14,266,305,386,691
3102,"บางบำหรุ","เขตบางพลัด",102503,"เต็นท์หน้าอาคารสำนักงานที่ดินกรุงเทพมหานคร สาขาบางกอกน้อย",15,214,258,308,566
3103,"บางบำหรุ","เขตบางพลัด",102503,"เต็นท์หน้าอาคารสำนักงานที่ดินกรุงเทพมหานคร สาขาบางกอกน้อย",16,228,251,321,572
3104,"บางบำหรุ","เขตบางพลัด",102503,"อาคารชุดลุมพินี ซอยจรัญสนิทวงศ์ 65",17,161,187,228,415
3105,"บางบำหรุ","เขตบางพลัด",102503,"อาคารชุดลุมพินี ซอยจรัญสนิทวงศ์ 65",18,140,204,248,452
3106,"บางบำหรุ","เขตบางพลัด",102503,"เต็นท์ในบริเวณสมาคมต่อต้านโรคมะเร็งแห่งประเทศไทย(ซอยจรัญสนิทวงศ์ 65)",19,258,309,397,706
3107,"บางบำหรุ","เขตบางพลัด",102503,"เต็นท์ในบริเวณสมาคมต่อต้านโรคมะเร็งแห่งประเทศไทย(ซอยจรัญสนิทวงศ์ 65)",20,244,310,393,703
3108,"บางบำหรุ","เขตบางพลัด",102503,"เต็นท์หน้าโรงเรียนอุดมศาสตร์พัฒนา (ซอยสิรินธร 7)",21,264,254,350,604
3109,"บางบำหรุ","เขตบางพลัด",102503,"เต็นท์หน้าโรงเรียนอุดมศาสตร์พัฒนา (ซอยสิรินธร 7)",22,243,270,386,656
3110,"บางบำหรุ","เขตบางพลัด",102503,"เต็นท์หน้าบริษัท เกตุชัยวัสดุก่อสร้าง จำกัด",23,177,208,271,479
3111,"บางบำหรุ","เขตบางพลัด",102503,"เต็นท์หน้าบริษัท เกตุชัยวัสดุก่อสร้าง จำกัด",24,174,209,244,453
3112,"บางยี่ขัน","เขตบางพลัด",102504,"เต็นท์บริเวณลานจอดรถห้างพาต้า ปิ่นเกล้า",1,445,206,356,562
3113,"บางยี่ขัน","เขตบางพลัด",102504,"เต็นท์บริเวณลานจอดรถห้างพาต้า ปิ่นเกล้า",2,228,217,269,486
3114,"บางยี่ขัน","เขตบางพลัด",102504,"เต็นท์หน้าคณะกายภาพบำบัด มหาวิทยาลัยมหิดล",3,235,262,317,579
3115,"บางยี่ขัน","เขตบางพลัด",102504,"เต็นท์หน้าคณะกายภาพบำบัด มหาวิทยาลัยมหิดล",4,114,245,276,521
3116,"บางยี่ขัน","เขตบางพลัด",102504,"เต็นท์ในบริเวณวัดดาวดึงษาราม",5,217,303,305,608
3117,"บางยี่ขัน","เขตบางพลัด",102504,"เต็นท์ในบริเวณวัดดาวดึงษาราม",6,146,297,327,624
3118,"บางยี่ขัน","เขตบางพลัด",102504,"เต็นท์ในบริเวณวัดดาวดึงษาราม",7,131,290,303,593
3119,"บางยี่ขัน","เขตบางพลัด",102504,"เต็นท์ในบริเวณวัดดาวดึงษาราม",8,171,314,358,672
3120,"บางยี่ขัน","เขตบางพลัด",102504,"เต็นท์ในบริเวณวัดน้อยนางหงษ์",9,558,323,492,815
3121,"บางยี่ขัน","เขตบางพลัด",102504,"เต็นท์ในบริเวณวัดน้อยนางหงษ์",10,249,342,406,748
3122,"บางยี่ขัน","เขตบางพลัด",102504,"เต็นท์ในบริเวณวัดน้อยนางหงษ์",11,371,364,495,859
3123,"บางยี่ขัน","เขตบางพลัด",102504,"เต็นท์ในบริเวณวัดน้อยนางหงษ์",12,277,362,472,834
3124,"บางยี่ขัน","เขตบางพลัด",102504,"เต็นท์ลานเอนกประสงค์ อาคารชุดลุมพินี เพลส พระราม 8",13,501,235,426,661
3125,"บางยี่ขัน","เขตบางพลัด",102504,"โรงเรียนวัดพระยาศิริไอยสวรรค์",14,131,240,270,510
3126,"บางยี่ขัน","เขตบางพลัด",102504,"โรงเรียนบางยี่ขันวิทยาคม",15,382,314,442,756
3127,"บางยี่ขัน","เขตบางพลัด",102504,"โรงเรียนบางยี่ขันวิทยาคม",16,577,308,461,769
3128,"บางยี่ขัน","เขตบางพลัด",102504,"โรงเรียนวัดคฤหบดี",17,408,280,381,661
3129,"บางยี่ขัน","เขตบางพลัด",102504,"โรงเรียนวัดคฤหบดี",18,240,329,449,778
3130,"บางยี่ขัน","เขตบางพลัด",102504,"โรงเรียนวัดคฤหบดี",19,204,357,435,792
3131,"บางยี่ขัน","เขตบางพลัด",102504,"โรงเรียนวัดคฤหบดี",20,173,319,391,710
3132,"บางยี่ขัน","เขตบางพลัด",102504,"โรงเรียนวัดบวรมงคล",21,235,290,379,669
3133,"บางยี่ขัน","เขตบางพลัด",102504,"โรงเรียนวัดบวรมงคล",22,257,342,403,745
3134,"บางยี่ขัน","เขตบางพลัด",102504,"โรงเรียนวัดบวรมงคล",23,171,318,368,686
3135,"บางยี่ขัน","เขตบางพลัด",102504,"โรงเรียนวัดบวรมงคล",24,191,300,382,682
3136,"บางยี่ขัน","เขตบางพลัด",102504,"โรงเรียนวัดบวรมงคล",25,171,296,316,612
3137,"บางยี่ขัน","เขตบางพลัด",102504,"โรงเรียนวัดเปาโรหิตย์",26,240,291,365,656
3138,"บางยี่ขัน","เขตบางพลัด",102504,"โรงเรียนวัดเปาโรหิตย์",27,189,247,274,521
3139,"บางยี่ขัน","เขตบางพลัด",102504,"โรงเรียนวัดเปาโรหิตย์",28,236,305,362,667
3140,"บางยี่ขัน","เขตบางพลัด",102504,"เต็นท์ในบริเวณวัดสิงห์",29,380,379,470,849
3141,"บางยี่ขัน","เขตบางพลัด",102504,"ศาลาในบริเวณวัดภคินีนาถ",30,274,346,422,768
3142,"บางยี่ขัน","เขตบางพลัด",102504,"ศาลาในบริเวณวัดภคินีนาถ",31,225,351,436,787
3143,"ดินแดง","เขตดินแดง",102601,"สมาคมศูนย์กลางเทวา ซอยประชาสงเคราะห์ 24",1,243,374,431,805
3144,"ดินแดง","เขตดินแดง",102601,"ที่จอดรถใต้อาคารธนาคารกสิกรไทย สาขาห้วยขวาง",2,251,320,362,682
3145,"ดินแดง","เขตดินแดง",102601,"โรงเรียนพร้อมพรรณวิทยา",3,259,370,391,761
3146,"ดินแดง","เขตดินแดง",102601,"โรงเรียนพร้อมพรรณวิทยา",4,193,317,337,654
3147,"ดินแดง","เขตดินแดง",102601,"โรงเรียนพร้อมพรรณวิทยา",5,180,234,306,540
3148,"ดินแดง","เขตดินแดง",102601,"โรงเรียนพณิชยการจำนงค์ (หอประชุม)",6,232,287,375,662
3149,"ดินแดง","เขตดินแดง",102601,"โรงเรียนพณิชยการจำนงค์ (หอประชุม)",7,224,279,345,624
3150,"ดินแดง","เขตดินแดง",102601,"โรงเรียนพณิชยการจำนงค์ (หอประชุม)",8,197,285,333,618
3151,"ดินแดง","เขตดินแดง",102601,"บริเวณใต้อาคารแฟลต 24 ดินแดง ถนนมิตรไมตรี",9,252,319,394,713
3152,"ดินแดง","เขตดินแดง",102601,"บริเวณใต้อาคารแฟลต 28 ดินแดง ถนนมิตรไมตรี",10,261,355,421,776
3153,"ดินแดง","เขตดินแดง",102601,"บริเวณใต้อาคารแฟลตแปลง G ถนนมิตรไมตรี",11,184,197,259,456
3154,"ดินแดง","เขตดินแดง",102601,"บริเวณใต้อาคารแฟลตแปลง G ถนนมิตรไมตรี",12,166,220,228,448
3155,"ดินแดง","เขตดินแดง",102601,"ศาลาหน้าหอพระแฟลต ช.1",13,308,398,449,847
3156,"ดินแดง","เขตดินแดง",102601,"เต็นท์บริเวณสวนเคหะชุมชนดินแดง 2",14,290,381,424,805
3157,"ดินแดง","เขตดินแดง",102601,"เต็นท์บริเวณสวนเคหะชุมชนดินแดง 2",15,285,335,443,778
3158,"ดินแดง","เขตดินแดง",102601,"ศาลาหอพระพุทธพาณิชย์ แฟลต ช.5",16,221,309,329,638
3159,"ดินแดง","เขตดินแดง",102601,"ศาลาหอพระพุทธพาณิชย์ แฟลต ช.5",17,221,288,342,630
3160,"ดินแดง","เขตดินแดง",102601,"บริเวณใต้อาคารแฟลต 33 ดินแดง ถนนประชาสงเคราะห์",18,284,307,415,722
3161,"ดินแดง","เขตดินแดง",102601,"ศาลาหน้าหอพระแฟลต 40 ดินแดง ถนนประชาสงเคราะห์",19,269,329,393,722
3162,"ดินแดง","เขตดินแดง",102601,"บริเวณใต้อาคารแฟลต 40 ดินแดง ถนนประชาสงเคราะห์",20,320,377,470,847
3163,"ดินแดง","เขตดินแดง",102601,"บริเวณใต้อาคารแฟลต 40 ดินแดง ถนนประชาสงเคราะห์",21,321,361,443,804
3164,"ดินแดง","เขตดินแดง",102601,"บริเวณใต้อาคารแฟลต 44 ดินแดง ถนนประชาสงเคราะห์",22,268,347,447,794
3165,"ดินแดง","เขตดินแดง",102601,"เต็นท์บริเวณแฟลต 48 - 50 ถนนประชาสงเคราะห์",23,266,384,447,831
3166,"ดินแดง","เขตดินแดง",102601,"เต็นท์บริเวณแฟลต 52 - 54 ถนนประชาสงเคราะห์",24,213,270,384,654
3167,"ดินแดง","เขตดินแดง",102601,"โรงเรียนวิชูทิศ ถนนประชาสงเคราะห์",25,263,289,380,669
3168,"ดินแดง","เขตดินแดง",102601,"โรงเรียนวิชูทิศ ถนนประชาสงเคราะห์",26,248,284,388,672
3169,"ดินแดง","เขตดินแดง",102601,"โรงเรียนวิชูทิศ ถนนประชาสงเคราะห์",27,251,284,357,641
3170,"ดินแดง","เขตดินแดง",102601,"โรงเรียนวิชูทิศ ถนนประชาสงเคราะห์",28,205,275,346,621
3171,"ดินแดง","เขตดินแดง",102601,"โรงเรียนเทคนิควิทยา",29,208,230,301,531
3172,"ดินแดง","เขตดินแดง",102601,"โรงเรียนเทคนิควิทยา",30,283,274,380,654
3173,"ดินแดง","เขตดินแดง",102601,"โรงเรียนแม่พระฟาติมา ถนนอโศก - ดินแดง",31,289,371,429,800
3174,"ดินแดง","เขตดินแดง",102601,"โรงเรียนแม่พระฟาติมา ถนนอโศก - ดินแดง",32,290,373,426,799
3175,"ดินแดง","เขตดินแดง",102601,"โรงเรียนแม่พระฟาติมา ถนนอโศก - ดินแดง",33,282,372,413,785
3176,"ดินแดง","เขตดินแดง",102601,"โรงเรียนแม่พระฟาติมา ถนนอโศก - ดินแดง",34,567,314,532,846
3177,"ดินแดง","เขตดินแดง",102601,"บริเวณศาลาไทย เอ สเปซ ไอดี อโศก - รัชดา ถนนอโศกดินแดง",35,417,178,323,501
3178,"ดินแดง","เขตดินแดง",102601,"บริเวณศาลาไทย เอ สเปซ ไอดี อโศก - รัชดา ถนนอโศกดินแดง",36,486,241,334,575
3179,"ดินแดง","เขตดินแดง",102601,"ที่จอดรถตรงข้ามรัชดาอพาร์ทเม้น ซอยรัชดาภิเษก 3 แยก 14",37,356,378,458,836
3180,"ดินแดง","เขตดินแดง",102601,"ที่จอดรถตรงข้ามรัชดาอพาร์ทเม้นท์ ซอยรัชดาภิเษก 3 แยก 14",38,342,318,388,706
3181,"ดินแดง","เขตดินแดง",102601,"ที่จอดรถตรงข้ามรัชดาอพาร์ทเม้นท์ ซอยรัชดาภิเษก 3 แยก 14",39,365,402,449,851
3182,"ดินแดง","เขตดินแดง",102601,"ที่จอดรถใต้อาคารธนาคารกรุงเทพ สาขาอโศก - ดินแดง",40,254,330,389,719
3183,"ดินแดง","เขตดินแดง",102601,"ที่จอดรถใต้อาคารธนาคารกรุงเทพ สาขาอโศก - ดินแดง",41,264,313,441,754
3184,"ดินแดง","เขตดินแดง",102601,"เต็นท์บริเวณที่จอดรถธนาคารกรุงเทพ สาขาอโศก - ดินแดง",42,228,268,330,598
3185,"ดินแดง","เขตดินแดง",102601,"โดมลานกีฬาห้วยขวาง ถนนประชาสงเคราะห์",43,208,322,382,704
3186,"ดินแดง","เขตดินแดง",102601,"โดมลานกีฬาห้วยขวาง ถนนประชาสงเคราะห์",44,195,297,379,676
3187,"ดินแดง","เขตดินแดง",102601,"โดมลานกีฬาห้วยขวาง ถนนประชาสงเคราะห์",45,482,247,416,663
3188,"ดินแดง","เขตดินแดง",102601,"โรงเรียนสามเสนนอก",46,314,374,466,840
3189,"ดินแดง","เขตดินแดง",102601,"โรงเรียนสามเสนนอก",47,372,379,453,832
3190,"ดินแดง","เขตดินแดง",102601,"โรงเรียนสามเสนนอก",48,302,367,453,820
3191,"ดินแดง","เขตดินแดง",102601,"โรงเรียนสามเสนนอก",49,299,347,470,817
3192,"ดินแดง","เขตดินแดง",102601,"โรงเรียนสามเสนนอก",50,340,393,485,878
3193,"ดินแดง","เขตดินแดง",102601,"โรงเรียนอำนวยพิทยา",51,237,333,450,783
3194,"ดินแดง","เขตดินแดง",102601,"โรงเรียนอำนวยพิทยา",52,245,362,427,789
3195,"ดินแดง","เขตดินแดง",102601,"โรงเรียนอำนวยพิทยา",53,260,388,443,831
3196,"ดินแดง","เขตดินแดง",102601,"โรงเรียนอำนวยพิทยา",54,220,345,457,802
3197,"ดินแดง","เขตดินแดง",102601,"โรงเรียนกอบวิทยา",55,221,331,355,686
3198,"ดินแดง","เขตดินแดง",102601,"โรงเรียนกอบวิทยา",56,193,278,352,630
3199,"ดินแดง","เขตดินแดง",102601,"โรงเรียนกอบวิทยา",57,229,341,411,752
3200,"ดินแดง","เขตดินแดง",102601,"เต็นท์ลานจอดรถหน้า SV Place อพาร์ทเม้นท์ ซอยชานเมือง",58,265,306,415,721
3201,"ดินแดง","เขตดินแดง",102601,"เต็นท์ลานจอดรถหน้า SV Place อพาร์ทเม้นท์ ซอยชานเมือง",59,289,372,430,802
3202,"ดินแดง","เขตดินแดง",102601,"เต็นท์บริเวณหน้าบ้านเลขที่ 26/1-2 ซอยกรุณา",60,138,208,233,441
3203,"ดินแดง","เขตดินแดง",102601,"เต็นท์ลานจอดรถโรงแรม เดอะ เนอฟ รัชดา ซอยรัชดาภิเษก 3 แยก 4",61,226,293,321,614
3204,"ดินแดง","เขตดินแดง",102601,"เต็นท์ลานจอดรถโรงแรม เดอะ เนอฟ รัชดา ซอยรัชดาภิเษก 3 แยก 4",62,267,322,368,690
3205,"ดินแดง","เขตดินแดง",102601,"เต็นท์ลานจอดรถโรงแรม เดอะ เนอฟ รัชดา ซอยรัชดาภิเษก 3 แยก 4",63,317,282,403,685
3206,"ดินแดง","เขตดินแดง",102601,"เต็นท์หน้าซันนี่เฮลท์คลับ (สระว่ายน้ำซอยอยู่เจริญ 6)",64,228,263,341,604
3207,"ดินแดง","เขตดินแดง",102601,"เต็นท์หน้าซันนี่เฮลท์คลับ (สระว่ายน้ำซอยอยู่เจริญ 6)",65,263,291,350,641
3208,"ดินแดง","เขตดินแดง",102601,"เต็นท์หน้าซันนี่เฮลท์คลับ (สระว่ายน้ำซอยอยู่เจริญ 6)",66,426,281,375,656
3209,"ดินแดง","เขตดินแดง",102601,"โรงเรียนจันทรวิชา",67,149,229,284,513
3210,"ดินแดง","เขตดินแดง",102601,"โรงเรียนจันทรวิชา",68,415,272,411,683
3211,"ดินแดง","เขตดินแดง",102601,"บริเวณใต้อาคารแฟลต 1 ถนนดินแดง",69,242,359,432,791
3212,"ดินแดง","เขตดินแดง",102601,"บริเวณใต้อาคารแฟลต 2 ถนนดินแดง",70,321,378,489,867
3213,"ดินแดง","เขตดินแดง",102601,"บริเวณใต้อาคารแฟลต 4 ถนนดินแดง",71,173,260,279,539
3214,"ดินแดง","เขตดินแดง",102601,"บริเวณใต้อาคารแฟลต 5 ถนนดินแดง",72,187,296,333,629
3215,"ดินแดง","เขตดินแดง",102601,"บริเวณใต้อาคารแฟลต 5 ถนนดินแดง",73,305,352,427,779
3216,"ดินแดง","เขตดินแดง",102601,"บริเวณใต้อาคารแฟลต 5 ถนนดินแดง",74,224,306,389,695
3217,"ดินแดง","เขตดินแดง",102601,"บริเวณใต้อาคารแฟลต 6 ถนนดินแดง",75,220,289,377,666
3218,"ดินแดง","เขตดินแดง",102601,"บริเวณใต้อาคารแฟลต 6 ถนนดินแดง",76,171,255,305,560
3219,"ดินแดง","เขตดินแดง",102601,"บริเวณใต้อาคารแฟลต 7 ถนนดินแดง",77,159,198,266,464
3220,"ดินแดง","เขตดินแดง",102601,"บริเวณใต้อาคารแฟลต 8 ถนนดินแดง",78,185,217,244,461
3221,"ดินแดง","เขตดินแดง",102601,"บริเวณใต้อาคารแฟลต 11 ถนนดินแดง",79,234,277,332,609
3222,"ดินแดง","เขตดินแดง",102601,"บริเวณใต้อาคารแฟลต 12 ถนนดินแดง",80,289,240,353,593
3223,"ดินแดง","เขตดินแดง",102601,"บริเวณใต้อาคารแฟลต 14 ถนนดินแดง",81,207,240,311,551
3224,"ดินแดง","เขตดินแดง",102601,"บริเวณใต้อาคารแฟลต 16 ถนนดินแดง",82,318,275,387,662
3225,"ดินแดง","เขตดินแดง",102601,"บริเวณอาคารบ้านแม่พระฟาติมา โบสถ์แม่พระฟาติมา",83,203,293,366,659
3226,"ดินแดง","เขตดินแดง",102601,"เต็นท์หน้าอาคาร PM Tower ถนนอโศก - ดินแดง",84,201,240,274,514
3227,"รัชดาภิเษก","เขตดินแดง",102602,"บริเวณใต้อาคารคอนโดมิเนียมบ้านศรีสวัสดิ์ ซอยอินทามระ 41",1,302,364,442,806
3228,"รัชดาภิเษก","เขตดินแดง",102602,"บริเวณหน้าอาคารวิริยะถาวร ปากซอยอินทามระ 37",2,315,390,523,913
3229,"รัชดาภิเษก","เขตดินแดง",102602,"เต็นท์ตรงข้ามหมวดการทางสุทธิสาร (ใกล้ปากซอยวิภาวดีรังสิต 10)",3,161,199,260,459
3230,"รัชดาภิเษก","เขตดินแดง",102602,"เต็นท์ตรงข้ามหมวดการทางสุทธิสาร (ใกล้ปากซอยวิภาวดีรังสิต 10)",4,289,235,363,598
3231,"รัชดาภิเษก","เขตดินแดง",102602,"เต็นท์ตรงข้ามหมวดการทางสุทธิสาร (ใกล้ปากซอยวิภาวดีรังสิต 10)",5,312,283,385,668
3232,"รัชดาภิเษก","เขตดินแดง",102602,"เต็นท์ทางเท้าถนนวิภาวดีรังสิต ใกล้สถานีดับเพลิงสุทธิสาร",6,241,342,280,622
3233,"รัชดาภิเษก","เขตดินแดง",102602,"เต็นท์ทางเท้าถนนวิภาวดีรังสิต ใกล้สถานีดับเพลิงสุทธิสาร",7,289,348,288,636
3234,"รัชดาภิเษก","เขตดินแดง",102602,"เต็นท์ทางเท้าถนนวิภาวดีรังสิต ใกล้สถานีดับเพลิงสุทธิสาร",8,223,298,342,640
3235,"รัชดาภิเษก","เขตดินแดง",102602,"เต็นท์บริเวณอู่แท็กซี่ ซอยอินทามระ 34",9,240,294,353,647
3236,"รัชดาภิเษก","เขตดินแดง",102602,"เต็นท์บริเวณหน้าบ้านเลขที่ 24 ซอยอินทามระ 40",10,245,282,363,645
3237,"รัชดาภิเษก","เขตดินแดง",102602,"เต็นท์บริเวณหน้าบ้านเลขที่ 24 ซอยอินทามระ 40",11,157,203,250,453
3238,"รัชดาภิเษก","เขตดินแดง",102602,"โดมหลังคาวัดกุนนทีรุทธาราม",12,407,300,435,735
3239,"รัชดาภิเษก","เขตดินแดง",102602,"โดมหลังคาวัดกุนนทีรุทธาราม",13,226,311,402,713
3240,"รัชดาภิเษก","เขตดินแดง",102602,"โดมหลังคาวัดกุนนทีรุทธาราม",14,207,311,404,715
3241,"รัชดาภิเษก","เขตดินแดง",102602,"โดมหลังคาวัดกุนนทีรุทธาราม",15,270,332,427,759
3242,"รัชดาภิเษก","เขตดินแดง",102602,"ศูนย์พัฒนาเด็กก่อนวัยเรียน ชุมชนสุพรรณิการ์ 2 ซอยอินทามระ 44",16,214,259,336,595
3243,"รัชดาภิเษก","เขตดินแดง",102602,"โรงเรียนอนุบาลรุ่งโรจน์เนอสเซอรี่ ซอยประชาสงเคราะห์ 33",17,240,273,314,587
3244,"รัชดาภิเษก","เขตดินแดง",102602,"โรงเรียนอนุบาลรุ่งโรจน์เนอสเซอรี่ ซอยประชาสงเคราะห์ 33",18,209,265,332,597
3245,"รัชดาภิเษก","เขตดินแดง",102602,"วัดพรหมวงศาราม (ศาลาโรย)",19,280,416,457,873
3246,"รัชดาภิเษก","เขตดินแดง",102602,"วัดพรหมวงศาราม (ศาลาโรย)",20,402,354,497,851
3247,"รัชดาภิเษก","เขตดินแดง",102602,"โดมลานกีฬาหน้าสถานีตำรวจนครบาลดินแดง ถนนมิตรไมตรี",21,210,341,399,740
3248,"รัชดาภิเษก","เขตดินแดง",102602,"โดมลานกีฬาหน้าสถานีตำรวจนครบาลดินแดง ถนนมิตรไมตรี",22,185,357,376,733
3249,"รัชดาภิเษก","เขตดินแดง",102602,"โดมลานกีฬาหน้าสถานีตำรวจนครบาลดินแดง ถนนมิตรไมตรี",23,262,348,401,749
3250,"รัชดาภิเษก","เขตดินแดง",102602,"โดมลานกีฬาหน้าสถานีตำรวจนครบาลดินแดง ถนนมิตรไมตรี",24,240,344,386,730
3251,"รัชดาภิเษก","เขตดินแดง",102602,"โดมลานกีฬาหน้าสถานีตำรวจนครบาลดินแดง ถนนมิตรไมตรี",25,234,332,406,738
3252,"รัชดาภิเษก","เขตดินแดง",102602,"โดมลานกีฬาหน้าสถานีตำรวจนครบาลดินแดง ถนนมิตรไมตรี",26,235,392,389,781
3253,"รัชดาภิเษก","เขตดินแดง",102602,"โดมลานกีฬาหน้าสถานีตำรวจนครบาลดินแดง ถนนมิตรไมตรี",27,202,318,361,679
3254,"รัชดาภิเษก","เขตดินแดง",102602,"มหาวิทยาลัยหอการค้าไทย (ใต้อาคาร 3)",28,212,272,322,594
3255,"รัชดาภิเษก","เขตดินแดง",102602,"มหาวิทยาลัยหอการค้าไทย (ใต้อาคาร 3)",29,331,358,345,703
3256,"รัชดาภิเษก","เขตดินแดง",102602,"โรงเรียนปัญจทรัพย์ ซอยวิภาวดีรังสิต 16",30,213,251,321,572
3257,"รัชดาภิเษก","เขตดินแดง",102602,"โรงเรียนปัญจทรัพย์ ซอยวิภาวดีรังสิต 16",31,412,295,366,661
3258,"รัชดาภิเษก","เขตดินแดง",102602,"โรงเรียนปัญจทรัพย์ ซอยวิภาวดีรังสิต 16",32,178,319,325,644
3259,"รัชดาภิเษก","เขตดินแดง",102602,"เต็นท์บริเวณปากซอยอยู่เจริญ แยก 10/1 ซอยอินทามระ 41",33,318,401,462,863
3260,"รัชดาภิเษก","เขตดินแดง",102602,"เต็นท์บริเวณปากซอยอยู่เจริญ แยก 10/1 ซอยอินทามระ 41",34,284,400,460,860
3261,"รัชดาภิเษก","เขตดินแดง",102602,"อาคารบริเวณสถานีตำรวจนครบาลสุทธิสาร",35,460,356,452,808
3262,"รัชดาภิเษก","เขตดินแดง",102602,"อาคารบริเวณสถานีตำรวจนครบาลสุทธิสาร",36,354,326,421,747
3263,"รัชดาภิเษก","เขตดินแดง",102602,"เต็นท์บริเวณสถานีตำรวจนครบาลสุทธิสาร",37,622,315,405,720
3264,"รัชดาภิเษก","เขตดินแดง",102602,"เต็นท์บริเวณสถานีตำรวจนครบาลสุทธิสาร",38,506,309,460,769
3265,"รัชดาภิเษก","เขตดินแดง",102602,"เต็นท์บริเวณสถานีตำรวจนครบาลสุทธิสาร",39,227,348,432,780
3266,"รัชดาภิเษก","เขตดินแดง",102602,"โรงเรียนเตรียมอุดมศึกษาน้อมเกล้ากุนนที ซอยรัชดาภิเษก 15",40,133,254,275,529
3267,"รัชดาภิเษก","เขตดินแดง",102602,"โรงเรียนเตรียมอุดมศึกษาน้อมเกล้ากุนนที ซอยรัชดาภิเษก 15",41,324,304,368,672
3268,"รัชดาภิเษก","เขตดินแดง",102602,"บริเวณที่จอดรถอาคารแกลเลอเรียแมนชั่น ซอยประชาราษฎร์บำเพ็ญ 1",42,167,261,269,530
3269,"รัชดาภิเษก","เขตดินแดง",102602,"เต็นท์บริเวณศูนย์กีฬาและนันทนาการ (แฟลต 7 - 8 ห้วยขวาง)",43,153,201,263,464
3270,"รัชดาภิเษก","เขตดินแดง",102602,"เต็นท์บริเวณศูนย์กีฬาและนันทนาการ (แฟลต 7 - 8 ห้วยขวาง)",44,158,214,250,464
3271,"รัชดาภิเษก","เขตดินแดง",102602,"บริเวณใต้อาคารแฟลต 9 ห้วยขวาง",45,250,344,410,754
3272,"รัชดาภิเษก","เขตดินแดง",102602,"บริเวณใต้อาคารแฟลต 12 ห้วยขวาง",46,241,342,403,745
3273,"รัชดาภิเษก","เขตดินแดง",102602,"เต็นท์บริเวณลานกีฬาแฟลต 15 ห้วยขวาง",47,236,311,409,720
3274,"รัชดาภิเษก","เขตดินแดง",102602,"บริเวณใต้อาคารแฟลต 19 ห้วยขวาง",48,158,216,279,495
3275,"รัชดาภิเษก","เขตดินแดง",102602,"บริเวณใต้อาคารแฟลต 19 ห้วยขวาง",49,158,195,300,495
3276,"รัชดาภิเษก","เขตดินแดง",102602,"เต็นท์บริเวณลานกีฬาแฟลต 22 ห้วยขวาง",50,243,270,419,689
3277,"รัชดาภิเษก","เขตดินแดง",102602,"เต็นท์บริเวณลานกีฬาแฟลต 22 ห้วยขวาง",51,254,331,404,735
3278,"รัชดาภิเษก","เขตดินแดง",102602,"เต็นท์บริเวณลานจอดรถแฟลต 28 ห้วยขวาง",52,296,426,495,921
3279,"คลองกุ่ม","เขตบึงกุ่ม",102701,"บริเวณแฟลตข้าราชการและลูกจ้างเขตบึงกุ่ม",1,173,215,221,436
3280,"คลองกุ่ม","เขตบึงกุ่ม",102701,"บริเวณแฟลตข้าราชการและลูกจ้างเขตบึงกุ่ม",2,219,191,226,417
3281,"คลองกุ่ม","เขตบึงกุ่ม",102701,"เต็นท์บริเวณใกล้กับศูนย์ชุมชนโครงการบ้านเอื้ออาทรบึงกุ่ม",3,323,283,371,654
3282,"คลองกุ่ม","เขตบึงกุ่ม",102701,"เต็นท์บริเวณใกล้กับศูนย์ชุมชนโครงการบ้านเอื้ออาทรบึงกุ่ม",4,338,282,379,661
3283,"คลองกุ่ม","เขตบึงกุ่ม",102701,"เต็นท์บริเวณใกล้กับศูนย์ชุมชนโครงการบ้านเอื้ออาทรบึงกุ่ม",5,317,285,370,655
3284,"คลองกุ่ม","เขตบึงกุ่ม",102701,"เต็นท์บริเวณใกล้กับศูนย์ชุมชนโครงการบ้านเอื้ออาทรบึงกุ่ม",6,329,289,345,634
3285,"คลองกุ่ม","เขตบึงกุ่ม",102701,"ศูนย์ชุมชนโครงการบ้านเอื้ออาทรบึงกุ่ม",7,345,279,374,653
3286,"คลองกุ่ม","เขตบึงกุ่ม",102701,"เต็นท์บริเวณหน้าศูนย์ชุมชนโครงการบ้านเอื้ออาทรบึงกุ่ม",8,302,247,330,577
3287,"คลองกุ่ม","เขตบึงกุ่ม",102701,"เต็นท์บริเวณหน้าศูนย์ชุมชนโครงการบ้านเอื้ออาทรบึงกุ่ม",9,317,267,308,575
3288,"คลองกุ่ม","เขตบึงกุ่ม",102701,"เต็นท์บริเวณหน้าศูนย์ชุมชนโครงการบ้านเอื้ออาทรบึงกุ่ม",10,307,250,321,571
3289,"คลองกุ่ม","เขตบึงกุ่ม",102701,"เต็นท์บริเวณลานกีฬาโครงการบ้านเอื้ออาทรบึงกุ่ม ระหว่างตึก 60-62",11,338,285,380,665
3290,"คลองกุ่ม","เขตบึงกุ่ม",102701,"เต็นท์บริเวณลานกีฬาโครงการบ้านเอื้ออาทรบึงกุ่มระหว่างตึก 60-62",12,336,294,379,673
3291,"คลองกุ่ม","เขตบึงกุ่ม",102701,"เต็นท์บริเวณลานกีฬาโครงการบ้านเอื้ออาทรบึงกุ่มระหว่างตึก 60-62",13,333,305,378,683
3292,"คลองกุ่ม","เขตบึงกุ่ม",102701,"เต็นท์บริเวณลานกีฬาโครงการบ้านเอื้ออาทรบึงกุ่มระหว่างตึก 60-62",14,333,307,378,685
3293,"คลองกุ่ม","เขตบึงกุ่ม",102701,"โรงเรียนสุขุมนวพันธ์อุปถัมภ์ (ลานราชพฤกษ์) ซอยเสรีไทย 41",15,181,367,383,750
3294,"คลองกุ่ม","เขตบึงกุ่ม",102701,"โรงเรียนสุขุมนวพันธ์อุปถัมภ์ (ลานราชพฤกษ์) ซอยเสรีไทย 41",16,181,346,413,759
3295,"คลองกุ่ม","เขตบึงกุ่ม",102701,"โรงเรียนสุขุมนวพันธ์อุปถัมภ์ (สนามเปตอง) ซอยเสรีไทย 41",17,267,372,466,838
3296,"คลองกุ่ม","เขตบึงกุ่ม",102701,"เต็นท์บริเวณลานอเนกประสงค์หมู่บ้านวังทองวิลเลจ 1 ซอยเสรีไทย 41",18,273,338,415,753
3297,"คลองกุ่ม","เขตบึงกุ่ม",102701,"เต็นท์บริเวณลานอเนกประสงค์หมู่บ้านวังทองวิลเลจ 1ซอยเสรีไทย 41",19,281,312,418,730
3298,"คลองกุ่ม","เขตบึงกุ่ม",102701,"โรงเรียนคลองกุ่ม (เสรีไทย อนุสรณ์) ซอยเสรีไทย 53",20,485,417,509,926
3299,"คลองกุ่ม","เขตบึงกุ่ม",102701,"โรงเรียนคลองกุ่ม (เสรีไทย อนุสรณ์) ซอยเสรีไทย 53",21,262,413,495,908
3300,"คลองกุ่ม","เขตบึงกุ่ม",102701,"เต็นท์บริเวณสวนปฏิบัติธรรม (ซอย 24) หมู่บ้านสหกรณ์ฯซอยเสรีไทย 57",22,297,384,482,866
3301,"คลองกุ่ม","เขตบึงกุ่ม",102701,"เต็นท์บริเวณสวนปฏิบัติธรรม (ซอย 24) หมู่บ้านสหกรณ์ฯซอยเสรีไทย 57",23,308,382,478,860
3302,"คลองกุ่ม","เขตบึงกุ่ม",102701,"เต็นท์บริเวณสวนปฏิบัติธรรม (ซอย 24) หมู่บ้านสหกรณ์ฯซอยเสรีไทย 57",24,308,363,466,829
3303,"คลองกุ่ม","เขตบึงกุ่ม",102701,"เต็นท์บริเวณสนามเทนนิส (สวนเฟต 5) หมู่บ้านสหกรณ์ฯซอยเสรีไทย 57",25,282,345,450,795
3304,"คลองกุ่ม","เขตบึงกุ่ม",102701,"เต็นท์บริเวณสนามเทนนิส (สวนเฟต 5) หมู่บ้านสหกรณ์ฯซอยเสรีไทย 57",26,260,351,447,798
3305,"คลองกุ่ม","เขตบึงกุ่ม",102701,"เต็นท์บริเวณสนามเทนนิส (สวนเฟต 5) หมู่บ้านสหกรณ์ฯซอยเสรีไทย 57",27,262,408,407,815
3306,"คลองกุ่ม","เขตบึงกุ่ม",102701,"อาคารอเนกประสงค์ชุมชนอัสสลาม ซอยเสรีไทย 24",28,141,352,369,721
3307,"คลองกุ่ม","เขตบึงกุ่ม",102701,"โรงเรียนชินวร ซอยเสรีไทย 12",29,384,287,443,730
3308,"คลองกุ่ม","เขตบึงกุ่ม",102701,"โรงเรียนชินวร ซอยเสรีไทย 12",30,406,271,424,695
3309,"คลองกุ่ม","เขตบึงกุ่ม",102701,"โรงเรียนชินวร ซอยเสรีไทย 12",31,261,304,389,693
3310,"คลองกุ่ม","เขตบึงกุ่ม",102701,"โรงเรียนชินวร ซอยเสรีไทย 12",32,268,275,386,661
3311,"คลองกุ่ม","เขตบึงกุ่ม",102701,"โรงเรียนชินวร ซอยเสรีไทย 12",33,255,288,377,665
3312,"คลองกุ่ม","เขตบึงกุ่ม",102701,"เต็นท์บริเวณหมู่บ้านเสริมสุข ซอยเสรีไทย 23",34,402,396,454,850
3313,"คลองกุ่ม","เขตบึงกุ่ม",102701,"โรงเรียนพิชัยพัฒนา ถนนเสรีไทย",35,155,297,347,644
3314,"คลองกุ่ม","เขตบึงกุ่ม",102701,"โรงเรียนพิชัยพัฒนา ถนนเสรีไทย",36,210,287,364,651
3315,"คลองกุ่ม","เขตบึงกุ่ม",102701,"โรงเรียนพิชัยพัฒนา ถนนเสรีไทย",37,232,332,327,659
3316,"คลองกุ่ม","เขตบึงกุ่ม",102701,"โรงเรียนพิชัยพัฒนา ถนนเสรีไทย",38,193,326,347,673
3317,"คลองกุ่ม","เขตบึงกุ่ม",102701,"โรงเรียนพิชัยพัฒนา ถนนเสรีไทย",39,279,308,330,638
3318,"คลองกุ่ม","เขตบึงกุ่ม",102701,"โรงเรียนพิชัยพัฒนา ถนนเสรีไทย",40,281,280,353,633
3319,"คลองกุ่ม","เขตบึงกุ่ม",102701,"เต็นท์บริเวณอาคารชุดเคหะบางกะปิ2 ซอยนวมินทร์ 24 แยก 1",41,382,300,395,695
3320,"คลองกุ่ม","เขตบึงกุ่ม",102701,"เต็นท์บริเวณอาคารชุดเคหะบางกะปิ2 ซอยนวมินทร์ 24 แยก 1",42,363,316,375,691
3321,"คลองกุ่ม","เขตบึงกุ่ม",102701,"เต็นท์บริเวณด้านข้างสโมสรหมู่บ้านศรีนครพัฒนา ซอยศรีนคร (นวมินทร์ 24)",43,251,294,370,664
3322,"คลองกุ่ม","เขตบึงกุ่ม",102701,"เต็นท์บริเวณด้านข้างสโมสรหมู่บ้านศรีนครพัฒนา ซอยศรีนคร (นวมินทร์ 24)",44,222,306,342,648
3323,"คลองกุ่ม","เขตบึงกุ่ม",102701,"เต็นท์บริเวณหมู่บ้านศรีนครพัฒนา (ปากซอยอุเทน 17) ซอยนวมินทร์ 24",45,156,275,326,601
3324,"คลองกุ่ม","เขตบึงกุ่ม",102701,"เต็นท์บริเวณหมู่บ้านศรีนครพัฒนา (ปากซอยอุเทน 17) ซอยนวมินทร์ 24",46,210,286,313,599
3325,"คลองกุ่ม","เขตบึงกุ่ม",102701,"เต็นท์บริเวณหมู่บ้านศรีนครพัฒนา (ปากซอยอุเทน 17) ซอยนวมินทร์ 24",47,216,283,317,600
3326,"คลองกุ่ม","เขตบึงกุ่ม",102701,"บริเวณศูนย์พัฒนาเด็กเล็กชุมชนสามัคคีพัฒนา (ซอยบุญส่งโสพิศ) ซอยนวมินทร์ 26",48,196,275,336,611
3327,"คลองกุ่ม","เขตบึงกุ่ม",102701,"บริเวณศูนย์พัฒนาเด็กเล็กชุมชนสามัคคีพัฒนา (ซอยบุญส่งโสพิศ)ซอยนวมินทร์ 26",49,221,298,323,621
3328,"คลองกุ่ม","เขตบึงกุ่ม",102701,"เต็นท์บริเวณที่ว่างข้างธนาคารกสิกรไทย ระหว่างซอยนวมินทร์ 36-38",50,415,446,543,989
3329,"คลองกุ่ม","เขตบึงกุ่ม",102701,"เต็นท์บริเวณที่ว่างข้างธนาคารกสิกรไทย ระหว่างซอยนวมินทร์ 36-38",51,367,463,542,1005
3330,"คลองกุ่ม","เขตบึงกุ่ม",102701,"เต็นท์บริเวณที่ว่างข้างธนาคารกสิกรไทย ระหว่างซอยนวมินทร์ 36-38",52,405,426,554,980
3331,"คลองกุ่ม","เขตบึงกุ่ม",102701,"เต็นท์บริเวณที่ว่างข้างธนาคารกสิกรไทย ระหว่างซอยนวมินทร์ 36-38",53,340,388,561,949
3332,"คลองกุ่ม","เขตบึงกุ่ม",102701,"เต็นท์บริเวณที่ว่างข้างธนาคารกสิกรไทย ระหว่างซอยนวมินทร์ 36-38",54,702,372,574,946
3333,"คลองกุ่ม","เขตบึงกุ่ม",102701,"เต็นท์บริเวณที่ว่างข้างธนาคารกสิกรไทย ระหว่างซอยนวมินทร์ 36-38",55,585,411,580,991
3334,"คลองกุ่ม","เขตบึงกุ่ม",102701,"บริเวณที่จอดรถลานอเนกประสงค์หมู่บ้านสุวรรณนิเวศน์ซอยนวมินทร์ 42",56,450,382,561,943
3335,"คลองกุ่ม","เขตบึงกุ่ม",102701,"บริเวณที่จอดรถลานอเนกประสงค์หมู่บ้านสุวรรณนิเวศน์ซอยนวมินทร์ 42",57,316,407,533,940
3336,"คลองกุ่ม","เขตบึงกุ่ม",102701,"บริเวณที่จอดรถลานอเนกประสงค์หมู่บ้านสุวรรณนิเวศน์ซอยนวมินทร์ 42",58,305,423,539,962
3337,"คลองกุ่ม","เขตบึงกุ่ม",102701,"บริเวณที่จอดรถลานอเนกประสงค์หมู่บ้านสุวรรณนิเวศน์ซอยนวมินทร์ 42",59,452,421,541,962
3338,"คลองกุ่ม","เขตบึงกุ่ม",102701,"เต็นท์บริเวณสนามเด็กเล่นหมู่บ้านสินธนากรีนวิลล์ (ซอยจำเป็น)ซอยนวมินทร์ 50",60,293,321,434,755
3339,"คลองกุ่ม","เขตบึงกุ่ม",102701,"เต็นท์บริเวณสนามเด็กเล่นหมู่บ้านสินธนากรีนวิลล์ (ซอยจำเป็น)ซอยนวมินทร์ 50",61,300,352,449,801
3340,"คลองกุ่ม","เขตบึงกุ่ม",102701,"โรงเรียนวัดบางเตย ซอยนวมินทร์ 62",62,287,275,321,596
3341,"คลองกุ่ม","เขตบึงกุ่ม",102701,"โรงเรียนวัดบางเตย ซอยนวมินทร์ 62",63,213,262,318,580
3342,"คลองกุ่ม","เขตบึงกุ่ม",102701,"เต็นท์บริเวณหน้าอาคารหมู่บ้านธนะสิน ซอยนวมินทร์ 66",64,277,303,394,697
3343,"คลองกุ่ม","เขตบึงกุ่ม",102701,"เต็นท์บริเวณหน้าอาคารหมู่บ้านธนะสิน ซอยนวมินทร์ 66",65,272,297,402,699
3344,"คลองกุ่ม","เขตบึงกุ่ม",102701,"เต็นท์บริเวณหน้าอาคารหมู่บ้านธนะสิน ซอยนวมินทร์ 66",66,254,304,394,698
3345,"คลองกุ่ม","เขตบึงกุ่ม",102701,"เต็นท์บริเวณหน้าอาคารหมู่บ้านธนะสิน ซอยนวมินทร์ 66",67,276,305,408,713
3346,"คลองกุ่ม","เขตบึงกุ่ม",102701,"เต็นท์บริเวณสนามเด็กเล่นหมู่บ้านกรุงเทพเสริมมิตรซอยนวมินทร์ 68 แยก 8",68,228,285,339,624
3347,"คลองกุ่ม","เขตบึงกุ่ม",102701,"เต็นท์บริเวณสนามเด็กเล่นหมู่บ้านกรุงเทพเสริมมิตรซอยนวมินทร์ 68 แยก 8",69,325,301,391,692
3348,"คลองกุ่ม","เขตบึงกุ่ม",102701,"ที่ทำการชุมชนสุวรรณประสิทธิ์ 3 ซอยประเสริฐมนูกิจ 48",70,169,316,381,697
3349,"คลองกุ่ม","เขตบึงกุ่ม",102701,"โรงเรียนบดินทรเดชา (สิงห์ สิงหเสนี) 2 ซอยนวมินทร์ 72",71,208,396,423,819
3350,"คลองกุ่ม","เขตบึงกุ่ม",102701,"โรงเรียนบดินทรเดชา (สิงห์ สิงหเสนี) 2 ซอยนวมินทร์ 72",72,402,367,456,823
3351,"คลองกุ่ม","เขตบึงกุ่ม",102701,"โรงเรียนบดินทรเดชา (สิงห์ สิงหเสนี) 2 ซอยนวมินทร์ 72",73,329,393,439,832
3352,"คลองกุ่ม","เขตบึงกุ่ม",102701,"โรงเรียนบดินทรเดชา (สิงห์ สิงหเสนี) 2 ซอยนวมินทร์ 72",74,297,350,464,814
3353,"คลองกุ่ม","เขตบึงกุ่ม",102701,"โรงเรียนบดินทรเดชา (สิงห์ สิงหเสนี) 2 ซอยนวมินทร์ 72",75,348,370,456,826
3354,"นวมินทร์","เขตบึงกุ่ม",102704,"สโมสรหมู่บ้านวังทองเฮ้าส์ ซอยนวมินทร์ 57",1,343,310,445,755
3355,"นวมินทร์","เขตบึงกุ่ม",102704,"เต็นท์บริเวณสนามเด็กเล่นหมู่บ้านวังทองเฮ้าส์ ซอยนวมินทร์ 57",2,299,302,393,695
3356,"นวมินทร์","เขตบึงกุ่ม",102704,"บริเวณที่จอดรถ พีพี แอร์ เซอร์วิส ระหว่างซอยนวมินทร์ 61-63",3,166,198,237,435
3357,"นวมินทร์","เขตบึงกุ่ม",102704,"บริเวณที่จอดรถ พีพี แอร์ เซอร์วิส ระหว่างซอยนวมินทร์ 61-63",4,144,209,233,442
3358,"นวมินทร์","เขตบึงกุ่ม",102704,"เต็นท์บริเวณในโรงเรียนอนุบาลลูกหนู ซอยนวมินทร์ 71",5,303,279,402,681
3359,"นวมินทร์","เขตบึงกุ่ม",102704,"เต็นท์บริเวณในโรงเรียนอนุบาลลูกหนู ซอยนวมินทร์ 71",6,241,283,372,655
3360,"นวมินทร์","เขตบึงกุ่ม",102704,"เต็นท์บริเวณสนามเด็กเล่นหมู่บ้านโชคชัยปัญจทรัพย์ซอยนวมินทร์ 81",7,231,287,371,658
3361,"นวมินทร์","เขตบึงกุ่ม",102704,"เต็นท์บริเวณสนามเด็กเล่นหมู่บ้านโชคชัยปัญจทรัพย์ซอยนวมินทร์ 81",8,242,291,359,650
3362,"นวมินทร์","เขตบึงกุ่ม",102704,"เต็นท์บริเวณสนามเด็กเล่นหมู่บ้านโชคชัยปัญจทรัพย์ซอยนวมินทร์ 81",9,231,281,381,662
3363,"นวมินทร์","เขตบึงกุ่ม",102704,"เต็นท์บริเวณสนามเด็กเล่นหมู่บ้านโชคชัยปัญจทรัพย์ซอยนวมินทร์ 81",10,254,269,379,648
3364,"นวมินทร์","เขตบึงกุ่ม",102704,"เต็นท์บริเวณลานจอดรถใกล้ปากซอยหมู่บ้านทวีทรัพย์ 2ซอยนวมินทร์ 87",11,322,315,429,744
3365,"นวมินทร์","เขตบึงกุ่ม",102704,"เต็นท์บริเวณลานจอดรถใกล้ปากซอยหมู่บ้านทวีทรัพย์ 2ซอยนวมินทร์ 87",12,280,286,376,662
3366,"นวมินทร์","เขตบึงกุ่ม",102704,"เต็นท์บริเวณลานอเนกประสงค์และลานกีฬาฯ หมู่บ้านสินธานี 1ซอยนวมินทร์ 93",13,246,243,306,549
3367,"นวมินทร์","เขตบึงกุ่ม",102704,"เต็นท์บริเวณลานอเนกประสงค์และลานกีฬาฯ หมู่บ้านสินธานี 1ซอยนวมินทร์ 93",14,225,244,317,561
3368,"นวมินทร์","เขตบึงกุ่ม",102704,"เต็นท์บริเวณลานอเนกประสงค์และลานกีฬาฯ หมู่บ้านสินธานี 1ซอยนวมินทร์ 93",15,247,237,355,592
3369,"นวมินทร์","เขตบึงกุ่ม",102704,"เต็นท์บริเวณลานอเนกประสงค์และลานกีฬาฯ หมู่บ้านสินธานี 1ซอยนวมินทร์ 93",16,233,262,334,596
3370,"นวมินทร์","เขตบึงกุ่ม",102704,"เต็นท์บริเวณด้านข้างสำนักงานประกันสังคมพื้นที่ 9ปากซอยนวมินทร์ 93",17,292,344,446,790
3371,"นวมินทร์","เขตบึงกุ่ม",102704,"เต็นท์บริเวณสนามเด็กเล่นหมู่บ้านยลประภาซอยโพธิ์แก้ว แยก 4",18,240,285,345,630
3372,"นวมินทร์","เขตบึงกุ่ม",102704,"เต็นท์บริเวณหน้าบริษัท ไทกอน ดีไซน์ กรุ๊ป หมู่บ้านยลประภา ซอยโพธิ์แก้ว แยก 4",19,287,282,374,656
3373,"นวมินทร์","เขตบึงกุ่ม",102704,"เต็นท์บริเวณหน้าบริษัท ไทกอน ดีไซน์ กรุ๊ป หมู่บ้านยลประภา ซอยโพธิ์แก้ว แยก  4",20,283,261,415,676
3374,"นวมินทร์","เขตบึงกุ่ม",102704,"เต็นท์บริเวณหน้าบริษัท ไทกอน ดีไซน์ กรุ๊ป หมู่บ้านยลประภา ซอยโพธิ์แก้ว แยก 4",21,296,302,376,678
3375,"นวมินทร์","เขตบึงกุ่ม",102704,"เต็นท์บริเวณลานกีฬา ซอย 10 หมู่บ้านสามัคคี 53ซอยนวมินทร์ 105",22,237,287,356,643
3376,"นวมินทร์","เขตบึงกุ่ม",102704,"เต็นท์บริเวณลานกีฬา ซอย 10 หมู่บ้านสามัคคี 53ซอยนวมินทร์ 105",23,259,308,359,667
3377,"นวมินทร์","เขตบึงกุ่ม",102704,"เต็นท์บริเวณโรงเรียนคลองลำเจียก (หวังทองบำรุง) ถนนประเสริฐมนูกิจ",24,286,324,350,674
3378,"นวมินทร์","เขตบึงกุ่ม",102704,"เต็นท์บริเวณโรงเรียนคลองลำเจียก (หวังทองบำรุง) ถนนประเสริฐมนูกิจ",25,275,309,371,680
3379,"นวมินทร์","เขตบึงกุ่ม",102704,"เต็นท์บริเวณโรงเรียนคลองลำเจียก (หวังทองบำรุง) ถนนประเสริฐมนูกิจ",26,262,307,373,680
3380,"นวมินทร์","เขตบึงกุ่ม",102704,"เต็นท์บริเวณลานอเนกประสงค์หมู่บ้านสราญรมย์ซอยประเสริฐมนูกิจ 42",27,253,286,350,636
3381,"นวมินทร์","เขตบึงกุ่ม",102704,"เต็นท์บริเวณลานอเนกประสงค์หมู่บ้านสราญรมย์ซอยประเสริฐมนูกิจ 42",28,235,300,344,644
3382,"นวมินทร์","เขตบึงกุ่ม",102704,"เต็นท์บริเวณหน้าเอสอาร์พาร์ค อพาร์ทเม้นท์ (ใกล้ซอยพึ่งเฮง)ถนนประเสริฐมนูกิจ",29,248,291,366,657
3383,"นวมินทร์","เขตบึงกุ่ม",102704,"เต็นท์บริเวณลานจอดรถมหาทรัพย์คอนโด ซอยประเสริฐมนูกิจ 40",30,484,412,480,892
3384,"นวมินทร์","เขตบึงกุ่ม",102704,"โรงเรียนคลองลำเจียก (หวังทองบำรุง) ถนนประเสริฐมนูกิจ",31,445,386,561,947
3385,"นวมินทร์","เขตบึงกุ่ม",102704,"โรงเรียนคลองลำเจียก (หวังทองบำรุง) ถนนประเสริฐมนูกิจ",32,357,414,506,920
3386,"นวมินทร์","เขตบึงกุ่ม",102704,"โรงเรียนคลองลำเจียก (หวังทองบำรุง) ถนนประเสริฐมนูกิจ",33,310,469,465,934
3387,"นวลจันทร์","เขตบึงกุ่ม",102705,"เต็นท์ด้านข้างห้าง ท็อป มาร์เก็ต (หลังป้อมตำรวจ) ถนนประเสริฐมนูกิจ",1,319,364,428,792
3388,"นวลจันทร์","เขตบึงกุ่ม",102705,"เต็นท์ด้านข้างห้าง ท็อป มาร์เก็ต (หลังป้อมตำรวจ)ถนนประเสริฐมนูกิจ",2,311,382,392,774
3389,"นวลจันทร์","เขตบึงกุ่ม",102705,"เต็นท์ด้านข้างห้าง ท็อป มาร์เก็ต (หลังป้อมตำรวจ)ถนนประเสริฐมนูกิจ",3,294,348,430,778
3390,"นวลจันทร์","เขตบึงกุ่ม",102705,"เต็นท์บริเวณลานกีฬาหมู่บ้านราณี 3 ซอยนวมินทร์ 135 แยก 2-2",4,350,352,438,790
3391,"นวลจันทร์","เขตบึงกุ่ม",102705,"เต็นท์บริเวณแฟลตการเคหะนวมินทร์ (บริเวณด้านหน้าบ้านหนังสือกรุงเทพฯ) ซอยนวมินทร์ 139",5,289,334,429,763
3392,"นวลจันทร์","เขตบึงกุ่ม",102705,"เต็นท์บริเวณแฟลตการเคหะนวมินทร์ (บริเวณด้านหน้าบ้านหนังสือกรุงเทพฯ) ซอยนวมินทร์ 139",6,334,342,416,758
3393,"นวลจันทร์","เขตบึงกุ่ม",102705,"เต็นท์บริเวณสนามกีฬาในหมู่บ้านซื่อตรง 39 ซอยนวมินทร์ 143",7,362,361,519,880
3394,"นวลจันทร์","เขตบึงกุ่ม",102705,"เต็นท์บริเวณที่จอดรถหน้าหมู่บ้านซันไรซ์กรีน ซอยนวมินทร์ 143",8,261,278,354,632
3395,"นวลจันทร์","เขตบึงกุ่ม",102705,"เต็นท์บริเวณลานที่ว่างหน้าบริษัท แอล ฮาร์ดแวร์ แอนด์เซอร์วิสซอยนวมินทร์ 149",9,245,263,359,622
3396,"นวลจันทร์","เขตบึงกุ่ม",102705,"เต็นท์บริเวณลานที่ว่างหน้าบริษัท แอล ฮาร์ดแวร์ แอนด์เซอร์วิสซอยนวมินทร์ 149",10,260,265,377,642
3397,"นวลจันทร์","เขตบึงกุ่ม",102705,"เต็นท์บริเวณลานที่ว่างหน้าบริษัท แอล ฮาร์ดแวร์ แอนด์เซอร์วิสซอยนวมินทร์ 149",11,268,283,379,662
3398,"นวลจันทร์","เขตบึงกุ่ม",102705,"เต็นท์บริเวณหน้าหมู่บ้านพรบดินทร ซอยนวมินทร์ 157 แยก 6",12,484,372,516,888
3399,"นวลจันทร์","เขตบึงกุ่ม",102705,"เต็นท์บริเวณหน้าหมู่บ้านพรบดินทร ซอยนวมินทร์ 157 แยก 6",13,351,376,507,883
3400,"นวลจันทร์","เขตบึงกุ่ม",102705,"โรงเรียนแย้มจาดวิชชานุสรณ์ ซอยนวมินทร์ 163",14,444,376,461,837
3401,"นวลจันทร์","เขตบึงกุ่ม",102705,"โรงเรียนแย้มจาดวิชชานุสรณ์ ซอยนวมินทร์ 163",15,332,382,453,835
3402,"นวลจันทร์","เขตบึงกุ่ม",102705,"โรงเรียนแย้มจาดวิชชานุสรณ์ ซอยนวมินทร์ 163",16,344,381,456,837
3403,"นวลจันทร์","เขตบึงกุ่ม",102705,"เต็นท์บริเวณหน้าห้างสรรพสินค้าเทสโก้โลตัส ถนนนวมินทร์",17,523,452,514,966
3404,"นวลจันทร์","เขตบึงกุ่ม",102705,"เต็นท์บริเวณหน้าห้างสรรพสินค้าเทสโก้โลตัส ถนนนวมินทร์",18,320,425,532,957
3405,"นวลจันทร์","เขตบึงกุ่ม",102705,"เต็นท์บริเวณหน้าห้างสรรพสินค้าเทสโก้โลตัส ถนนนวมินทร์",19,375,402,534,936
3406,"นวลจันทร์","เขตบึงกุ่ม",102705,"เต็นท์บริเวณหน้าห้างสรรพสินค้าเทสโก้โลตัส ถนนนวมินทร์",20,491,390,553,943
3407,"นวลจันทร์","เขตบึงกุ่ม",102705,"เต็นท์บริเวณสนามเทนนิสหมู่บ้านอัมรินทร์นิเวศน์ 2ซอยนวมินทร์ 90",21,211,239,324,563
3408,"นวลจันทร์","เขตบึงกุ่ม",102705,"เต็นท์บริเวณด้านหน้ามัสยิดมิฟตาฮุ้นยีนาน ซอยคลองลำเจียก 15",22,456,341,414,755
3409,"นวลจันทร์","เขตบึงกุ่ม",102705,"เต็นท์บริเวณด้านหน้ามัสยิดมิฟตาฮุ้นยีนาน ซอยคลองลำเจียก 15",23,264,334,393,727
3410,"นวลจันทร์","เขตบึงกุ่ม",102705,"เต็นท์บริเวณด้านหน้ามัสยิดมิฟตาฮุ้นยีนาน ซอยคลองลำเจียก 15",24,412,305,446,751
3411,"นวลจันทร์","เขตบึงกุ่ม",102705,"เต็นท์บริเวณลานอเนกประสงค์หมู่บ้านสวนทิพย์ ซอยคลองลำเจียก 12",25,245,287,341,628
3412,"นวลจันทร์","เขตบึงกุ่ม",102705,"เต็นท์บริเวณลานอเนกประสงค์หมู่บ้านสวนทิพย์ ซอยคลองลำเจียก 12",26,264,269,356,625
3413,"นวลจันทร์","เขตบึงกุ่ม",102705,"เต็นท์บริเวณสนามเด็กเล่นหมู่บ้านเสนา 88 ซอยคลองลำเจียก 8",27,258,266,372,638
3414,"นวลจันทร์","เขตบึงกุ่ม",102705,"เต็นท์บริเวณสนามเด็กเล่นหมู่บ้านเสนา 88 ซอยคลองลำเจียก 8",28,247,272,366,638
3415,"นวลจันทร์","เขตบึงกุ่ม",102705,"เต็นท์บริเวณสนามเด็กเล่นหมู่บ้านเสนา 88 ซอยคลองลำเจียก 8",29,305,267,373,640
3416,"นวลจันทร์","เขตบึงกุ่ม",102705,"เต็นท์บริเวณลานจอดรถด้านหน้าการไฟฟ้านครหลวงเขตนวลจันทร์ถนนคลองลำเจียก",30,289,377,437,814
3417,"นวลจันทร์","เขตบึงกุ่ม",102705,"เต็นท์บริเวณลานจอดรถด้านหน้าการไฟฟ้านครหลวงเขตนวลจันทร์ถนนคลองลำเจียก",31,312,377,425,802
3418,"นวลจันทร์","เขตบึงกุ่ม",102705,"เต็นท์บริเวณลานจอดรถด้านหน้าการไฟฟ้านครหลวงเขตนวลจันทร์ถนนคลองลำเจียก",32,371,363,469,832
3419,"นวลจันทร์","เขตบึงกุ่ม",102705,"เต็นท์บริเวณที่จอดรถด้านหลังตลาดบ้านนวลจันทร์ ซอยนวลจันทร์ 38",33,339,402,488,890
3420,"นวลจันทร์","เขตบึงกุ่ม",102705,"เต็นท์บริเวณที่จอดรถด้านหลังตลาดบ้านนวลจันทร์ซอยนวลจันทร์ 38",34,363,377,504,881
3421,"นวลจันทร์","เขตบึงกุ่ม",102705,"เต็นท์บริเวณสนามเด็กเล่นหมู่บ้านเคหะธานี 2ซอยนวลจันทร์ 56 แยก 1",35,258,306,418,724
3422,"นวลจันทร์","เขตบึงกุ่ม",102705,"เต็นท์บริเวณสนามเด็กเล่นหมู่บ้านเคหะธานี 2ซอยนวลจันทร์ 56 แยก 1",36,283,309,405,714
3423,"นวลจันทร์","เขตบึงกุ่ม",102705,"เต็นท์บริเวณสนามเด็กเล่นหมู่บ้านเคหะธานี 2ซอยนวลจันทร์ 56 แยก 1",37,273,343,384,727
3424,"นวลจันทร์","เขตบึงกุ่ม",102705,"หอประชุมวิทยาลัยการอาชีพนวมินทราชูทิศซอยนวลจันทร์ 56 แยก 3",38,356,296,432,728
3425,"นวลจันทร์","เขตบึงกุ่ม",102705,"หอประชุมวิทยาลัยการอาชีพนวมินทราชูทิศซอยนวลจันทร์ 56 แยก 3",39,299,335,393,728
3426,"นวลจันทร์","เขตบึงกุ่ม",102705,"โรงเรียนวัดนวลจันทร์ ซอยรามอินทรา 40 แยก 37",40,453,436,527,963
3427,"นวลจันทร์","เขตบึงกุ่ม",102705,"โรงเรียนวัดนวลจันทร์ ซอยรามอินทรา 40 แยก 37",41,394,433,533,966
3428,"นวลจันทร์","เขตบึงกุ่ม",102705,"โรงเรียนวัดนวลจันทร์ ซอยรามอินทรา 40 แยก 37",42,455,425,541,966
3429,"นวลจันทร์","เขตบึงกุ่ม",102705,"โรงเรียนวัดนวลจันทร์ ซอยรามอินทรา 40 แยก 37",43,405,409,543,952
3430,"นวลจันทร์","เขตบึงกุ่ม",102705,"โรงเรียนสายอักษร ซอยรามอินทรา 40",44,289,364,419,783
3431,"นวลจันทร์","เขตบึงกุ่ม",102705,"โรงเรียนสายอักษร ซอยรามอินทรา 40",45,341,358,425,783
3432,"นวลจันทร์","เขตบึงกุ่ม",102705,"โรงเรียนสายอักษร ซอยรามอินทรา 40",46,292,375,420,795
3433,"ทุ่งวัดดอน","เขตสาทร",102801,"ศาลาการเปรียญวัดปรก",1,201,303,371,674
3434,"ทุ่งวัดดอน","เขตสาทร",102801,"ศาลาการเปรียญวัดปรก",2,151,257,292,549
3435,"ทุ่งวัดดอน","เขตสาทร",102801,"เต็นท์บริเวณวัดวิษณุ",3,142,216,229,445
3436,"ทุ่งวัดดอน","เขตสาทร",102801,"เต็นท์บริเวณวัดวิษณุ",4,124,213,261,474
3437,"ทุ่งวัดดอน","เขตสาทร",102801,"บริเวณหน้าห้องแถวเลขที่ 830/139-144 ซอยแสงจันทร์",5,163,259,337,596
3438,"ทุ่งวัดดอน","เขตสาทร",102801,"บริเวณหน้าห้องแถวเลขที่ 830/139-144 ซอยแสงจันทร์",6,126,225,245,470
3439,"ทุ่งวัดดอน","เขตสาทร",102801,"เต็นท์บริเวณลานกีฬาชุมชนร่วมพัฒนาวรพจน์ 1",7,106,230,232,462
3440,"ทุ่งวัดดอน","เขตสาทร",102801,"วิทยาลัยเทคโนโลยีสารสาสน์กนกอนุสรณ์ (เดิม)",8,166,232,301,533
3441,"ทุ่งวัดดอน","เขตสาทร",102801,"วิทยาลัยเทคโนโลยีสารสาสน์กนกอนุสรณ์ (เดิม)",9,147,238,234,472
3442,"ทุ่งวัดดอน","เขตสาทร",102801,"เต็นท์บริเวณลานจอดรถบริษัทเจริญโภคภัณฑ์อุตสาหกรรม จำกัด",10,163,252,324,576
3443,"ทุ่งวัดดอน","เขตสาทร",102801,"เต็นท์บริเวณลานจอดรถบริษัทเจริญโภคภัณฑ์อุตสาหกรรม จำกัด",11,173,278,320,598
3444,"ทุ่งวัดดอน","เขตสาทร",102801,"เต็นท์บริเวณลานจอดรถบริษัทเจริญโภคภัณฑ์อุตสาหกรรม จำกัด",12,160,265,310,575
3445,"ทุ่งวัดดอน","เขตสาทร",102801,"เต็นท์บริเวณลานจอดรถบริษัทเจริญโภคภัณฑ์อุตสาหกรรม จำกัด",13,178,258,275,533
3446,"ทุ่งวัดดอน","เขตสาทร",102801,"เต็นท์บริเวณหน้าสำนักงานเขตสาทร",14,366,353,423,776
3447,"ทุ่งวัดดอน","เขตสาทร",102801,"เต็นท์บริเวณหน้าคอนโดเดอะรูม สาทร-เซนต์หลุยส์",15,236,333,396,729
3448,"ทุ่งวัดดอน","เขตสาทร",102801,"เต็นท์บริเวณหน้าคอนโดเดอะรูม สาทร-เซนต์หลุยส์",16,231,308,387,695
3449,"ทุ่งวัดดอน","เขตสาทร",102801,"วิทยาลัยเทคโนโลยีกิตติบริหารธุรกิจ",17,172,294,337,631
3450,"ทุ่งวัดดอน","เขตสาทร",102801,"วิทยาลัยเทคโนโลยีกิตติบริหารธุรกิจ",18,268,339,442,781
3451,"ทุ่งวัดดอน","เขตสาทร",102801,"วิทยาลัยเทคโนโลยีกิตติบริหารธุรกิจ",19,245,306,390,696
3452,"ทุ่งวัดดอน","เขตสาทร",102801,"วิทยาลัยเทคโนโลยีกิตติบริหารธุรกิจ",20,206,302,420,722
3453,"ทุ่งวัดดอน","เขตสาทร",102801,"วิทยาลัยเทคโนโลยีกิตติบริหารธุรกิจ",21,198,299,355,654
3454,"ทุ่งวัดดอน","เขตสาทร",102801,"โรงเรียนทุ่งมหาเมฆ",22,142,313,305,618
3455,"ทุ่งวัดดอน","เขตสาทร",102801,"โรงเรียนทุ่งมหาเมฆ",23,224,268,354,622
3456,"ทุ่งวัดดอน","เขตสาทร",102801,"โรงเรียนทุ่งมหาเมฆ",24,178,290,305,595
3457,"ทุ่งวัดดอน","เขตสาทร",102801,"เต็นท์บริเวณศูนย์การค้าวรรัตน์",25,235,326,391,717
3458,"ทุ่งวัดดอน","เขตสาทร",102801,"เต็นท์บริเวณศูนย์การค้าวรรัตน์",26,340,398,471,869
3459,"ทุ่งวัดดอน","เขตสาทร",102801,"เต็นท์บริเวณศูนย์การค้าวรรัตน์",27,232,313,348,661
3460,"ทุ่งวัดดอน","เขตสาทร",102801,"เต็นท์บริเวณศูนย์การค้าวรรัตน์",28,209,314,376,690
3461,"ทุ่งวัดดอน","เขตสาทร",102801,"เต็นท์บริเวณศูนย์การค้าวรรัตน์",29,300,330,423,753
3462,"ทุ่งวัดดอน","เขตสาทร",102801,"เต็นท์บริเวณศูนย์การค้าวรรัตน์",30,334,311,456,767
3463,"ทุ่งวัดดอน","เขตสาทร",102801,"เต็นท์บริเวณหน้าบ้านเลขที่ 224 ถนนจันทน์ข้างป้อมตำรวจสามแยกสาธุประดิษฐ์",31,618,335,521,856
3464,"ทุ่งวัดดอน","เขตสาทร",102801,"เต็นท์บริเวณหน้าบ้านเลขที่ 224 ถนนจันทน์ข้างป้อมตำรวจสามแยกสาธุประดิษฐ์",32,276,377,467,844
3465,"ทุ่งวัดดอน","เขตสาทร",102801,"เต็นท์บริเวณหน้าบ้านเลขที่ 92 ถนนจันทน์",33,146,193,243,436
3466,"ทุ่งวัดดอน","เขตสาทร",102801,"เต็นท์บริเวณหน้าธนาคารกรุงเทพ สาขาถนนจันทน์ สะพาน 5",34,340,333,475,808
3467,"ทุ่งวัดดอน","เขตสาทร",102801,"โรงเรียนเตรียมอุดมศีกษาพัฒนาการ ยานนาเวศ",35,149,232,245,477
3468,"ทุ่งวัดดอน","เขตสาทร",102801,"โรงเรียนเตรียมอุดมศีกษาพัฒนาการ ยานนาเวศ",36,148,204,254,458
3469,"ทุ่งวัดดอน","เขตสาทร",102801,"โรงเรียนพระแม่มารี สาทร",37,204,270,390,660
3470,"ทุ่งวัดดอน","เขตสาทร",102801,"โรงเรียนพระแม่มารี สาทร",38,259,296,408,704
3471,"ทุ่งวัดดอน","เขตสาทร",102801,"โรงเรียนพระแม่มารี สาทร",39,254,278,394,672
3472,"ทุ่งวัดดอน","เขตสาทร",102801,"โรงเรียนเบญจวรรณศึกษา",40,146,189,262,451
3473,"ทุ่งวัดดอน","เขตสาทร",102801,"โรงเรียนเบญจวรรณศึกษา",41,143,222,261,483
3474,"ทุ่งวัดดอน","เขตสาทร",102801,"วิทยาลัยเทคโนโลยีสารสาสน์กนกอนุสรณ์ (เดิม) (ย้ายมาจากโรงเรียนตรอกจันทน์วิทยา)",42,140,214,279,493
3475,"ทุ่งวัดดอน","เขตสาทร",102801,"วิทยาลัยเทคโนโลยีสารสาสน์กนกอนุสรณ์ (เดิม)(ย้ายมาจากโรงเรียนตรอกจันทน์วิทยา)",43,137,209,232,441
3476,"ทุ่งวัดดอน","เขตสาทร",102801,"เต็นท์บริเวณลานจอดรถอาคารเดอะมอนทานาลอดจ์ ซอยจันทน์ 47",44,192,329,392,721
3477,"ทุ่งวัดดอน","เขตสาทร",102801,"เต็นท์บริเวณสวนหย่อมและลานกีฬา ใต้ทางด่วนซอยอยู่ดี",45,186,348,341,689
3478,"ทุ่งวัดดอน","เขตสาทร",102801,"เต็นท์บริเวณสวนหย่อมและลานกีฬา ใต้ทางด่วนซอยอยู่ดี",46,203,276,349,625
3479,"ทุ่งวัดดอน","เขตสาทร",102801,"เต็นท์บริเวณสวนหย่อมและลานกีฬา ใต้ทางด่วนซอยอยู่ดี",47,178,284,317,601
3480,"ทุ่งวัดดอน","เขตสาทร",102801,"เต็นท์บริเวณหน้าบ้านหนังสือเจริญสุขใจ ถนนเจริญราษฎร์",48,193,275,356,631
3481,"ยานนาวา","เขตสาทร",102802,"โรงเรียนศุภวิทย์",1,170,230,298,528
3482,"ยานนาวา","เขตสาทร",102802,"โรงเรียนศุภวิทย์",2,199,248,297,545
3483,"ยานนาวา","เขตสาทร",102802,"โรงเรียนศุภวิทย์",3,221,306,367,673
3484,"ยานนาวา","เขตสาทร",102802,"เต็นท์หน้าธนาคารยูโอบี สำนักงานใหญ่",4,520,388,511,899
3485,"ยานนาวา","เขตสาทร",102802,"เต็นท์บริเวณลานจอดรถ อาคารภิรัชทาวเวอร์ แอท สาทร(ย้ายมาจากเต็นท์โรงพยาบาลยาสูบ)",5,211,381,415,796
3486,"ยานนาวา","เขตสาทร",102802,"เต็นท์บริเวณลานจอดรถ อาคารภิรัชทาวเวอร์ แอท สาทร(ย้ายมาจากเต็นท์โรงพยาบาลยาสูบ)",6,526,375,492,867
3487,"ยานนาวา","เขตสาทร",102802,"ลานจอดรถข้างโรงเรียนอนุบาลพรประสิทธิ์ (เดิม)",7,158,237,294,531
3488,"ยานนาวา","เขตสาทร",102802,"โรงเรียนอัสสัมชัญแผนกประถม",8,327,242,360,602
3489,"ยานนาวา","เขตสาทร",102802,"โรงเรียนอัสสัมชัญพาณิชยการ",9,131,205,237,442
3490,"ยานนาวา","เขตสาทร",102802,"เต็นท์บริเวณสวนเฉลิมพระเกียรติ 72 พรรษา ใต้ทางด่วนถนนสาทรใต้",10,154,240,308,548
3491,"ยานนาวา","เขตสาทร",102802,"เต็นท์บริเวณสวนเฉลิมพระเกียรติ 72 พรรษา ใต้ทางด่วนถนนสาทรใต้",11,132,253,296,549
3492,"ยานนาวา","เขตสาทร",102802,"มัสยิดยะวา",12,139,190,278,468
3493,"ยานนาวา","เขตสาทร",102802,"มัสยิดยะวา",13,177,288,377,665
3494,"ยานนาวา","เขตสาทร",102802,"มัสยิดยะวา",14,76,171,208,379
3495,"ยานนาวา","เขตสาทร",102802,"โรงเรียนวัดยานนาวา",15,127,196,170,366
3496,"ยานนาวา","เขตสาทร",102802,"มหาวิทยาลัยเทคโนโลยีราชมงคลกรุงเทพ พระนครใต้",16,126,221,296,517
3497,"ยานนาวา","เขตสาทร",102802,"โรงเรียนโกศลวิทยา",17,164,238,309,547
3498,"ยานนาวา","เขตสาทร",102802,"โรงเรียนวัดดอน",18,111,232,233,465
3499,"ยานนาวา","เขตสาทร",102802,"โรงเรียนวัดดอน",19,154,205,259,464
3500,"ยานนาวา","เขตสาทร",102802,"เต็นท์บริเวณโรงเรียนวัดสุทธิวราราม",20,342,283,380,663
3501,"ยานนาวา","เขตสาทร",102802,"เต็นท์บริเวณโรงเรียนวัดสุทธิวราราม",21,213,317,320,637
3502,"ยานนาวา","เขตสาทร",102802,"เต็นท์บริเวณโรงเรียนวัดสุทธิวราราม",22,155,255,319,574
3503,"ยานนาวา","เขตสาทร",102802,"โรงเรียนศิลปวัฒนา",23,183,277,329,606
3504,"ยานนาวา","เขตสาทร",102802,"โรงเรียนศิลปวัฒนา",24,181,310,354,664
3505,"ยานนาวา","เขตสาทร",102802,"เต็นท์บริเวณโรงเรียนศิลปวัฒนา",25,174,325,323,648
3506,"ยานนาวา","เขตสาทร",102802,"โรงเรียนวัดดอน(ย้ายมาจากเต็นท์บริเวณโรงแรมมิลอฟ สาธร โฮเท็ล)",26,96,209,218,427
3507,"ทุ่งมหาเมฆ","เขตสาทร",102803,"โรงรถโรงงานพิพัฒนกิจเท็กซ์ไทล์",1,327,321,406,727
3508,"ทุ่งมหาเมฆ","เขตสาทร",102803,"เต็นท์บริเวณโรงเรียนนานาชาติเครซเซนต์",2,307,252,350,602
3509,"ทุ่งมหาเมฆ","เขตสาทร",102803,"เต็นท์บริเวณสมาคมเหยี่ยวเพ้งแห่งประเทศไทย",3,176,202,246,448
3510,"ทุ่งมหาเมฆ","เขตสาทร",102803,"เต็นท์บริเวณสมาคมเหยี่ยวเพ้งแห่งประเทศไทย",4,152,181,236,417
3511,"ทุ่งมหาเมฆ","เขตสาทร",102803,"มหาวิทยาลัยเทคโนโลยีราชมงคลกรุงเทพ บพิตรพิมุขมหาเมฆ",5,134,184,258,442
3512,"ทุ่งมหาเมฆ","เขตสาทร",102803,"มหาวิทยาลัยเทคโนโลยีราชมงคลกรุงเทพ บพิตรพิมุขมหาเมฆ",6,119,328,197,525
3513,"ทุ่งมหาเมฆ","เขตสาทร",102803,"เต็นท์บริเวณหน้าสวนเฉลิมพระเกียรติ 80 พรรษา พระบาทสมเด็จพระเจ้าอยู่หัว",7,326,341,444,785
3514,"ทุ่งมหาเมฆ","เขตสาทร",102803,"เต็นท์บริเวณลานจอดรถ ร้านบ้านขนิษฐา แอนด์ แกลเลอรี่",8,440,272,369,641
3515,"ทุ่งมหาเมฆ","เขตสาทร",102803,"เต็นท์บริเวณลานจอดรถ ร้านบ้านขนิษฐา แอนด์ แกลเลอรี่",9,256,289,369,658
3516,"ทุ่งมหาเมฆ","เขตสาทร",102803,"เต็นท์บริเวณโรงเรียนคริสต์ศาสนศาสตร์คณะแบบติสต์",10,178,187,272,459
3517,"ทุ่งมหาเมฆ","เขตสาทร",102803,"เต็นท์บริเวณโรงเรียนคริสต์ศาสนศาสตร์คณะแบบติสต์",11,353,248,342,590
3518,"ทุ่งมหาเมฆ","เขตสาทร",102803,"โรงอาหารวิทยาลัยอาชีวศึกษาเอี่ยมละออ",12,360,356,385,741
3519,"ทุ่งมหาเมฆ","เขตสาทร",102803,"โรงอาหารวิทยาลัยอาชีวศึกษาเอี่ยมละออ",13,582,411,508,919
3520,"ทุ่งมหาเมฆ","เขตสาทร",102803,"เต็นท์บริเวณวิทยาลัยอาชีวศึกษาเอี่ยมละออ",14,294,355,400,755
3521,"ทุ่งมหาเมฆ","เขตสาทร",102803,"เต็นท์บริเวณวิทยาลัยอาชีวศึกษาเอี่ยมละออ",15,200,343,389,732
3522,"ทุ่งมหาเมฆ","เขตสาทร",102803,"มหาวิทยาลัยเทคโนโลยีราชมงคลกรุงเทพ (เทคนิคกรุงเทพ)",16,277,365,369,734
3523,"ทุ่งมหาเมฆ","เขตสาทร",102803,"มหาวิทยาลัยเทคโนโลยีราชมงคลกรุงเทพ (เทคนิคกรุงเทพ)",17,217,472,206,678
3524,"ทุ่งมหาเมฆ","เขตสาทร",102803,"อาคารอเนกประสงค์ชุมชนเอื้ออาทรสวนพลูพัฒนา",18,343,399,503,902
3525,"ทุ่งมหาเมฆ","เขตสาทร",102803,"อาคารอเนกประสงค์ชุมชนเอื้ออาทรสวนพลูพัฒนา",19,328,407,452,859
3526,"ทุ่งมหาเมฆ","เขตสาทร",102803,"โรงพลศึกษา สกทร.อาคารสงเคราะห์ข้าราชการกองทัพเรือทุ่งมหาเมฆ",20,208,262,179,441
3527,"ทุ่งมหาเมฆ","เขตสาทร",102803,"โรงพลศึกษา สกทร.อาคารสงเคราะห์ข้าราชการกองทัพเรือทุ่งมหาเมฆ",21,276,282,235,517
3528,"ทุ่งมหาเมฆ","เขตสาทร",102803,"โรงพลศึกษา สกทร.อาคารสงเคราะห์ข้าราชการกองทัพเรือทุ่งมหาเมฆ",22,138,260,254,514
3529,"ทุ่งมหาเมฆ","เขตสาทร",102803,"โรงเรียนอนุบาลจันทร์เจ้า ซอยเกงชวน",23,179,153,222,375
3530,"ทุ่งมหาเมฆ","เขตสาทร",102803,"โรงเรียนอนุบาลจันทร์เจ้า ซอยเกงชวน",24,147,201,237,438
3531,"บางซื่อ","เขตบางซื่อ",102901,"เต็นท์ลานจอดรถอาคารอเนกประสงค์ ตึกแดง",1,143,310,281,591
3532,"บางซื่อ","เขตบางซื่อ",102901,"เต็นท์ลานจอดรถอาคารอเนกประสงค์ ตึกแดง",2,178,250,321,571
3533,"บางซื่อ","เขตบางซื่อ",102901,"เต็นท์ลานจอดรถอาคารอเนกประสงค์ ตึกแดง",3,151,302,323,625
3534,"บางซื่อ","เขตบางซื่อ",102901,"เต็นท์ลานจอดรถอาคารอเนกประสงค์ ตึกแดง",4,160,316,303,619
3535,"บางซื่อ","เขตบางซื่อ",102901,"เต็นท์ลานจอดรถอาคารอเนกประสงค์ ตึกแดง",5,157,294,295,589
3536,"บางซื่อ","เขตบางซื่อ",102901,"เต็นท์ทางเข้าชุมชนบ้านพักรถไฟก่อสร้าง (แฟลตกระป๋อง)",6,193,289,191,480
3537,"บางซื่อ","เขตบางซื่อ",102901,"เต็นท์ทางเข้าชุมชนบ้านพักรถไฟก่อสร้าง (แฟลตกระป๋อง)",7,155,256,237,493
3538,"บางซื่อ","เขตบางซื่อ",102901,"เต็นท์ชุมชนบ้านพักรถไฟก่อสร้าง (แฟลตกระป๋อง)",8,151,304,258,562
3539,"บางซื่อ","เขตบางซื่อ",102901,"ศูนย์เยาวชนเตชะวนิช",9,155,191,244,435
3540,"บางซื่อ","เขตบางซื่อ",102901,"อาคารศูนย์สาธารณสุข 3",10,153,261,325,586
3541,"บางซื่อ","เขตบางซื่อ",102901,"อาคารศูนย์สาธารณสุข 3",11,117,272,291,563
3542,"บางซื่อ","เขตบางซื่อ",102901,"อาคารศูนย์สาธารณสุข 3",12,348,250,343,593
3543,"บางซื่อ","เขตบางซื่อ",102901,"อาคารศูนย์สาธารณสุข 3",13,310,273,332,605
3544,"บางซื่อ","เขตบางซื่อ",102901,"เต็นท์ศูนย์สาธารณสุข 3",14,148,259,286,545
3545,"บางซื่อ","เขตบางซื่อ",102901,"เต็นท์ข้างเทสโก้โลตัส",15,286,284,391,675
3546,"บางซื่อ","เขตบางซื่อ",102901,"เต็นท์ข้างเทสโก้โลตัส",16,223,302,392,694
3547,"บางซื่อ","เขตบางซื่อ",102901,"เต็นท์พุทธสมาคม",17,206,269,372,641
3548,"บางซื่อ","เขตบางซื่อ",102901,"เต็นท์พุทธสมาคม",18,219,283,381,664
3549,"บางซื่อ","เขตบางซื่อ",102901,"โรงเรียนราชนันทาจารย์ (สามเสนวิทยาลัย 2)",19,165,257,295,552
3550,"บางซื่อ","เขตบางซื่อ",102901,"โรงเรียนราชนันทาจารย์ (สามเสนวิทยาลัย 2)",20,187,231,282,513
3551,"บางซื่อ","เขตบางซื่อ",102901,"โรงเรียนราชนันทาจารย์ (สามเสนวิทยาลัย 2)",21,152,252,279,531
3552,"บางซื่อ","เขตบางซื่อ",102901,"โรงเรียนราชนันทาจารย์ (สามเสนวิทยาลัย 2)",22,173,226,274,500
3553,"บางซื่อ","เขตบางซื่อ",102901,"เต็นท์โรงเรียนราชนันทาจารย์ (สามเสนวิทยาลัย 2)",23,215,271,317,588
3554,"บางซื่อ","เขตบางซื่อ",102901,"วิทยาลัยเทคโนโลยีวิมลบริหารธุรกิจ",24,223,321,373,694
3555,"บางซื่อ","เขตบางซื่อ",102901,"วิทยาลัยเทคโนโลยีวิมลบริหารธุรกิจ",25,614,294,400,694
3556,"บางซื่อ","เขตบางซื่อ",102901,"วิทยาลัยเทคโนโลยีวิมลบริหารธุรกิจ",26,483,281,388,669
3557,"บางซื่อ","เขตบางซื่อ",102901,"วิทยาลัยเทคโนโลยีวิมลบริหารธุรกิจ",27,241,305,404,709
3558,"บางซื่อ","เขตบางซื่อ",102901,"เต็นท์กองระบบส่งน้ำดิบ",28,174,310,335,645
3559,"บางซื่อ","เขตบางซื่อ",102901,"เต็นท์กองระบบส่งน้ำดิบ",29,170,268,305,573
3560,"บางซื่อ","เขตบางซื่อ",102901,"โรงเรียนผะดุงศิษย์พิทยา",30,164,293,338,631
3561,"บางซื่อ","เขตบางซื่อ",102901,"โรงเรียนผะดุงศิษย์พิทยา",31,192,259,315,574
3562,"บางซื่อ","เขตบางซื่อ",102901,"โรงเรียนผะดุงศิษย์พิทยา",32,198,341,340,681
3563,"บางซื่อ","เขตบางซื่อ",102901,"โรงเรียนผะดุงศิษย์พิทยา",33,146,271,338,609
3564,"บางซื่อ","เขตบางซื่อ",102901,"โรงเรียนผะดุงศิษย์พิทยา",34,162,286,341,627
3565,"บางซื่อ","เขตบางซื่อ",102901,"โรงเรียนผะดุงศิษย์พิทยา",35,161,310,323,633
3566,"บางซื่อ","เขตบางซื่อ",102901,"เต็นท์สี่แยกประชาชื่น ข้างอาคารชุด ไอดีโอ โมบิ บางซื่อ",36,369,274,370,644
3567,"บางซื่อ","เขตบางซื่อ",102901,"เต็นท์สี่แยกประชาชื่น ข้างอาคารชุด ไอดีโอ โมบิ บางซื่อ",37,123,236,264,500
3568,"บางซื่อ","เขตบางซื่อ",102901,"เต็นท์สี่แยกประชาชื่น ข้างอาคารชุด ไอดีโอ โมบิ บางซื่อ",38,393,263,345,608
3569,"บางซื่อ","เขตบางซื่อ",102901,"เต็นท์ข้างอาคารสุขประพฤติ",39,446,313,477,790
3570,"บางซื่อ","เขตบางซื่อ",102901,"เต็นท์หมวดการทางนนทบุรี",40,338,244,306,550
3571,"บางซื่อ","เขตบางซื่อ",102901,"เต็นท์หมวดการทางนนทบุรี",41,240,237,287,524
3572,"บางซื่อ","เขตบางซื่อ",102901,"เต็นท์ไปรษณีย์บางซื่อ",42,149,189,246,435
3573,"บางซื่อ","เขตบางซื่อ",102901,"เต็นท์ชุมสายโทรศัพท์ ซอยกรุงเทพ-นนทบุรี 18",43,127,220,228,448
3574,"บางซื่อ","เขตบางซื่อ",102901,"โชว์รูมรถฮอนด้า ถนนกรุงเทพ-นนทบุรี",44,142,218,263,481
3575,"บางซื่อ","เขตบางซื่อ",102901,"โชว์รูมรถฮอนด้า ถนนกรุงเทพ-นนทบุรี",45,153,214,202,416
3576,"บางซื่อ","เขตบางซื่อ",102901,"เต็นท์ใต้สถานีรถไฟฟ้าสายสีม่วง สถานีเตาปูน",46,184,315,343,658
3577,"บางซื่อ","เขตบางซื่อ",102901,"เต็นท์ใต้สถานีรถไฟฟ้าสายสีม่วง สถานีเตาปูน",47,224,302,353,655
3578,"บางซื่อ","เขตบางซื่อ",102901,"เต็นท์ใต้สถานีรถไฟฟ้าสายสีม่วง สถานีเตาปูน",48,383,222,312,534
3579,"บางซื่อ","เขตบางซื่อ",102901,"เต็นท์ใต้สถานีรถไฟฟ้าสายสีม่วง สถานีเตาปูน",49,550,293,352,645
3580,"บางซื่อ","เขตบางซื่อ",102901,"เต็นท์ใต้สถานีรถไฟฟ้าสายสีม่วง สถานีเตาปูน",50,633,345,426,771
3581,"บางซื่อ","เขตบางซื่อ",102901,"เต็นท์ใต้สถานีรถไฟฟ้าสายสีม่วง สถานีเตาปูน",51,396,349,410,759
3582,"บางซื่อ","เขตบางซื่อ",102901,"เต็นท์ใต้สถานีรถไฟฟ้าสายสีม่วง สถานีเตาปูน",52,204,267,364,631
3583,"บางซื่อ","เขตบางซื่อ",102901,"เต็นท์ใต้สถานีรถไฟฟ้าสายสีม่วง สถานีเตาปูน",53,365,302,372,674
3584,"บางซื่อ","เขตบางซื่อ",102901,"เต็นท์โรงเรียนเทพสัมฤทธิ์วิทยา",54,230,289,323,612
3585,"บางซื่อ","เขตบางซื่อ",102901,"เต็นท์โรงเรียนเทพสัมฤทธิ์วิทยา",55,130,281,328,609
3586,"บางซื่อ","เขตบางซื่อ",102901,"เต็นท์โรงเรียนเทพสัมฤทธิ์วิทยา",56,207,283,345,628
3587,"บางซื่อ","เขตบางซื่อ",102901,"เต็นท์ที่จอดรถ ธนาคารไทยพาณิชย์ สาขาบางโพ",57,233,270,331,601
3588,"บางซื่อ","เขตบางซื่อ",102901,"เต็นท์ที่จอดรถ ธนาคารไทยพาณิชย์ สาขาบางโพ",58,144,275,291,566
3589,"บางซื่อ","เขตบางซื่อ",102901,"เต็นท์หน้าองค์การอุตสาหกรรมป่าไม้ ประชาราษฎร์ 1",59,208,252,335,587
3590,"บางซื่อ","เขตบางซื่อ",102901,"เต็นท์หน้าองค์การอุตสาหกรรมป่าไม้ ประชาราษฎร์ 1",60,197,235,325,560
3591,"บางซื่อ","เขตบางซื่อ",102901,"เต็นท์หน้าองค์การอุตสาหกรรมป่าไม้ ประชาราษฎร์ 1",61,522,311,314,625
3592,"บางซื่อ","เขตบางซื่อ",102901,"เต็นท์ในซอยอาทรอุปถัมภ์",62,245,312,374,686
3593,"บางซื่อ","เขตบางซื่อ",102901,"เต็นท์ในซอยอาทรอุปถัมภ์",63,253,309,384,693
3594,"บางซื่อ","เขตบางซื่อ",102901,"เต็นท์ในซอยอาทรอุปถัมภ์",64,199,364,406,770
3595,"บางซื่อ","เขตบางซื่อ",102901,"ศาลาวัดประดู่ธรรมาธิปัตย์",65,168,230,313,543
3596,"บางซื่อ","เขตบางซื่อ",102901,"ศาลาวัดประดู่ธรรมาธิปัตย์",66,170,266,312,578
3597,"บางซื่อ","เขตบางซื่อ",102901,"โรงเรียนวัดประดู่ธรรมาธิปัตย์",67,165,280,332,612
3598,"บางซื่อ","เขตบางซื่อ",102901,"เต็นท์โรงเรียนวัดประดู่ธรรมาธิปัตย์",68,163,232,289,521
3599,"บางซื่อ","เขตบางซื่อ",102901,"เต็นท์ซอยบริษัทมาเวลล์",69,168,240,290,530
3600,"บางซื่อ","เขตบางซื่อ",102901,"เต็นท์ซอยบริษัทมาเวลล์",70,234,247,299,546
3601,"บางซื่อ","เขตบางซื่อ",102901,"เต็นท์ซอยบริษัทมาเวลล์",71,167,209,264,473
3602,"บางซื่อ","เขตบางซื่อ",102901,"เต็นท์ข้างร้าน ช.โชคดี ซอยประชานฤมิตร",72,124,159,186,345
3603,"บางซื่อ","เขตบางซื่อ",102901,"เต็นท์ข้างร้านวันชัยการช่าง ซอยประชานฤมิตร",73,153,243,270,513
3604,"บางซื่อ","เขตบางซื่อ",102901,"เต็นท์ข้าง หจก.เอกพฤกษ์ ซอยประชานฤมิตร",74,103,220,236,456
3605,"บางซื่อ","เขตบางซื่อ",102901,"โรงเรียนวัดบางโพโอมาวาส",75,185,301,320,621
3606,"บางซื่อ","เขตบางซื่อ",102901,"โรงเรียนวัดบางโพโอมาวาส",76,124,247,298,545
3607,"บางซื่อ","เขตบางซื่อ",102901,"โรงเรียนกุลวรรณศึกษา",77,293,355,420,775
3608,"บางซื่อ","เขตบางซื่อ",102901,"โรงเรียนกุลวรรณศึกษา",78,236,320,380,700
3609,"บางซื่อ","เขตบางซื่อ",102901,"โรงเรียนกุลวรรณศึกษา",79,176,308,361,669
3610,"บางซื่อ","เขตบางซื่อ",102901,"โรงเรียนกุลวรรณศึกษา",80,331,307,348,655
3611,"บางซื่อ","เขตบางซื่อ",102901,"เต็นท์ศาลเจ้าแม่ทับทิม (ซอยประชานฤมิตร)",81,214,289,320,609
3612,"บางซื่อ","เขตบางซื่อ",102901,"เต็นท์ศาลเจ้าแม่ทับทิม (ซอยประชานฤมิตร)",82,243,302,389,691
3613,"บางซื่อ","เขตบางซื่อ",102901,"เต็นท์สถานีตำรวจนครบาลเตาปูน",83,180,327,316,643
3614,"บางซื่อ","เขตบางซื่อ",102901,"เต็นท์สถานีตำรวจนครบาลเตาปูน",84,144,201,249,450
3615,"บางซื่อ","เขตบางซื่อ",102901,"เต็นท์สถานีตำรวจนครบาลเตาปูน",85,143,200,248,448
3616,"บางซื่อ","เขตบางซื่อ",102901,"โรงเรียนวัดเวตวันธรรมาวาส",86,201,297,311,608
3617,"บางซื่อ","เขตบางซื่อ",102901,"โรงเรียนวัดเวตวันธรรมาวาส",87,127,255,274,529
3618,"บางซื่อ","เขตบางซื่อ",102901,"โรงเรียนวัดเวตวันธรรมาวาส",88,116,273,304,577
3619,"บางซื่อ","เขตบางซื่อ",102901,"เต็นท์ธนาคารกรุงไทย ซอยกรุงเทพ-นนทบุรี 23/1",89,227,321,418,739
3620,"บางซื่อ","เขตบางซื่อ",102901,"เต็นท์ลานจอดรถอาคารชุด รีเจ้นท์โฮม บางซ่อน",90,428,199,322,521
3621,"บางซื่อ","เขตบางซื่อ",102901,"เต็นท์ลานจอดรถอาคารชุด รีเจ้นท์โฮม บางซ่อน",91,445,200,323,523
3622,"บางซื่อ","เขตบางซื่อ",102901,"เต็นท์ลานจอดรถอาคารชุด รีเจ้นท์โฮม บางซ่อน",92,418,201,303,504
3623,"บางซื่อ","เขตบางซื่อ",102901,"เต็นท์ลานจอดรถอาคารชุด รีเจ้นท์โฮม บางซ่อน",93,572,258,404,662
3624,"บางซื่อ","เขตบางซื่อ",102901,"เต็นท์ตลาดบางซ่อน",94,177,251,314,565
3625,"บางซื่อ","เขตบางซื่อ",102901,"เต็นท์ตลาดบางซ่อน",95,145,286,305,591
3626,"บางซื่อ","เขตบางซื่อ",102901,"เต็นท์ตลาดบางซ่อน",96,138,252,318,570
3627,"บางซื่อ","เขตบางซื่อ",102901,"เต็นท์ตลาดบางซ่อน",97,157,241,291,532
3628,"บางซื่อ","เขตบางซื่อ",102901,"เต็นท์หมู่บ้านมั่นคงกัลยาณมิตร",98,224,331,370,701
3629,"บางซื่อ","เขตบางซื่อ",102901,"เต็นท์ปากซอยประชาราษฎร์สาย1 ซอย 38 (ซอยสีน้ำเงิน)",99,167,336,321,657
3630,"บางซื่อ","เขตบางซื่อ",102901,"เต็นท์หน้าอาคารพาณิชย์ ข้างตลาดวัฒนานันท์",100,177,333,404,737
3631,"บางซื่อ","เขตบางซื่อ",102901,"เต็นท์หน้าตลาดวัฒนานันท์",101,163,305,336,641
3632,"บางซื่อ","เขตบางซื่อ",102901,"เต็นท์พิบูลย์คอนโดทาวน์",102,242,242,330,572
3633,"บางซื่อ","เขตบางซื่อ",102901,"เต็นท์พิบูลย์คอนโดทาวน์",103,364,262,391,653
3634,"บางซื่อ","เขตบางซื่อ",102901,"เต็นท์พิบูลย์คอนโดทาวน์",104,197,289,358,647
3635,"บางซื่อ","เขตบางซื่อ",102901,"เต็นท์พิบูลย์คอนโดทาวน์",105,243,315,377,692
3636,"บางซื่อ","เขตบางซื่อ",102901,"โรงเรียนวัดสร้อยทอง",106,229,182,254,436
3637,"บางซื่อ","เขตบางซื่อ",102901,"โรงเรียนวัดสร้อยทอง",107,149,190,218,408
3638,"บางซื่อ","เขตบางซื่อ",102901,"โรงเรียนวัดสร้อยทอง",108,315,332,237,569
3639,"บางซื่อ","เขตบางซื่อ",102901,"เต็นท์โรงเรียนวัดสร้อยทอง",109,95,213,241,454
3640,"วงศ์สว่าง","เขตบางซื่อ",102902,"เต็นท์ชุมทางสยามยิปซี (บางซ่อน)",1,363,285,373,658
3641,"วงศ์สว่าง","เขตบางซื่อ",102902,"เต็นท์ปากซอยกรุงเทพ-นนทบุรี 40",2,132,149,193,342
3642,"วงศ์สว่าง","เขตบางซื่อ",102902,"โชว์รูมรถนิสสัน ซอยกรุงเทพ-นนทบุรี 42",3,134,166,202,368
3643,"วงศ์สว่าง","เขตบางซื่อ",102902,"เต็นท์ปั้มน้ำมันปตท. ปากซอยกรุงเทพ-นนทบุรี 37",4,247,300,384,684
3644,"วงศ์สว่าง","เขตบางซื่อ",102902,"เต็นท์ปั้มน้ำมันปตท. ปากซอยกรุงเทพ-นนทบุรี 37",5,231,303,419,722
3645,"วงศ์สว่าง","เขตบางซื่อ",102902,"เต็นท์ในซอยสุดซอยสมถวิล",6,218,379,403,782
3646,"วงศ์สว่าง","เขตบางซื่อ",102902,"เต็นท์กรมยุทธบริการทหาร",7,418,303,428,731
3647,"วงศ์สว่าง","เขตบางซื่อ",102902,"เต็นท์กรมยุทธบริการทหาร",8,288,336,379,715
3648,"วงศ์สว่าง","เขตบางซื่อ",102902,"เต็นท์กรมยุทธบริการทหาร",9,326,305,334,639
3649,"วงศ์สว่าง","เขตบางซื่อ",102902,"เต็นท์หน้าบิ๊กซี สาขาวงศ์สว่าง",10,444,239,326,565
3650,"วงศ์สว่าง","เขตบางซื่อ",102902,"เต็นท์หน้าบิ๊กซี สาขาวงศ์สว่าง",11,543,263,340,603
3651,"วงศ์สว่าง","เขตบางซื่อ",102902,"เต็นท์หน้าบิ๊กซี สาขาวงศ์สว่าง",12,484,234,334,568
3652,"วงศ์สว่าง","เขตบางซื่อ",102902,"เต็นท์หน้าธนาคารกรุงเทพ สาขาวงศ์สว่าง",13,125,170,237,407
3653,"วงศ์สว่าง","เขตบางซื่อ",102902,"ลานกีฬาชุมชนยิ้มประยูรพัฒนา",14,183,265,340,605
3654,"วงศ์สว่าง","เขตบางซื่อ",102902,"โรงเรียนวัดประชาศรัทธาธรรม",15,174,308,352,660
3655,"วงศ์สว่าง","เขตบางซื่อ",102902,"โรงเรียนวัดประชาศรัทธาธรรม",16,167,258,292,550
3656,"วงศ์สว่าง","เขตบางซื่อ",102902,"โรงเรียนวัดประชาศรัทธาธรรม",17,225,311,362,673
3657,"วงศ์สว่าง","เขตบางซื่อ",102902,"โรงเรียนวัดประชาศรัทธาธรรม",18,182,310,346,656
3658,"วงศ์สว่าง","เขตบางซื่อ",102902,"เต็นท์ในมหาวิทยาลัยเทคโนโลยีราชมงคลพระนครเหนือ",19,213,311,357,668
3659,"วงศ์สว่าง","เขตบางซื่อ",102902,"เต็นท์ในหมู่บ้านพิบูลย์",20,206,252,318,570
3660,"วงศ์สว่าง","เขตบางซื่อ",102902,"เต็นท์ในหมู่บ้านพิบูลย์",21,234,265,319,584
3661,"วงศ์สว่าง","เขตบางซื่อ",102902,"เต็นท์โรงเรียนวัดมัชฌันติการาม",22,149,268,270,538
3662,"วงศ์สว่าง","เขตบางซื่อ",102902,"เต็นท์โรงเรียนวัดมัชฌันติการาม",23,182,228,301,529
3663,"วงศ์สว่าง","เขตบางซื่อ",102902,"เต็นท์โรงเรียนวัดมัชฌันติการาม",24,230,263,319,582
3664,"วงศ์สว่าง","เขตบางซื่อ",102902,"เต็นท์ลานจอดรถธนาคารกรุงไทย สาขาวงศ์สว่าง",25,195,242,310,552
3665,"วงศ์สว่าง","เขตบางซื่อ",102902,"เต็นท์ลานกีฬาซอยวงศ์สว่าง 19",26,172,291,354,645
3666,"วงศ์สว่าง","เขตบางซื่อ",102902,"เต็นท์ลานกีฬาซอยวงศ์สว่าง 19",27,224,327,391,718
3667,"วงศ์สว่าง","เขตบางซื่อ",102902,"เต็นท์ลานกีฬาซอยวงศ์สว่าง 19",28,243,285,321,606
3668,"วงศ์สว่าง","เขตบางซื่อ",102902,"เต็นท์ลานกีฬาซอยวงศ์สว่าง 19",29,274,315,399,714
3669,"วงศ์สว่าง","เขตบางซื่อ",102902,"เต็นท์ในศูนย์สาธารณสุข 19 วงศ์สว่าง",30,157,182,243,425
3670,"วงศ์สว่าง","เขตบางซื่อ",102902,"เต็นท์ในศูนย์สาธารณสุข 19 วงศ์สว่าง",31,129,210,236,446
3671,"วงศ์สว่าง","เขตบางซื่อ",102902,"โรงเรียนวัดเลียบราษฎร์บำรุง",32,178,211,302,513
3672,"วงศ์สว่าง","เขตบางซื่อ",102902,"โรงเรียนวัดเลียบราษฎร์บำรุง",33,161,270,312,582
3673,"วงศ์สว่าง","เขตบางซื่อ",102902,"โรงเรียนวัดเลียบราษฎร์บำรุง",34,141,264,300,564
3674,"วงศ์สว่าง","เขตบางซื่อ",102902,"โรงเรียนวัดเลียบราษฎร์บำรุง",35,138,256,289,545
3675,"วงศ์สว่าง","เขตบางซื่อ",102902,"โรงเรียนวัดทองสุทธาราม",36,189,236,331,567
3676,"วงศ์สว่าง","เขตบางซื่อ",102902,"โรงเรียนวัดทองสุทธาราม",37,203,260,302,562
3677,"วงศ์สว่าง","เขตบางซื่อ",102902,"โรงเรียนวัดทองสุทธาราม",38,198,267,340,607
3678,"วงศ์สว่าง","เขตบางซื่อ",102902,"โรงเรียนวัดทองสุทธาราม",39,178,245,285,530
3679,"วงศ์สว่าง","เขตบางซื่อ",102902,"เต็นท์โรงเรียนวัดทองสุทธาราม",40,184,255,293,548
3680,"วงศ์สว่าง","เขตบางซื่อ",102902,"เต็นท์ปากซอยกรุงเทพ-นนทบุรี 54 (หน้าหมู่บ้านวงศ์สว่าง)",41,236,289,342,631
3681,"วงศ์สว่าง","เขตบางซื่อ",102902,"เต็นท์ลานจอดรถเดอะแพชชั่น สนุ๊กเกอร์คลับ ซอยรัชดาภิเษก 66",42,395,267,402,669
3682,"วงศ์สว่าง","เขตบางซื่อ",102902,"เต็นท์ลานจอดรถเดอะแพชชั่น สนุ๊กเกอร์คลับ ซอยรัชดาภิเษก 66",43,268,315,405,720
3683,"วงศ์สว่าง","เขตบางซื่อ",102902,"เต็นท์ลานจอดรถเดอะแพชชั่น สนุ๊กเกอร์คลับ ซอยรัชดาภิเษก 66",44,213,299,375,674
3684,"วงศ์สว่าง","เขตบางซื่อ",102902,"เต็นท์ลานจอดรถเดอะแพชชั่น สนุ๊กเกอร์คลับ ซอยรัชดาภิเษก 66",45,253,282,380,662
3685,"วงศ์สว่าง","เขตบางซื่อ",102902,"เต็นท์หน้าร้านดอกคูนนวดเพื่อสุขภาพ ซอยรัชดาภิเษก 66",46,215,316,340,656
3686,"วงศ์สว่าง","เขตบางซื่อ",102902,"เต็นท์ลานจอดรถสถานีรถไฟบางซ่อน",47,413,256,314,570
3687,"วงศ์สว่าง","เขตบางซื่อ",102902,"เต็นท์ลานจอดรถสถานีรถไฟบางซ่อน",48,171,196,271,467
3688,"วงศ์สว่าง","เขตบางซื่อ",102902,"เต็นท์ข้างศาลเจ้าพ่อเห้งเจีย ซอยประชาชื่น 29",49,296,179,277,456
3689,"วงศ์สว่าง","เขตบางซื่อ",102902,"เต็นท์ข้างศาลเจ้าพ่อเห้งเจีย ซอยประชาชื่น 29",50,278,206,249,455
3690,"วงศ์สว่าง","เขตบางซื่อ",102902,"เต็นท์ใต้ทางด่วน ซอยประชาชื่น 30",51,214,208,277,485
3691,"วงศ์สว่าง","เขตบางซื่อ",102902,"เต็นท์ใต้ทางด่วน ซอยประชาชื่น 30",52,175,249,299,548
3692,"วงศ์สว่าง","เขตบางซื่อ",102902,"เต็นท์ใต้ทางด่วน ซอยประชาชื่น 30",53,177,224,299,523
3693,"วงศ์สว่าง","เขตบางซื่อ",102902,"เต็นท์หน้าอู่ช่าง ส.เซอร์วิส ซอยประชาชื่น 33",54,183,233,294,527
3694,"วงศ์สว่าง","เขตบางซื่อ",102902,"เต็นท์ปากซอยประชาชื่น 34",55,156,181,264,445
3695,"วงศ์สว่าง","เขตบางซื่อ",102902,"เต็นท์บริษัทเจษฎ์พัฒนา ซอยประชาชื่น 36",56,268,330,359,689
3696,"วงศ์สว่าง","เขตบางซื่อ",102902,"เต็นท์บริษัทเจษฎ์พัฒนา ซอยประชาชื่น 36",57,200,261,326,587
3697,"วงศ์สว่าง","เขตบางซื่อ",102902,"เต็นท์บริษัทเจษฎ์พัฒนา ซอยประชาชื่น 36",58,242,287,394,681
3698,"วงศ์สว่าง","เขตบางซื่อ",102902,"เต็นท์บริษัทเจษฎ์พัฒนา ซอยประชาชื่น 36",59,177,251,303,554
3699,"วงศ์สว่าง","เขตบางซื่อ",102902,"เต็นท์หน้าธนาคารกรุงเทพ ถนนประชาชื่น",60,487,230,371,601
3700,"วงศ์สว่าง","เขตบางซื่อ",102902,"เต็นท์หน้าธนาคารกรุงเทพ ถนนประชาชื่น",61,253,205,311,516
3701,"วงศ์สว่าง","เขตบางซื่อ",102902,"เต็นท์หน้าธนาคารกรุงเทพ ถนนประชาชื่น",62,228,272,371,643
3702,"ลาดยาว","เขตจตุจักร",103001,"อาคารโรงเรียนบางบัว (ถนนพหลโยธิน)",1,150,268,327,595
3703,"ลาดยาว","เขตจตุจักร",103001,"อาคารโรงเรียนบางบัว (ถนนพหลโยธิน)",2,430,248,328,576
3704,"ลาดยาว","เขตจตุจักร",103001,"เต็นท์บริเวณกรมป่าไม้ (ถนนพหลโยธิน)",3,249,333,351,684
3705,"ลาดยาว","เขตจตุจักร",103001,"เต็นท์บริเวณกรมป่าไม้ (ถนนพหลโยธิน)",4,302,322,366,688
3706,"ลาดยาว","เขตจตุจักร",103001,"เต็นท์บริเวณกรมป่าไม้ (ถนนพหลโยธิน)",5,240,333,353,686
3707,"ลาดยาว","เขตจตุจักร",103001,"เต็นท์บริเวณกรมป่าไม้ (ถนนพหลโยธิน)",6,238,331,359,690
3708,"ลาดยาว","เขตจตุจักร",103001,"อาคารศาลาอเนกประสงค์ ชุมชนโรงสูบน้ำ (มหาวิทยาลัยเกษตรศาสตร์)",7,229,537,450,987
3709,"ลาดยาว","เขตจตุจักร",103001,"เต็นท์บริเวณโรงพยาบาลวิภาวดี (ฝั่งถนนงามวงศ์วาน)",8,378,273,365,638
3710,"ลาดยาว","เขตจตุจักร",103001,"เต็นท์บริเวณโรงพยาบาลวิภาวดี(ฝั่งถนนงามวงศ์วาน)",9,318,308,338,646
3711,"ลาดยาว","เขตจตุจักร",103001,"เต็นท์บริเวณโรงพยาบาลวิภาวดี(ฝั่งถนนงามวงศ์วาน)",10,242,267,375,642
3712,"ลาดยาว","เขตจตุจักร",103001,"เต็นท์บริเวณปากซอยงามวงศ์วาน52",11,213,203,282,485
3713,"ลาดยาว","เขตจตุจักร",103001,"เต็นท์บริเวณปากซอยงามวงศ์วาน52",12,187,201,301,502
3714,"ลาดยาว","เขตจตุจักร",103001,"เต็นท์บริเวณทางเท้าหน้ากรมพัฒนาที่ดิน (ถนนพหลโยธิน)",13,401,291,380,671
3715,"ลาดยาว","เขตจตุจักร",103001,"เต็นท์บริเวณทางเท้าหน้ากรมพัฒนาที่ดิน (ถนนพหลโยธิน)",14,269,313,338,651
3716,"ลาดยาว","เขตจตุจักร",103001,"เต็นท์บริเวณสนามเด็กเล่นหมู่บ้านทาวน์โฮม(ซอยท่านผู้หญิงพหล)",15,208,210,260,470
3717,"ลาดยาว","เขตจตุจักร",103001,"อาคารข้างร้านเซเว่น อีเลฟเว่นสาขาพหลโยธิน35 แยก 17",16,326,295,408,703
3718,"ลาดยาว","เขตจตุจักร",103001,"อาคารข้างร้านเซเว่น อีเลฟเว่นสาขาพหลโยธิน35 แยก 17",17,248,308,408,716
3719,"ลาดยาว","เขตจตุจักร",103001,"อาคารข้างร้านเซเว่น อีเลฟเว่นสาขาพหลโยธิน35 แยก 17",18,238,304,405,709
3720,"ลาดยาว","เขตจตุจักร",103001,"เต็นท์บริเวณลานหิน อเวนิว รัชโยธิน(ถนนรัชดาภิเษก)",19,232,293,371,664
3721,"ลาดยาว","เขตจตุจักร",103001,"เต็นท์บริเวณลานหิน อเวนิว รัชโยธิน(ถนนรัชดาภิเษก)",20,338,257,392,649
3722,"ลาดยาว","เขตจตุจักร",103001,"เต็นท์บริเวณลานหิน อเวนิว รัชโยธิน(ถนนรัชดาภิเษก)",21,553,297,363,660
3723,"ลาดยาว","เขตจตุจักร",103001,"ใต้อาคารแฟลตหลังสถานีตำรวจวิภาวดี(ถนนวิภาวดีรังสิต)",22,267,265,260,525
3724,"ลาดยาว","เขตจตุจักร",103001,"ใต้อาคารแฟลตหลังสถานีตำรวจวิภาวดี(ถนนวิภาวดีรังสิต)",23,445,227,335,562
3725,"ลาดยาว","เขตจตุจักร",103001,"เต็นท์บริเวณกองบัญชาการศึกษาสำนักงานตำรวจแห่งชาติ (ถนนวิภาวดีรังสิต)",24,295,354,458,812
3726,"ลาดยาว","เขตจตุจักร",103001,"เต็นท์บริเวณกองบัญชาการศึกษาสำนักงานตำรวจแห่งชาติ (ถนนวิภาวดีรังสิต)",25,356,390,431,821
3727,"ลาดยาว","เขตจตุจักร",103001,"เต็นท์บริเวณกองบัญชาการศึกษาสำนักงานตำรวจแห่งชาติ (ถนนวิภาวดีรังสิต)",26,429,380,461,841
3728,"ลาดยาว","เขตจตุจักร",103001,"อาคารโรงเรียนวัดเสมียนนารี (หน้าห้องสมุด)",27,316,478,478,956
3729,"ลาดยาว","เขตจตุจักร",103001,"อาคารโรงเรียนวัดเสมียนนารี (หน้าห้องสมุด)",28,274,338,374,712
3730,"ลาดยาว","เขตจตุจักร",103001,"อาคารแฟลตบ้านพักกองกำกับการสายตรวจ 191",29,201,282,162,444
3731,"ลาดยาว","เขตจตุจักร",103001,"อาคารโรงเรียนวัดเทวสุนทร",30,221,306,332,638
3732,"ลาดยาว","เขตจตุจักร",103001,"อาคารโรงเรียนวัดเทวสุนทร",31,185,283,341,624
3733,"ลาดยาว","เขตจตุจักร",103001,"เต็นท์บริเวณริมกำแพงทัณฑสถานโรงพยาบาลราชทัณฑ์",32,297,367,433,800
3734,"ลาดยาว","เขตจตุจักร",103001,"อาคารโรงเรียนรัตนโกสินทร์สมโภช",33,231,274,201,475
3735,"ลาดยาว","เขตจตุจักร",103001,"อาคารโรงเรียนรัตนโกสินทร์สมโภช",34,242,273,208,481
3736,"ลาดยาว","เขตจตุจักร",103001,"อาคารโรงเรียนประชานิเวศน์ (ประถมศึกษา)",35,532,377,485,862
3737,"ลาดยาว","เขตจตุจักร",103001,"อาคารโรงเรียนประชานิเวศน์ (ประถมศึกษา)",36,306,383,485,868
3738,"ลาดยาว","เขตจตุจักร",103001,"อาคารโรงเรียนประชานิเวศน์ (ประถมศึกษา)",37,311,375,495,870
3739,"ลาดยาว","เขตจตุจักร",103001,"อาคารโรงเรียนประชานิเวศน์ (ประถมศึกษา)",38,277,370,501,871
3740,"ลาดยาว","เขตจตุจักร",103001,"อาคารโรงเรียนประชานิเวศน์ (ประถมศึกษา)",39,319,378,493,871
3741,"ลาดยาว","เขตจตุจักร",103001,"อาคารจอดรถศูนย์กีฬาประชานิเวศน์",40,240,286,391,677
3742,"ลาดยาว","เขตจตุจักร",103001,"อาคารจอดรถศูนย์กีฬาประชานิเวศน์",41,277,284,395,679
3743,"ลาดยาว","เขตจตุจักร",103001,"อาคารจอดรถศูนย์กีฬาประชานิเวศน์",42,308,303,380,683
3744,"ลาดยาว","เขตจตุจักร",103001,"อาคารจอดรถศูนย์กีฬาประชานิเวศน์",43,283,280,393,673
3745,"ลาดยาว","เขตจตุจักร",103001,"อาคารจอดรถศูนย์กีฬาประชานิเวศน์",44,282,308,378,686
3746,"ลาดยาว","เขตจตุจักร",103001,"เต็นท์บริเวณลานอเนกประสงค์หน้าหมู่บ้านชลนิเวศน์",45,245,259,360,619
3747,"ลาดยาว","เขตจตุจักร",103001,"เต็นท์บริเวณลานอเนกประสงค์หน้าหมู่บ้านชลนิเวศน์",46,221,245,362,607
3748,"ลาดยาว","เขตจตุจักร",103001,"อาคารศาลารวมใจหมู่บ้านจัดสรรปูนซิเมนต์ไทย",47,479,409,504,913
3749,"ลาดยาว","เขตจตุจักร",103001,"อาคารศาลารวมใจหมู่บ้านจัดสรรปูนซิเมนต์ไทย",48,269,392,520,912
3750,"ลาดยาว","เขตจตุจักร",103001,"เต็นท์บริเวณศาลารวมใจหมู่บ้านจัดสรรปูนซิเมนต์ไทย",49,320,391,511,902
3751,"เสนานิคม","เขตจตุจักร",103002,"อาคารอเนกประสงค์โรงเรียนสารวิทยา",1,202,316,344,660
3752,"เสนานิคม","เขตจตุจักร",103002,"อาคารอเนกประสงค์โรงเรียนสารวิทยา",2,195,337,323,660
3753,"เสนานิคม","เขตจตุจักร",103002,"อาคารอเนกประสงค์โรงเรียนสารวิทยา",3,222,291,193,484
3754,"เสนานิคม","เขตจตุจักร",103002,"อาคารอเนกประสงค์โรงเรียนสารวิทยา",4,221,263,231,494
3755,"เสนานิคม","เขตจตุจักร",103002,"เต็นท์บริเวณการทางพิเศษแห่งประเทศไทย (ถนนพหลโยธิน)",5,250,234,326,560
3756,"เสนานิคม","เขตจตุจักร",103002,"เต็นท์บริเวณการทางพิเศษแห่งประเทศไทย (ถนนพหลโยธิน)",6,178,241,318,559
3757,"เสนานิคม","เขตจตุจักร",103002,"เต็นท์บริเวณสนามเด็กเล่นหมู่บ้านอยู่เจริญ (ซอยพหลโยธิน40)",7,357,354,461,815
3758,"เสนานิคม","เขตจตุจักร",103002,"เต็นท์บริเวณสนามเด็กเล่นหมู่บ้านอยู่เจริญ (ซอยพหลโยธิน40)",8,323,336,468,804
3759,"เสนานิคม","เขตจตุจักร",103002,"เต็นท์บริเวณกรมยุทธโยธาทหารบก (แยกเกษตร-นวมินทร์)",9,403,317,440,757
3760,"เสนานิคม","เขตจตุจักร",103002,"เต็นท์บริเวณกรมยุทธโยธาทหารบก (แยกเกษตร-นวมินทร์)",10,283,390,344,734
3761,"เสนานิคม","เขตจตุจักร",103002,"เต็นท์บริเวณกรมยุทธโยธาทหารบก (แยกเกษตร-นวมินทร์)",11,591,342,424,766
3762,"เสนานิคม","เขตจตุจักร",103002,"เต็นท์บริเวณกรมยุทธโยธาทหารบก (แยกเกษตร-นวมินทร์)",12,577,276,452,728
3763,"เสนานิคม","เขตจตุจักร",103002,"เต็นท์บริเวณลานจอดรถบริษัท โอ.จี.ที. จำกัดข้างโรงเรียนอนุบาลไสวตาแตง (ซอยเสนานิคม2)",13,442,341,479,820
3764,"เสนานิคม","เขตจตุจักร",103002,"เต็นท์บริเวณลานจอดรถบริษัท โอ.จี.ที. จำกัดข้างโรงเรียนอนุบาลไสวตาแตง (ซอยเสนานิคม2)",14,583,368,442,810
3765,"เสนานิคม","เขตจตุจักร",103002,"เต็นท์บริเวณลานจอดรถบริษัท โอ.จี.ที. จำกัดข้างโรงเรียนอนุบาลไสวตาแตง (ซอยเสนานิคม2)",15,549,354,483,837
3766,"เสนานิคม","เขตจตุจักร",103002,"เต็นท์บริเวณลานจอดรถ บริษัท โอ.จี.ที. จำกัดข้างโรงเรียนอนุบาลไสวตาแตง (ซอยเสนานิคม2)",16,270,395,447,842
3767,"เสนานิคม","เขตจตุจักร",103002,"เต็นท์บริเวณลานจอดรถ บริษัท โอ.จี.ที. จำกัดข้างโรงเรียนอนุบาลไสวตาแตง (ซอยเสนานิคม2)",17,452,343,486,829
3768,"เสนานิคม","เขตจตุจักร",103002,"เต็นท์บริเวณลานจอดรถ บริษัท โอ.จี.ที. จำกัดข้างโรงเรียนอนุบาลไสวตาแตง (ซอยเสนานิคม2)",18,576,344,475,819
3769,"เสนานิคม","เขตจตุจักร",103002,"เต็นท์บริเวณลานจอดรถ บริษัท โอ.จี.ที. จำกัดข้างโรงเรียนอนุบาลไสวตาแตง (ซอยเสนานิคม2)",19,403,367,464,831
3770,"เสนานิคม","เขตจตุจักร",103002,"เต็นท์บริเวณลานจอดรถ บริษัท โอ.จี.ที. จำกัดข้างโรงเรียนอนุบาลไสวตาแตง (ซอยเสนานิคม2)",20,279,384,443,827
3771,"เสนานิคม","เขตจตุจักร",103002,"เต็นท์บริเวณทางเท้าปากซอยเสนานิคม1 ซอย 13 (ซอยวรรณชิต)",21,365,302,394,696
3772,"เสนานิคม","เขตจตุจักร",103002,"เต็นท์บริเวณทางเท้าปากซอยเสนานิคม1 ซอย 13 (ซอยวรรณชิต)",22,347,316,388,704
3773,"เสนานิคม","เขตจตุจักร",103002,"เต็นท์บริเวณทางเท้าปากซอยเสนานิคม1 ซอย 13 (ซอยวรรณชิต)",23,250,316,378,694
3774,"เสนานิคม","เขตจตุจักร",103002,"เต็นท์บริเวณทางเท้าหน้าอาคาร BEE HOUSE (ถนนเสนานิคม1)",24,144,202,204,406
3775,"จันทรเกษม","เขตจตุจักร",103003,"อาคารโรงเรียนเสนานิคม",1,337,338,452,790
3776,"จันทรเกษม","เขตจตุจักร",103003,"อาคารโรงเรียนเสนานิคม",2,452,321,471,792
3777,"จันทรเกษม","เขตจตุจักร",103003,"อาคารโรงเรียนเสนานิคม",3,222,349,443,792
3778,"จันทรเกษม","เขตจตุจักร",103003,"อาคารโรงเรียนเสนานิคม",4,307,329,444,773
3779,"จันทรเกษม","เขตจตุจักร",103003,"อาคารโรงเรียนเสนานิคม",5,313,366,415,781
3780,"จันทรเกษม","เขตจตุจักร",103003,"อาคารโรงเรียนเสนานิคม",6,240,357,434,791
3781,"จันทรเกษม","เขตจตุจักร",103003,"อาคารสระว่ายน้ำ (ซอยพหลโยธิน30)",7,288,504,269,773
3782,"จันทรเกษม","เขตจตุจักร",103003,"อาคารสระว่ายน้ำ (ซอยพหลโยธิน30)",8,376,408,445,853
3783,"จันทรเกษม","เขตจตุจักร",103003,"อาคารสระว่ายน้ำ (ซอยพหลโยธิน30)",9,358,418,442,860
3784,"จันทรเกษม","เขตจตุจักร",103003,"เต็นท์บริเวณทางเท้าหน้าธนาคารกสิกรไทย สาขาบางเขน(ถนนพหลโยธิน)",10,719,382,567,949
3785,"จันทรเกษม","เขตจตุจักร",103003,"เต็นท์บริเวณทางเท้าหน้าปากซอยรัชดาภิเษก44(ตรงข้ามสถานีตำรวจนครบาลพหลโยธิน)",11,198,305,336,641
3786,"จันทรเกษม","เขตจตุจักร",103003,"เต็นท์บริเวณทางเท้าหน้าปากซอยรัชดาภิเษก44(ตรงข้ามสถานีตำรวจนครบาลพหลโยธิน)",12,237,285,369,654
3787,"จันทรเกษม","เขตจตุจักร",103003,"เต็นท์บริเวณทางเท้าหน้าปากซอยรัชดาภิเษก44(ตรงข้ามสถานีตำรวจนครบาลพหลโยธิน)",13,228,260,382,642
3788,"จันทรเกษม","เขตจตุจักร",103003,"เต็นท์บริเวณที่จอดรถหน้าร้านไก่ย่างเสือใหญ่ซอยรัชดาภิเษก36 (ซอยเสือใหญ่อุทิศ)",14,234,293,342,635
3789,"จันทรเกษม","เขตจตุจักร",103003,"เต็นท์บริเวณที่จอดรถหน้าร้านไก่ย่างเสือใหญ่ซอยรัชดาภิเษก36 (ซอยเสือใหญ่อุทิศ)",15,294,278,360,638
3790,"จันทรเกษม","เขตจตุจักร",103003,"อาคารเรียนรวม (อาคาร 28)มหาวิทยาลัยราชภัฏจันทรเกษม ใกล้ประตู 3",16,417,347,475,822
3791,"จันทรเกษม","เขตจตุจักร",103003,"อาคารเรียนรวม (อาคาร 28)มหาวิทยาลัยราชภัฏจันทรเกษม ใกล้ประตู 3",17,484,361,467,828
3792,"จันทรเกษม","เขตจตุจักร",103003,"อาคารเรียนรวม (อาคาร 28)มหาวิทยาลัยราชภัฏจันทรเกษม ใกล้ประตู 3",18,535,344,478,822
3793,"จันทรเกษม","เขตจตุจักร",103003,"อาคารเรียนรวม (อาคาร 28)มหาวิทยาลัยราชภัฏจันทรเกษม ใกล้ประตู 3",19,366,360,473,833
3794,"จันทรเกษม","เขตจตุจักร",103003,"เต็นท์บริเวณลานจอดรถยนต์ ประตู 3กรมส่งเสริมการค้าระหว่างประเทศ (ถนนรัชดาภิเษก)",20,388,394,490,884
3795,"จันทรเกษม","เขตจตุจักร",103003,"เต็นท์บริเวณลานจอดรถยนต์ ประตู 3กรมส่งเสริมการค้าระหว่างประเทศ (ถนนรัชดาภิเษก)",21,326,365,524,889
3796,"จันทรเกษม","เขตจตุจักร",103003,"เต็นท์บริเวณลานจอดรถยนต์ ประตู 3กรมส่งเสริมการค้าระหว่างประเทศ (ถนนรัชดาภิเษก)",22,356,390,502,892
3797,"จันทรเกษม","เขตจตุจักร",103003,"เต็นท์บริเวณลานจอดรถยนต์ ประตู 3กรมส่งเสริมการค้าระหว่างประเทศ (ถนนรัชดาภิเษก)",23,388,399,474,873
3798,"จันทรเกษม","เขตจตุจักร",103003,"เต็นท์บริเวณลานจอดรถยนต์ ประตู 3กรมส่งเสริมการค้าระหว่างประเทศ (ถนนรัชดาภิเษก)",24,477,385,480,865
3799,"จันทรเกษม","เขตจตุจักร",103003,"เต็นท์บริเวณลานจอดรถยนต์ ประตู 3กรมส่งเสริมการค้าระหว่างประเทศ (ถนนรัชดาภิเษก)",25,487,371,498,869
3800,"จันทรเกษม","เขตจตุจักร",103003,"เต็นท์บริเวณลานจอดรถยนต์ ประตู 3กรมส่งเสริมการค้าระหว่างประเทศ (ถนนรัชดาภิเษก)",26,378,386,498,884
3801,"จันทรเกษม","เขตจตุจักร",103003,"เต็นท์บริเวณลานจอดรถยนต์ ประตู 3กรมส่งเสริมการค้าระหว่างประเทศ (ถนนรัชดาภิเษก)",27,525,364,512,876
3802,"จันทรเกษม","เขตจตุจักร",103003,"เต็นท์บริเวณลานจอดรถยนต์ ประตู 3กรมส่งเสริมการค้าระหว่างประเทศ (ถนนรัชดาภิเษก)",28,487,377,474,851
3803,"จันทรเกษม","เขตจตุจักร",103003,"เต็นท์บริเวณสวนสนุกข้างสโมสรหมู่บ้านศุภาลัยวิลล์",29,289,248,345,593
3804,"จันทรเกษม","เขตจตุจักร",103003,"เต็นท์บริเวณลานจอดรถศิขรี แมนชั่น(ซอยลาดพร้าว34)",30,291,260,320,580
3805,"จันทรเกษม","เขตจตุจักร",103003,"เต็นท์บริเวณลานจอดรถศิขรี แมนชั่น(ซอยลาดพร้าว34)",31,434,247,323,570
3806,"จันทรเกษม","เขตจตุจักร",103003,"เต็นท์บริเวณลานจอดรถสนามเทนนิส(ซอยลาดพร้าว33)",32,184,204,290,494
3807,"จันทรเกษม","เขตจตุจักร",103003,"เต็นท์บริเวณลานจอดรถสนามเทนนิส(ซอยลาดพร้าว33)",33,289,212,297,509
3808,"จันทรเกษม","เขตจตุจักร",103003,"เต็นท์ข้างอาคารโรงเรียนบ้านลาดพร้าว",34,299,310,457,767
3809,"จันทรเกษม","เขตจตุจักร",103003,"เต็นท์ข้างอาคารโรงเรียนบ้านลาดพร้าว",35,280,329,435,764
3810,"จันทรเกษม","เขตจตุจักร",103003,"เต็นท์ข้างอาคารโรงเรียนบ้านลาดพร้าว",36,270,342,430,772
3811,"จันทรเกษม","เขตจตุจักร",103003,"เต็นท์ข้างอาคารโรงเรียนบ้านลาดพร้าว",37,294,342,430,772
3812,"จันทรเกษม","เขตจตุจักร",103003,"เต็นท์ข้างอาคารโรงเรียนบ้านลาดพร้าว",38,287,375,390,765
3813,"จันทรเกษม","เขตจตุจักร",103003,"เต็นท์ข้างอาคารโรงเรียนบ้านลาดพร้าว",39,263,336,429,765
3814,"จันทรเกษม","เขตจตุจักร",103003,"เต็นท์ข้างอาคารโรงเรียนบ้านลาดพร้าว",40,283,352,413,765
3815,"จันทรเกษม","เขตจตุจักร",103003,"เต็นท์ข้างอาคารโรงเรียนบ้านลาดพร้าว",41,251,360,408,768
3816,"จอมพล","เขตจตุจักร",103004,"อาคารโรงเรียนสตรีวรนาถบางเขน (ถนนพหลโยธิน)",1,296,328,398,726
3817,"จอมพล","เขตจตุจักร",103004,"อาคารโรงเรียนสตรีวรนาถบางเขน (ถนนพหลโยธิน)",2,442,305,453,758
3818,"จอมพล","เขตจตุจักร",103004,"อาคารโรงเรียนสตรีวรนาถบางเขน (ถนนพหลโยธิน)",3,279,309,424,733
3819,"จอมพล","เขตจตุจักร",103004,"อาคารโรงเรียนสตรีวรนาถบางเขน (ถนนพหลโยธิน)",4,386,335,420,755
3820,"จอมพล","เขตจตุจักร",103004,"เต็นท์บริเวณกรมการขนส่งทางบก (ถนนพหลโยธิน)",5,697,373,482,855
3821,"จอมพล","เขตจตุจักร",103004,"เต็นท์บริเวณกรมการขนส่งทางบก (ถนนพหลโยธิน)",6,576,412,461,873
3822,"จอมพล","เขตจตุจักร",103004,"เต็นท์บริเวณกรมการขนส่งทางบก (ถนนพหลโยธิน)",7,558,363,489,852
3823,"จอมพล","เขตจตุจักร",103004,"เต็นท์บริเวณทางเท้าหน้าโชว์รูม BMW Barcelona Motor (ปากซอยวิภาวดีรังสิต22)",8,416,377,426,803
3824,"จอมพล","เขตจตุจักร",103004,"เต็นท์บริเวณทางเท้าหน้าโชว์รูม BMW Barcelona Motor (ปากซอยวิภาวดีรังสิต22)",9,445,317,435,752
3825,"จอมพล","เขตจตุจักร",103004,"เต็นท์บริเวณลานจอดรถ บริษัท จัดการและพัฒนาทรัพยากรน้ำภาคตะวันออก จำกัด (มหาชน) (ซอยวิภาวดีรังสิต5)",10,445,330,463,793
3826,"จอมพล","เขตจตุจักร",103004,"เต็นท์บริเวณลานจอดรถ บริษัท จัดการและพัฒนาทรัพยากรน้ำภาคตะวันออก จำกัด (มหาชน) (ซอยวิภาวดีรังสิต5)",11,626,332,420,752
3827,"จอมพล","เขตจตุจักร",103004,"เต็นท์บริเวณลานจอดรถ บริษัท จัดการและพัฒนาทรัพยากรน้ำภาคตะวันออก จำกัด (มหาชน) (ซอยวิภาวดีรังสิต5)",12,355,329,456,785
3828,"จอมพล","เขตจตุจักร",103004,"เต็นท์บริเวณลานจอดรถ บริษัท จัดการและพัฒนาทรัพยากรน้ำภาคตะวันออก จำกัด (มหาชน) (ซอยวิภาวดีรังสิต5)",13,468,321,433,754
3829,"จอมพล","เขตจตุจักร",103004,"เต็นท์บริเวณลานจอดรถปั๊มน้ำมันซัสโก้ (ปากซอยวิภาวดีรังสิต20)",14,365,315,406,721
3830,"จอมพล","เขตจตุจักร",103004,"เต็นท์บริเวณลานจอดรถปั๊มน้ำมันซัสโก้ (ปากซอยวิภาวดีรังสิต20)",15,266,317,383,700
3831,"จอมพล","เขตจตุจักร",103004,"เต็นท์บริเวณลานจอดรถปั๊มน้ำมันซัสโก้ (ปากซอยวิภาวดีรังสิต20)",16,288,284,413,697
3832,"จอมพล","เขตจตุจักร",103004,"เต็นท์บริเวณลานจอดรถ บริษัท ตือ จำกัดข้างซอยวิภาวดีรังสิต16/6",17,253,338,414,752
3833,"จอมพล","เขตจตุจักร",103004,"เต็นท์บริเวณลานจอดรถ บริษัท ตือ จำกัดข้างซอยวิภาวดีรังสิต16/6",18,377,307,436,743
3834,"จอมพล","เขตจตุจักร",103004,"เต็นท์บริเวณลานจอดรถ บริษัท ตือ จำกัดข้างซอยวิภาวดีรังสิต16/6",19,420,289,475,764
3835,"จอมพล","เขตจตุจักร",103004,"เต็นท์บริเวณลานจอดรถ บริษัท ตือ จำกัดข้างซอยวิภาวดีรังสิต16/6",20,425,286,480,766
3836,"จอมพล","เขตจตุจักร",103004,"เต็นท์บริเวณลานจอดรถธีรวรรณแมนชั่น (ซอยลาดพร้าว1)",21,312,358,436,794
3837,"จอมพล","เขตจตุจักร",103004,"เต็นท์บริเวณลานจอดรถธีรวรรณแมนชั่น (ซอยลาดพร้าว1)",22,377,346,481,827
3838,"จอมพล","เขตจตุจักร",103004,"เต็นท์บริเวณลานจอดรถธีรวรรณแมนชั่น (ซอยลาดพร้าว1)",23,312,344,446,790
3839,"จอมพล","เขตจตุจักร",103004,"เต็นท์บริเวณลานจอดรถธีรวรรณแมนชั่น (ซอยลาดพร้าว1)",24,340,329,438,767
3840,"จอมพล","เขตจตุจักร",103004,"เต็นท์บริเวณทางเท้าหน้าห้างบิ๊กซี (ถนนลาดพร้าว)",25,302,373,458,831
3841,"จอมพล","เขตจตุจักร",103004,"เต็นท์บริเวณทางเท้าหน้าห้างบิ๊กซี (ถนนลาดพร้าว)",26,667,365,487,852
3842,"จอมพล","เขตจตุจักร",103004,"เต็นท์บริเวณทางเท้าหน้าห้างบิ๊กซี (ถนนลาดพร้าว)",27,536,361,481,842
3843,"จอมพล","เขตจตุจักร",103004,"เต็นท์บริเวณทางเท้าหน้าห้างบิ๊กซี (ถนนลาดพร้าว)",28,437,353,495,848
3844,"จอมพล","เขตจตุจักร",103004,"เต็นท์บริเวณทางเท้าหน้าห้างบิ๊กซี (ถนนลาดพร้าว)",29,386,355,465,820
3845,"จอมพล","เขตจตุจักร",103004,"เต็นท์บริเวณทางเท้าหน้าห้างบิ๊กซี (ถนนลาดพร้าว)",30,352,382,454,836
3846,"จอมพล","เขตจตุจักร",103004,"เต็นท์บริเวณทางเท้าหน้าห้างบิ๊กซี (ถนนลาดพร้าว)",31,558,333,537,870
3847,"จอมพล","เขตจตุจักร",103004,"เต็นท์บริเวณที่จอดรถธนาคารไทยพาณิชย์ สาขาลาดพร้าว ซอย 10",32,351,307,382,689
3848,"จอมพล","เขตจตุจักร",103004,"เต็นท์บริเวณที่จอดรถธนาคารไทยพาณิชย์ สาขาลาดพร้าว ซอย 10",33,316,264,375,639
3849,"จอมพล","เขตจตุจักร",103004,"เต็นท์บริเวณสนามเด็กเล่นหมู่บ้านอยู่เจริญพัฒนา",34,438,303,447,750
3850,"จอมพล","เขตจตุจักร",103004,"เต็นท์บริเวณสนามเด็กเล่นหมู่บ้านอยู่เจริญพัฒนา",35,346,290,423,713
3851,"จอมพล","เขตจตุจักร",103004,"เต็นท์หน้าอาคารโรงเรียนบีคอนเฮาส์ แย้มสอาด ลาดพร้าว(ซอยลาดพร้าว26)",36,283,270,356,626
3852,"จอมพล","เขตจตุจักร",103004,"เต็นท์หน้าอาคารโรงเรียนบีคอนเฮาส์ แย้มสอาด ลาดพร้าว(ซอยลาดพร้าว26)",37,355,244,371,615
3853,"จตุจักร","เขตจตุจักร",103005,"เต็นท์บริเวณหน้าอาคาร East SCB Park Plazaธนาคารไทยพาณิชย์ จำกัด (มหาชน) แยกรัชโยธิน",1,420,342,501,843
3854,"จตุจักร","เขตจตุจักร",103005,"เต็นท์บริเวณหน้าอาคาร East SCB Park Plazaธนาคารไทยพาณิชย์ จำกัด (มหาชน) แยกรัชโยธิน",2,623,372,522,894
3855,"จตุจักร","เขตจตุจักร",103005,"เต็นท์บริเวณหน้าอาคาร East SCB Park Plazaธนาคารไทยพาณิชย์ จำกัด (มหาชน) แยกรัชโยธิน",3,495,394,479,873
3856,"จตุจักร","เขตจตุจักร",103005,"อาคารโรงเรียนเซนต์จอห์น (ซอยวิภาวดีรังสิต32)",4,336,350,463,813
3857,"จตุจักร","เขตจตุจักร",103005,"อาคารโรงเรียนเซนต์จอห์น (ซอยวิภาวดีรังสิต32)",5,312,333,494,827
3858,"จตุจักร","เขตจตุจักร",103005,"อาคารโรงเรียนธัชรินทร์วิทยาบางเขน ถนนวิภาวดีรังสิต",6,187,291,325,616
3859,"จตุจักร","เขตจตุจักร",103005,"อาคารโรงเรียนธัชรินทร์วิทยาบางเขน ถนนวิภาวดีรังสิต",7,182,283,317,600
3860,"จตุจักร","เขตจตุจักร",103005,"อาคารโรงเรียนธัชรินทร์วิทยาบางเขน ถนนวิภาวดีรังสิต",8,319,267,348,615
3861,"จตุจักร","เขตจตุจักร",103005,"เต็นท์บริเวณลานกีฬาชุมชนภักดี",9,269,372,451,823
3862,"จตุจักร","เขตจตุจักร",103005,"เต็นท์บริเวณลานกีฬาชุมชนภักดี",10,240,412,440,852
3863,"จตุจักร","เขตจตุจักร",103005,"เต็นท์บริเวณลานกีฬาชุมชนภักดี",11,271,405,454,859
3864,"จตุจักร","เขตจตุจักร",103005,"เต็นท์บริเวณศาลาอเนกประสงค์บ้านพักรถไฟ กม.11",12,294,416,273,689
3865,"จตุจักร","เขตจตุจักร",103005,"เต็นท์บริเวณศาลาอเนกประสงค์บ้านพักรถไฟ กม.11",13,277,419,275,694
3866,"จตุจักร","เขตจตุจักร",103005,"เต็นท์บริเวณศาลาอเนกประสงค์บ้านพักรถไฟ กม.11",14,300,391,261,652
3867,"จตุจักร","เขตจตุจักร",103005,"เต็นท์บริเวณศาลาอเนกประสงค์บ้านพักรถไฟ กม.11",15,330,394,242,636
3868,"จตุจักร","เขตจตุจักร",103005,"เต็นท์บริเวณถนนหน้าสำนักงานสวัสดิการกองบัญชาการกองทัพไทย (บก.สูงสุด)",16,258,372,410,782
3869,"จตุจักร","เขตจตุจักร",103005,"เต็นท์บริเวณถนนหน้าสำนักงานสวัสดิการกองบัญชาการกองทัพไทย (บก.สูงสุด)",17,238,384,408,792
3870,"จตุจักร","เขตจตุจักร",103005,"เต็นท์บริเวณถนนหน้าสำนักงานสวัสดิการกองบัญชาการกองทัพไทย (บก.สูงสุด)",18,315,347,412,759
3871,"จตุจักร","เขตจตุจักร",103005,"เต็นท์บริเวณถนนหน้าสำนักงานสวัสดิการกองบัญชาการกองทัพไทย (บก.สูงสุด)",19,420,326,443,769
3872,"จตุจักร","เขตจตุจักร",103005,"เต็นท์บริเวณถนนหน้าสำนักงานสวัสดิการกองบัญชาการกองทัพไทย (บก.สูงสุด)",20,400,379,390,769
3873,"จตุจักร","เขตจตุจักร",103005,"อาคารร้าน GB Wrap (ซอยรัชดาภิเษก31)",21,312,325,388,713
3874,"จตุจักร","เขตจตุจักร",103005,"เต็นท์บริเวณลานกีฬาการทางพิเศษแห่งประเทศไทยใต้ทางด่วนด่านรัชดาภิเษก",22,164,230,277,507
3875,"บางคอแหลม","เขตบางคอแหลม",103101,"โรงเรียนรักษาราชวิตร",1,159,241,267,508
3876,"บางคอแหลม","เขตบางคอแหลม",103101,"โรงเรียนรักษาราชวิตร",2,146,266,323,589
3877,"บางคอแหลม","เขตบางคอแหลม",103101,"เต็นท์บริเวณโรงเรียนรักษาราชวิตร",3,125,279,291,570
3878,"บางคอแหลม","เขตบางคอแหลม",103101,"เต็นท์บริเวณโรงเรียนรักษาราชวิตร",4,140,282,325,607
3879,"บางคอแหลม","เขตบางคอแหลม",103101,"บริเวณโรงเรียนสอนศาสนามัสยิดอัลอะติ๊ก",5,135,301,337,638
3880,"บางคอแหลม","เขตบางคอแหลม",103101,"บริเวณโรงเรียนสอนศาสนามัสยิดอัลอะติ๊ก",6,137,274,337,611
3881,"บางคอแหลม","เขตบางคอแหลม",103101,"โรงเรียนวัดลาดบัวขาว",7,163,286,327,613
3882,"บางคอแหลม","เขตบางคอแหลม",103101,"โรงเรียนวัดลาดบัวขาว",8,295,234,330,564
3883,"บางคอแหลม","เขตบางคอแหลม",103101,"โรงเรียนวัดลาดบัวขาว",9,172,285,298,583
3884,"บางคอแหลม","เขตบางคอแหลม",103101,"โรงเรียนวัดลาดบัวขาว",10,312,249,350,599
3885,"บางคอแหลม","เขตบางคอแหลม",103101,"อาคารอเนกประสงค์มัสยิดอัสสละฟิยะฮ์",11,149,261,298,559
3886,"บางคอแหลม","เขตบางคอแหลม",103101,"เต็นท์บริเวณมัสยิดอัสสละฟิยะฮ์",12,148,172,227,399
3887,"บางคอแหลม","เขตบางคอแหลม",103101,"เต็นท์บริเวณมัสยิดอัสสละฟิยะฮ์",13,132,206,230,436
3888,"บางคอแหลม","เขตบางคอแหลม",103101,"เต็นท์หน้าชุมชนมาตานุสรณ์",14,104,220,225,445
3889,"บางคอแหลม","เขตบางคอแหลม",103101,"เต็นท์หน้าชุมชนมาตานุสรณ์",15,137,135,188,323
3890,"บางคอแหลม","เขตบางคอแหลม",103101,"เต็นท์บริเวณลานจอดรถร้านอาหารเดอะวิว วิลเลจ",16,104,202,453,655
3891,"บางคอแหลม","เขตบางคอแหลม",103101,"เต็นท์บริเวณลานจอดรถร้านอาหารเดอะวิว วิลเลจ",17,393,242,376,618
3892,"บางคอแหลม","เขตบางคอแหลม",103101,"เต็นท์บริเวณลานจอดรถร้านอาหารเดอะวิว วิลเลจ",18,139,262,279,541
3893,"บางคอแหลม","เขตบางคอแหลม",103101,"เต็นท์บริเวณลานจอดรถร้านอาหารเดอะวิว วิลเลจ",19,171,292,322,614
3894,"บางคอแหลม","เขตบางคอแหลม",103101,"เต็นท์บริเวณลานจอดรถร้านอาหารเดอะวิว วิลเลจ",20,182,258,344,602
3895,"บางคอแหลม","เขตบางคอแหลม",103101,"เต็นท์บริเวณลานจอดรถร้านอาหารเดอะวิว วิลเลจ",21,243,279,331,610
3896,"บางคอแหลม","เขตบางคอแหลม",103101,"เต็นท์บริเวณลานจอดรถร้านอาหารเดอะวิว วิลเลจ",22,124,223,207,430
3897,"บางคอแหลม","เขตบางคอแหลม",103101,"เต็นท์ในโรงเรียนคริสตจักร์เจริญกรุงไมตรีจิต",23,77,166,212,378
3898,"บางคอแหลม","เขตบางคอแหลม",103101,"เต็นท์ในโรงเรียนคริสตจักร์เจริญกรุงไมตรีจิต",24,102,195,210,405
3899,"บางคอแหลม","เขตบางคอแหลม",103101,"เต็นท์ในโรงเรียนคริสตจักร์เจริญกรุงไมตรีจิต",25,127,223,247,470
3900,"บางคอแหลม","เขตบางคอแหลม",103101,"เต็นท์บริเวณลานจอดรถบริษัท ทีโอที จำกัด (มหาชน)",26,172,238,285,523
3901,"บางคอแหลม","เขตบางคอแหลม",103101,"เต็นท์บริเวณลานจอดรถบริษัท ทีโอที จำกัด (มหาชน)",27,127,201,242,443
3902,"บางคอแหลม","เขตบางคอแหลม",103101,"เต็นท์บริเวณลานจอดรถบริษัท ทีโอที จำกัด (มหาชน)",28,108,161,182,343
3903,"บางคอแหลม","เขตบางคอแหลม",103101,"เต็นท์บริเวณลานจอดรถบริษัท ทีโอที จำกัด (มหาชน)",29,157,234,277,511
3904,"บางคอแหลม","เขตบางคอแหลม",103101,"อาคารสงเคราะห์ข้าราชการและลูกจ้างประจำ กทม.",30,259,219,270,489
3905,"บางคอแหลม","เขตบางคอแหลม",103101,"เต็นท์หน้าห้างสรรพสินค้า Tree on 3",31,152,199,231,430
3906,"บางคอแหลม","เขตบางคอแหลม",103101,"เต็นท์หน้าห้างสรรพสินค้า Tree on 3",32,146,203,238,441
3907,"บางคอแหลม","เขตบางคอแหลม",103101,"วัดอินทร์บรรจงทรงวาดราษฏร์บำรุง",33,143,251,288,539
3908,"วัดพระยาไกร","เขตบางคอแหลม",103102,"มัสยิดดารุ้ลอาบิดีน",1,146,126,179,305
3909,"วัดพระยาไกร","เขตบางคอแหลม",103102,"ศูนย์บริการสาธารณสุข 14",2,128,173,235,408
3910,"วัดพระยาไกร","เขตบางคอแหลม",103102,"เต็นท์หน้าศูนย์บริการสาธารณสุข 14",3,107,161,192,353
3911,"วัดพระยาไกร","เขตบางคอแหลม",103102,"เต็นท์บริเวณลานจอดรถบ้านเลขที่ 1 ซอยมิตรสัมพันธ์",4,161,233,255,488
3912,"วัดพระยาไกร","เขตบางคอแหลม",103102,"เต็นท์บริเวณลานจอดรถบ้านเลขที่ 1 ซอยมิตรสัมพันธ์",5,146,279,282,561
3913,"วัดพระยาไกร","เขตบางคอแหลม",103102,"เต็นท์บริเวณลานจอดรถท๊อปวิวคอนโด ปากซอยกิ่งจันทน์",6,162,227,262,489
3914,"วัดพระยาไกร","เขตบางคอแหลม",103102,"เต็นท์บริเวณลานจอดรถท๊อปวิวคอนโด ปากซอยกิ่งจันทน์",7,161,239,280,519
3915,"วัดพระยาไกร","เขตบางคอแหลม",103102,"เต็นท์บริเวณลานจอดรถท๊อปวิวคอนโด ปากซอยกิ่งจันทน์",8,199,231,307,538
3916,"วัดพระยาไกร","เขตบางคอแหลม",103102,"มัสยิดบาหยัน",9,98,194,209,403
3917,"วัดพระยาไกร","เขตบางคอแหลม",103102,"โรงเรียนมูลนิธิสตรีไทยมุสลิม",10,154,202,248,450
3918,"วัดพระยาไกร","เขตบางคอแหลม",103102,"โรงเรียนมูลนิธิสตรีไทยมุสลิม",11,212,245,338,583
3919,"วัดพระยาไกร","เขตบางคอแหลม",103102,"โรงเรียนมูลนิธิสตรีไทยมุสลิม",12,102,161,161,322
3920,"วัดพระยาไกร","เขตบางคอแหลม",103102,"โรงเรียนมูลนิธิสตรีไทยมุสลิม",13,125,197,217,414
3921,"วัดพระยาไกร","เขตบางคอแหลม",103102,"โรงเรียนมูลนิธิสตรีไทยมุสลิม",14,114,195,235,430
3922,"วัดพระยาไกร","เขตบางคอแหลม",103102,"โรงเรียนมูลนิธิสตรีไทยมุสลิม",15,134,209,274,483
3923,"วัดพระยาไกร","เขตบางคอแหลม",103102,"เต็นท์ในโรงเรียนลักษณเกียรติศึกษา",16,145,252,292,544
3924,"วัดพระยาไกร","เขตบางคอแหลม",103102,"เต็นท์ในโรงเรียนลักษณเกียรติศึกษา",17,145,244,306,550
3925,"วัดพระยาไกร","เขตบางคอแหลม",103102,"เต็นท์ในโรงเรียนลักษณเกียรติศึกษา",18,250,257,355,612
3926,"วัดพระยาไกร","เขตบางคอแหลม",103102,"เต็นท์ในโรงเรียนลักษณเกียรติศึกษา",19,145,280,284,564
3927,"วัดพระยาไกร","เขตบางคอแหลม",103102,"โรงเรียนวัดราชสิงขร",20,145,275,305,580
3928,"วัดพระยาไกร","เขตบางคอแหลม",103102,"โรงเรียนวัดราชสิงขร",21,107,246,291,537
3929,"วัดพระยาไกร","เขตบางคอแหลม",103102,"โรงเรียนวัดราชสิงขร",22,132,256,313,569
3930,"วัดพระยาไกร","เขตบางคอแหลม",103102,"โรงเรียนวัดราชสิงขร",23,119,247,288,535
3931,"วัดพระยาไกร","เขตบางคอแหลม",103102,"โรงเรียนวัดราชสิงขร",24,151,236,244,480
3932,"วัดพระยาไกร","เขตบางคอแหลม",103102,"โรงเรียนวัดราชสิงขร",25,151,260,298,558
3933,"วัดพระยาไกร","เขตบางคอแหลม",103102,"โรงเรียนวัดราชสิงขร",26,144,183,225,408
3934,"วัดพระยาไกร","เขตบางคอแหลม",103102,"โรงเรียนวัดราชสิงขร",27,235,239,273,512
3935,"วัดพระยาไกร","เขตบางคอแหลม",103102,"เต็นท์บริเวณลานจอดรถเอเชียทีค",28,109,236,249,485
3936,"วัดพระยาไกร","เขตบางคอแหลม",103102,"เต็นท์บริเวณลานจอดรถเอเชียทีค",29,104,245,251,496
3937,"วัดพระยาไกร","เขตบางคอแหลม",103102,"เต็นท์บริเวณลานจอดรถเอเชียทีค",30,103,205,274,479
3938,"วัดพระยาไกร","เขตบางคอแหลม",103102,"เต็นท์บริเวณลานจอดรถเอเชียทีค",31,87,253,256,509
3939,"วัดพระยาไกร","เขตบางคอแหลม",103102,"เต็นท์บริเวณลานจอดรถเอเชียทีค",32,107,223,267,490
3940,"วัดพระยาไกร","เขตบางคอแหลม",103102,"เต็นท์บริเวณลานจอดรถเอเชียทีค",33,105,232,261,493
3941,"วัดพระยาไกร","เขตบางคอแหลม",103102,"เต็นท์บริเวณลานจอดรถเอเชียทีค",34,112,240,300,540
3942,"วัดพระยาไกร","เขตบางคอแหลม",103102,"เต็นท์บริเวณลานจอดรถเอเชียทีค",35,127,245,296,541
3943,"วัดพระยาไกร","เขตบางคอแหลม",103102,"เต็นท์บริเวณลานจอดรถเอเชียทีค",36,152,213,233,446
3944,"วัดพระยาไกร","เขตบางคอแหลม",103102,"เต็นท์บริเวณลานจอดรถเอเชียทีค",37,141,208,271,479
3945,"วัดพระยาไกร","เขตบางคอแหลม",103102,"โรงเรียนเพาะปัญญา",38,137,244,306,550
3946,"วัดพระยาไกร","เขตบางคอแหลม",103102,"โรงเรียนเพาะปัญญา",39,178,298,334,632
3947,"บางโคล่","เขตบางคอแหลม",103103,"โรงเรียนวัดบางโคล่นอก",1,187,189,226,415
3948,"บางโคล่","เขตบางคอแหลม",103103,"โรงเรียนวัดบางโคล่นอก",2,184,253,310,563
3949,"บางโคล่","เขตบางคอแหลม",103103,"โรงเรียนวัดไทร",3,203,251,293,544
3950,"บางโคล่","เขตบางคอแหลม",103103,"โรงเรียนวัดไทร",4,149,237,274,511
3951,"บางโคล่","เขตบางคอแหลม",103103,"โรงเรียนวัดไทร",5,214,275,322,597
3952,"บางโคล่","เขตบางคอแหลม",103103,"โรงเรียนวัดไทร",6,258,327,361,688
3953,"บางโคล่","เขตบางคอแหลม",103103,"โรงเรียนวัดไทร",7,178,275,295,570
3954,"บางโคล่","เขตบางคอแหลม",103103,"โรงเรียนวัดไทร",8,122,227,276,503
3955,"บางโคล่","เขตบางคอแหลม",103103,"โรงเรียนวัดจันทร์ใน",9,155,254,269,523
3956,"บางโคล่","เขตบางคอแหลม",103103,"โรงเรียนวัดจันทร์ใน",10,160,234,301,535
3957,"บางโคล่","เขตบางคอแหลม",103103,"โรงเรียนวัดจันทร์ใน",11,178,221,266,487
3958,"บางโคล่","เขตบางคอแหลม",103103,"โรงเรียนวัดจันทร์ใน",12,184,154,256,410
3959,"บางโคล่","เขตบางคอแหลม",103103,"โรงเรียนวัดจันทร์ใน",13,191,251,281,532
3960,"บางโคล่","เขตบางคอแหลม",103103,"เต็นท์ริมถนนเจริญราษฎร์ หน้าบ้านหนังสือ",14,216,282,348,630
3961,"บางโคล่","เขตบางคอแหลม",103103,"เต็นท์ริมถนนเจริญราษฎร์ หน้าบ้านหนังสือ",15,341,275,392,667
3962,"บางโคล่","เขตบางคอแหลม",103103,"เต็นท์ริมถนนเจริญราษฎร์ หน้าบ้านหนังสือ",16,176,266,306,572
3963,"บางโคล่","เขตบางคอแหลม",103103,"เต็นท์ริมถนนเจริญราษฎร์ หน้าบ้านหนังสือ",17,215,345,362,707
3964,"บางโคล่","เขตบางคอแหลม",103103,"อาคารศุภาลัยคอนโด",18,361,227,304,531
3965,"บางโคล่","เขตบางคอแหลม",103103,"อาคารศุภาลัยคอนโด",19,331,152,242,394
3966,"บางโคล่","เขตบางคอแหลม",103103,"เต็นท์ริมถนนเจริญราษฎร์ หน้าอาคารศุภาลัยคอนโด",20,135,216,223,439
3967,"บางโคล่","เขตบางคอแหลม",103103,"เต็นท์ริมถนนเจริญราษฎร์ หน้าอาคารศุภาลัยคอนโด",21,146,223,261,484
3968,"บางโคล่","เขตบางคอแหลม",103103,"เต็นท์บริเวณลานกีฬาเมืองอยู่ดี",22,154,242,271,513
3969,"บางโคล่","เขตบางคอแหลม",103103,"เต็นท์บริเวณลานกีฬาเมืองอยู่ดี",23,152,229,272,501
3970,"บางโคล่","เขตบางคอแหลม",103103,"เต็นท์บริเวณลานกีฬาเมืองอยู่ดี",24,204,294,326,620
3971,"บางโคล่","เขตบางคอแหลม",103103,"เต็นท์บริเวณลานกีฬาเมืองอยู่ดี",25,162,219,292,511
3972,"บางโคล่","เขตบางคอแหลม",103103,"เต็นท์บริเวณลานกีฬาเมืองอยู่ดี",26,181,250,309,559
3973,"บางโคล่","เขตบางคอแหลม",103103,"เต็นท์บริเวณศูนย์การค้ากรีนเพลส ซอยวัดไผ่เงิน",27,123,178,208,386
3974,"บางโคล่","เขตบางคอแหลม",103103,"โรงเรียนวัดไผ่เงินโชตนาราม",28,183,224,235,459
3975,"บางโคล่","เขตบางคอแหลม",103103,"โรงเรียนวัดไผ่เงินโชตนาราม",29,152,256,294,550
3976,"บางโคล่","เขตบางคอแหลม",103103,"เต็นท์บริเวณลานกีฬาเมืองอยู่ดี",30,84,206,207,413
3977,"บางโคล่","เขตบางคอแหลม",103103,"โรงเรียนวัดไผ่เงินโชตนาราม",31,108,263,286,549
3978,"บางโคล่","เขตบางคอแหลม",103103,"โรงเรียนวัดไผ่เงินโชตนาราม",32,125,252,282,534
3979,"บางโคล่","เขตบางคอแหลม",103103,"อาคารจอดรถสำนักวัณโรค",33,129,252,277,529
3980,"บางโคล่","เขตบางคอแหลม",103103,"อาคารจอดรถสำนักวัณโรค",34,141,268,273,541
3981,"บางโคล่","เขตบางคอแหลม",103103,"อาคารจอดรถสำนักวัณโรค",35,133,263,271,534
3982,"บางโคล่","เขตบางคอแหลม",103103,"อาคารจอดรถสำนักวัณโรค",36,168,206,266,472
3983,"บางโคล่","เขตบางคอแหลม",103103,"โรงเรียนอนุบาลสุพิศมร",37,182,239,273,512
3984,"บางโคล่","เขตบางคอแหลม",103103,"โรงเรียนอนุบาลสุพิศมร",38,222,269,303,572
3985,"บางโคล่","เขตบางคอแหลม",103103,"โรงเรียนอนุบาลสุพิศมร",39,193,244,280,524
3986,"บางโคล่","เขตบางคอแหลม",103103,"โรงเรียนอนุบาลสุพิศมร",40,239,265,344,609
3987,"บางโคล่","เขตบางคอแหลม",103103,"เต็นท์ในสมาคมตระกูลโต๋ว",41,138,234,238,472
3988,"บางโคล่","เขตบางคอแหลม",103103,"เต็นท์ในสมาคมตระกูลโต๋ว",42,110,188,234,422
3989,"บางโคล่","เขตบางคอแหลม",103103,"โรงเรียนยอแซฟ",43,134,212,221,433
3990,"บางโคล่","เขตบางคอแหลม",103103,"โรงเรียนยอแซฟ",44,213,284,368,652
3991,"บางโคล่","เขตบางคอแหลม",103103,"โรงเรียนวาสุเทวี",45,124,197,238,435
3992,"บางโคล่","เขตบางคอแหลม",103103,"โรงเรียนวาสุเทวี",46,149,224,269,493
3993,"บางโคล่","เขตบางคอแหลม",103103,"โรงเรียนวาสุเทวี",47,168,211,286,497
3994,"บางโคล่","เขตบางคอแหลม",103103,"โรงเรียนสอนศาสนามัสยิดอมันนฤมิต",48,173,254,299,553
3995,"บางโคล่","เขตบางคอแหลม",103103,"โรงเรียนสอนศาสนามัสยิดอมันนฤมิต",49,84,224,209,433
3996,"บางโคล่","เขตบางคอแหลม",103103,"วัดเรืองยศสุทธาราม",50,229,273,328,601
3997,"บางโคล่","เขตบางคอแหลม",103103,"วัดเรืองยศสุทธาราม",51,332,266,309,575
3998,"บางโคล่","เขตบางคอแหลม",103103,"วัดเรืองยศสุทธาราม",52,211,289,327,616
3999,"บางโคล่","เขตบางคอแหลม",103103,"วัดเรืองยศสุทธาราม",53,174,283,324,607
4000,"บางโคล่","เขตบางคอแหลม",103103,"วัดเรืองยศสุทธาราม",54,214,270,323,593
4001,"ประเวศ","เขตประเวศ",103201,"เต็นท์ในคอนโดลุมพินี (ซอยอ่อนนุช 55-1)",1,216,298,367,665
4002,"ประเวศ","เขตประเวศ",103201,"เต็นท์ในคอนโดลุมพินี (ซอยอ่อนนุช 55-1)",2,213,342,387,729
4003,"ประเวศ","เขตประเวศ",103201,"เต็นท์ในคอนโดลุมพินี (ซอยอ่อนนุช 55-1)",3,195,372,419,791
4004,"ประเวศ","เขตประเวศ",103201,"เต็นท์ในคอนโดลุมพินี (ซอยอ่อนนุช 55-1)",4,623,286,514,800
4005,"ประเวศ","เขตประเวศ",103201,"เต็นท์บริเวณลานกิจกรรมโรงเรียนสุเหร่าบึงหนองบอน(ซอยอ่อนนุช 70)",5,202,361,375,736
4006,"ประเวศ","เขตประเวศ",103201,"เต็นท์บริเวณลานกิจกรรมโรงเรียนสุเหร่าบึงหนองบอน(ซอยอ่อนนุช 70)",6,317,359,430,789
4007,"ประเวศ","เขตประเวศ",103201,"เต็นท์บริเวณลานกิจกรรมโรงเรียนสุเหร่าบึงหนองบอน(ซอยอ่อนนุช 70)",7,235,375,407,782
4008,"ประเวศ","เขตประเวศ",103201,"เต็นท์บริเวณลานกิจกรรมโรงเรียนสุเหร่าบึงหนองบอน(ซอยอ่อนนุช 70)",8,241,376,411,787
4009,"ประเวศ","เขตประเวศ",103201,"เต็นท์บริเวณลานกิจกรรมโรงเรียนสุเหร่าบึงหนองบอน(ซอยอ่อนนุช 70)",9,241,388,401,789
4010,"ประเวศ","เขตประเวศ",103201,"เต็นท์บริเวณลานกิจกรรมโรงเรียนสุเหร่าบึงหนองบอน(ซอยอ่่อนนุช70)",10,191,373,431,804
4011,"ประเวศ","เขตประเวศ",103201,"โรงอาหารโรงเรียนสุเหร่าบึงหนองบอน (ซอยอ่อนนุช 70)",11,200,315,341,656
4012,"ประเวศ","เขตประเวศ",103201,"โรงอาหารโรงเรียนสุเหร่าบึงหนองบอน (ซอยอ่อนนุช 70)",12,173,301,338,639
4013,"ประเวศ","เขตประเวศ",103201,"โรงอาหารโรงเรียนสุเหร่าบึงหนองบอน (ซอยอ่อนนุช 70)",13,193,310,367,677
4014,"ประเวศ","เขตประเวศ",103201,"โรงอาหารโรงเรียนสุเหร่าบึงหนองบอน (ซอยอ่อนนุช 70)",14,207,337,404,741
4015,"ประเวศ","เขตประเวศ",103201,"เต็นท์บริเวณลานกิจกรรมโรงเรียนมัธยมสุวิทย์เสรีอนุสรณ์(ซอยอ่อนนุช 70/1)",15,250,271,381,652
4016,"ประเวศ","เขตประเวศ",103201,"เต็นท์บริเวณลานกิจกรรมโรงเรียนมัธยมสุวิทย์เสรีอนุสรณ์(ซอยอ่อนนุช 70/1)",16,279,324,389,713
4017,"ประเวศ","เขตประเวศ",103201,"เต็นท์บริเวณลานกิจกรรมโรงเรียนมัธยมสุวิทย์เสรีอนุสรณ์(ซอยอ่อนนุช 70/1)",17,240,305,335,640
4018,"ประเวศ","เขตประเวศ",103201,"เต็นท์บริเวณลานกิจกรรมโรงเรียนมัธยมสุวิทย์เสรีอนุสรณ์(ซอยอ่อนนุช 70/1)",18,227,277,374,651
4019,"ประเวศ","เขตประเวศ",103201,"เต็นท์บริเวณลานกิจกรรมโรงเรียนมัธยมสุวิทย์เสรีอนุสรณ์(ซอยอ่อนนุช 70/1)",19,277,315,359,674
4020,"ประเวศ","เขตประเวศ",103201,"เต็นท์บริเวณลานกิจกรรมโรงเรียนมัธยมสุวิทย์เสรีอนุสรณ์(ซอยอ่อนนุช 70/1)",20,284,360,427,787
4021,"ประเวศ","เขตประเวศ",103201,"เต็นท์บริเวณลานกิจกรรมโรงเรียนสุเหร่าศาลาลอย(ซอยอ่อนนุช 70/1 แยก 2-5)",21,165,338,388,726
4022,"ประเวศ","เขตประเวศ",103201,"เต็นท์บริเวณลานกิจกรรมโรงเรียนงามมานะ (ถนนอ่อนนุช)",22,344,313,385,698
4023,"ประเวศ","เขตประเวศ",103201,"เต็นท์บริเวณลานกิจกรรมโรงเรียนงามมานะ (ถนนอ่อนนุช)",23,198,297,311,608
4024,"ประเวศ","เขตประเวศ",103201,"เต็นท์บริเวณลานกิจกรรมโรงเรียนงามมานะ (ถนนอ่อนนุช)",24,144,290,320,610
4025,"ประเวศ","เขตประเวศ",103201,"เต็นท์บริเวณลานกิจกรรมโรงเรียนงามมานะ (ถนนอ่อนนุช)",25,225,262,312,574
4026,"ประเวศ","เขตประเวศ",103201,"เต็นท์บริเวณลานกิจกรรมโรงเรียนสุเหร่าทางควาย(ซอยอ่อนนุช 59)",26,304,312,396,708
4027,"ประเวศ","เขตประเวศ",103201,"เต็นท์บริเวณลานกิจกรรมโรงเรียนสุเหร่าทางควาย(ซอยอ่อนนุช59)",27,255,327,384,711
4028,"ประเวศ","เขตประเวศ",103201,"เต็นท์บริเวณลานกิจกรรมโรงเรียนสุเหร่าทางควาย(ซอยอ่อนนุช59)",28,127,325,352,677
4029,"ประเวศ","เขตประเวศ",103201,"เต็นท์บริเวณลานกิจกรรมโรงเรียนสุเหร่าทางควาย(ซอยอ่อนนุช59)",29,146,321,367,688
4030,"ประเวศ","เขตประเวศ",103201,"เต็นท์บริเวณลานกิจกรรมโรงเรียนสุเหร่าทางควาย(ซอยอ่อนนุช59)",30,280,327,410,737
4031,"ประเวศ","เขตประเวศ",103201,"เต็นท์บริเวณลานกิจกรรมโรงเรียนสุเหร่าทางควาย(ซอยอ่อนนุช59)",31,191,355,377,732
4032,"ประเวศ","เขตประเวศ",103201,"ศาลารวมใจหมู่บ้านชมเดือน (ซอยอ่อนนุช 59/1)",32,231,284,352,636
4033,"ประเวศ","เขตประเวศ",103201,"โรงอาหารโรงเรียนวัดกระทุ่มเสือปลา (ซอยอ่อนนุช 67)",33,295,358,394,752
4034,"ประเวศ","เขตประเวศ",103201,"โรงอาหารโรงเรียนวัดกระทุ่มเสือปลา (ซอยอ่อนนุช 67)",34,173,361,391,752
4035,"ประเวศ","เขตประเวศ",103201,"โรงอาหารโรงเรียนวัดกระทุ่มเสือปลา (ซอยอ่อนนุช 67)",35,214,410,369,779
4036,"ประเวศ","เขตประเวศ",103201,"โรงอาหารโรงเรียนวัดกระทุ่มเสือปลา (ซอยอ่อนนุช 67)",36,273,369,381,750
4037,"ประเวศ","เขตประเวศ",103201,"เต็นท์บริเวณลานกิจกรรมโรงเรียนวัดกระทุ่มเสือปลา(ซอยอ่อนนุช 67)",37,201,362,401,763
4038,"ประเวศ","เขตประเวศ",103201,"เต็นท์บริเวณลานกิจกรรมโรงเรียนวัดกระทุ่มเสือปลา(ซอยอ่อนนุช 67)",38,363,346,413,759
4039,"ประเวศ","เขตประเวศ",103201,"เต็นท์บริเวณลานกิจกรรมโรงเรียนวัดกระทุ่มเสือปลา(ซอยอ่อนนุช 67)",39,231,369,416,785
4040,"ประเวศ","เขตประเวศ",103201,"เต็นท์บริเวณลานกิจกรรมโรงเรียนวัดกระทุ่มเสือปลา(ซอยอ่อนนุช 67)",40,303,359,411,770
4041,"ประเวศ","เขตประเวศ",103201,"เต็นท์บริเวณลานกิจกรรมโรงเรียนวัดกระทุ่มเสือปลา(ซอยอ่อนนุช 67)",41,383,318,425,743
4042,"ประเวศ","เขตประเวศ",103201,"เต็นท์บริเวณลานกิจกรรมโรงเรียนวัดกระทุ่มเสือปลา(ซอยอ่อนนุช 67)",42,364,328,421,749
4043,"ประเวศ","เขตประเวศ",103201,"เต็นท์บริเวณลานกิจกรรมโรงเรียนวัดกระทุ่มเสือปลา(ซอยอ่อนนุช 67)",43,267,331,375,706
4044,"ประเวศ","เขตประเวศ",103201,"ใต้อาคารสงเคราะห์อ่อนนุช 86",44,124,301,263,564
4045,"ประเวศ","เขตประเวศ",103201,"ใต้อาคารสงเคราะห์อ่อนนุช 86",45,209,282,277,559
4046,"ประเวศ","เขตประเวศ",103201,"ใต้อาคารสงเคราะห์อ่อนนุช 86",46,179,305,326,631
4047,"ประเวศ","เขตประเวศ",103201,"เต็นท์บริเวณซอยอ่อนนุช 88 แยก 14",47,125,233,245,478
4048,"ประเวศ","เขตประเวศ",103201,"เต็นท์บริเวณซอยอ่อนนุช 88 แยก 14",48,138,254,297,551
4049,"ประเวศ","เขตประเวศ",103201,"เต็นท์ในหมู่บ้านพฤกษาทาวน์เน็กซ์(ซ.เฉลิมพระเกียรติ ร.๙ ซ.87)",49,391,357,439,796
4050,"ประเวศ","เขตประเวศ",103201,"เต็นท์ในหมู่บ้านพฤกษาทาวน์เน็กซ์(ซ.เฉลิมพระเกียรติ ร.๙ ซ.87)",50,412,353,438,791
4051,"ประเวศ","เขตประเวศ",103201,"เต็นท์ในหมู่บ้านพฤกษาทาวน์เน็กซ์(ซ.เฉลิมพระเกียรติ ร.๙ ซ.87)",51,395,351,431,782
4052,"ประเวศ","เขตประเวศ",103201,"เต็นท์บริเวณสวนสุขภาพเขตประเวศ",52,335,366,438,804
4053,"ประเวศ","เขตประเวศ",103201,"เต็นท์บริเวณสวนสุขภาพเขตประเวศ",53,495,316,461,777
4054,"ประเวศ","เขตประเวศ",103201,"เต็นท์บริเวณสวนสุขภาพเขตประเวศ",54,185,396,398,794
4055,"ประเวศ","เขตประเวศ",103201,"เต็นท์บริเวณสวนสุขภาพเขตประเวศ",55,226,371,398,769
4056,"ประเวศ","เขตประเวศ",103201,"เต็นท์บริเวณสวนสุขภาพเขตประเวศ",56,343,374,405,779
4057,"ประเวศ","เขตประเวศ",103201,"เต็นท์บริเวณสวนสุขภาพเขตประเวศ",57,326,350,455,805
4058,"ประเวศ","เขตประเวศ",103201,"เต็นท์บริเวณสวนสุขภาพเขตประเวศ",58,405,362,455,817
4059,"ประเวศ","เขตประเวศ",103201,"เต็นท์บริเวณสวนสุขภาพเขตประเวศ",59,387,378,421,799
4060,"ประเวศ","เขตประเวศ",103201,"เต็นท์บริเวณสโมสรชวนชื่น (ซอยพัฒนาการ 57)",60,195,250,305,555
4061,"ประเวศ","เขตประเวศ",103201,"เต็นท์บริเวณสโมสรชวนชื่น (ซอยพัฒนาการ 57)",61,210,237,299,536
4062,"ประเวศ","เขตประเวศ",103201,"เต็นท์บริเวณสโมสรหมู่บ้านเมืองทอง 2/2 (ซอยพัฒนาการ 61)",62,188,225,316,541
4063,"ประเวศ","เขตประเวศ",103201,"เต็นท์บริเวณสโมสรหมู่บ้านเมืองทอง 2/2 (ซอยพัฒนาการ 61)",63,220,276,381,657
4064,"ประเวศ","เขตประเวศ",103201,"เต็นท์บริเวณสโมสรหมู่บ้านเมืองทอง 2/2 (ซอยพัฒนาการ 61)",64,244,285,393,678
4065,"ประเวศ","เขตประเวศ",103201,"เต็นท์ข้างที่ทำการนิติบุคคลหมู่่บ้านผาสุก (ซอยพัฒนาการ 65)",65,232,319,391,710
4066,"ประเวศ","เขตประเวศ",103201,"เต็นท์ข้างที่ทำการนิติบุคคลหมู่บ้านผาสุก (ซอยพัฒนาการ 65)",66,216,283,361,644
4067,"ประเวศ","เขตประเวศ",103201,"เต็นท์ข้างที่ทำการนิติบุคคลหมู่บ้านผาสุก (ซอยพัฒนาการ 65)",67,277,296,367,663
4068,"ประเวศ","เขตประเวศ",103201,"เต็นท์ข้างที่ทำการนิติบุคคลหมู่บ้านผาสุก (ซอยพัฒนาการ 65)",68,314,350,427,777
4069,"ประเวศ","เขตประเวศ",103201,"เต็นท์ข้างที่ทำการนิติบุคคลหมู่บ้านผาสุก (ซอยพัฒนาการ 65)",69,267,330,430,760
4070,"ประเวศ","เขตประเวศ",103201,"เต็นท์ข้างที่ทำการนิติบุคคลหมู่บ้านผาสุก (ซอยพัฒนาการ 65)",70,397,308,442,750
4071,"ประเวศ","เขตประเวศ",103201,"เต็นท์บริเวณศาลารวมใจหมู่บ้านเมืองทอง 2/1 (ซอยพัฒนาการ 74)",71,257,303,386,689
4072,"ประเวศ","เขตประเวศ",103201,"เต็นท์บริเวณศาลารวมใจหมู่บ้านเมืองทอง 2/1 (ซอยพัฒนาการ 74 )",72,213,255,363,618
4073,"ประเวศ","เขตประเวศ",103201,"เต็นท์บริเวณศาลารวมใจหมู่บ้านเมืองทอง 2/1 (ซอยพัฒนาการ 74 )",73,210,260,313,573
4074,"ประเวศ","เขตประเวศ",103201,"เต็นท์บริเวณศาลารวมใจหมู่บ้านเมืองทอง 2/1 (ซอยพัฒนาการ 74 )",74,220,296,387,683
4075,"ประเวศ","เขตประเวศ",103201,"อาคารจอดรถโรงเรียนสุเหร่าบ้านม้า (ถนนมอเตอร์เวย์)",75,453,345,445,790
4076,"ประเวศ","เขตประเวศ",103201,"อาคารจอดรถโรงเรียนสุเหร่าบ้านม้า (ถนนมอเตอร์เวย์)",76,291,378,432,810
4077,"ประเวศ","เขตประเวศ",103201,"ห้องประชุมโรงเรียนสุเหร่าทับช้าง (ถนนมอเตอร์เวย์)",77,185,402,388,790
4078,"ประเวศ","เขตประเวศ",103201,"เต็นท์บริเวณซอยสุขาภิบาล 2 ซอย 13",78,319,277,385,662
4079,"ประเวศ","เขตประเวศ",103201,"เต็นท์บริเวณซอยสุขาภิบาล 2 ซอย 13",79,266,310,328,638
4080,"ประเวศ","เขตประเวศ",103201,"เต็นท์บริเวณซอยสุขาภิบาล 2 ซอย 13",80,228,313,371,684
4081,"ประเวศ","เขตประเวศ",103201,"ศาลากาญจนาภิเษก ชุมชนอ่อนนุช 40 ไร่",81,250,298,361,659
4082,"ประเวศ","เขตประเวศ",103201,"ศาลากาญจนาภิเษก ชุมชนอ่อนนุช 40 ไร่",82,149,228,255,483
4083,"ประเวศ","เขตประเวศ",103201,"เต็นท์บริเวณลานกิจกรรมโรงเรียนสุเหร่าจรเข้ขบ(ซอยเฉลิมพระเกียรติ ร.๙ ซอย 68)",83,277,295,390,685
4084,"ประเวศ","เขตประเวศ",103201,"เต็นท์บริเวณลานกิจกรรมโรงเรียนสุเหร่าจรเข้ขบ(ซอยเฉลิมพระเกียรติ ร.๙ ซอย 68)",84,241,264,342,606
4085,"ประเวศ","เขตประเวศ",103201,"เต็นท์บริเวณลานกิจกรรมโรงเรียนสุเหร่าจรเข้ขบ(ซอยเฉลิมพระเกียรติ ร.๙ซอย 68)",85,286,251,364,615
4086,"ประเวศ","เขตประเวศ",103201,"เต็นท์บริเวณลานกิจกรรมโรงเรียนสุเหร่าจรเข้ขบ(ซอยเฉลิมพระเกียรติ ร.๙ ซอย 68)",86,124,300,307,607
4087,"ประเวศ","เขตประเวศ",103201,"เต็นท์บริเวณลานกิจกรรม รร.สุเหร่าจรเข้ขบ  (ซ.เฉลิมพระเกียรติ ร.๙ ซ.68)",87,142,292,304,596
4088,"ประเวศ","เขตประเวศ",103201,"ใต้อาคารสงเคราะห์ประเวศ (ถนนกาญจนาภิเษก)",88,305,353,358,711
4089,"ประเวศ","เขตประเวศ",103201,"ใต้อาคารสงเคราะห์ประเวศ (ถนนกาญจนาภิเษก)",89,314,295,390,685
4090,"ประเวศ","เขตประเวศ",103201,"ใต้อาคารสงเคราะห์ประเวศ (ถนนกาญจนาภิเษก)",90,163,362,379,741
4091,"ประเวศ","เขตประเวศ",103201,"ใต้อาคารสงเคราะห์ประเวศ (ถนนกาญจนาภิเษก)",91,333,312,398,710
4092,"ประเวศ","เขตประเวศ",103201,"ใต้อาคารสงเคราะห์ประเวศ (ถนนกาญจนาภิเษก)",92,376,319,403,722
4093,"ประเวศ","เขตประเวศ",103201,"เต็นท์บริเวณวัดแก้วพิทักษ์เจริญธรรม(ถนนเฉลิมพระเกียรติ ร.๙)",93,302,294,388,682
4094,"ประเวศ","เขตประเวศ",103201,"เต็นท์บริเวณวัดแก้วพิทักษ์เจริญธรรม(ถนนเฉลิมพระเกียรติ ร.๙)",94,278,300,398,698
4095,"ประเวศ","เขตประเวศ",103201,"เต็นท์บริเวณวัดแก้วพิทักษ์เจริญธรรม(ถนนเฉลิมพระเกียรติ ร.๙)",95,230,321,415,736
4096,"หนองบอน","เขตประเวศ",103202,"เต็นท์บริเวณลานกิจกรรมโรงเรียนอยู่เป็นสุขอนุสรณ์(ซอยสุภาพงษ์ 1 แยก 7)",1,262,275,317,592
4097,"หนองบอน","เขตประเวศ",103202,"เต็นท์บริเวณลานกิจกรรมโรงเรียนอยู่เป็นสุขอนุสรณ์(ซอยสุภาพงษ์ 1 แยก 7)",2,502,308,468,776
4098,"หนองบอน","เขตประเวศ",103202,"เต็นท์บริเวณลานกิจกรรมโรงเรียนอยู่เป็นสุขอนุสรณ์ (ซอยสุภาพงษ์ 1 แยก 7)",3,302,263,328,591
4099,"หนองบอน","เขตประเวศ",103202,"เต็นท์บริเวณลานกิจกรรมโรงเรียนอยู่เป็นสุขอนุสรณ์ (ซอยสุภาพงษ์ 1 แยก 7)",4,327,299,359,658
4100,"หนองบอน","เขตประเวศ",103202,"เต็นท์บริเวณลานกิจกรรมโรงเรียนอยู่เป็นสุขอนุสรณ์ (ซอยสุภาพงษ์ 1 แยก 7)",5,364,292,367,659
4101,"หนองบอน","เขตประเวศ",103202,"เต็นท์บริเวณลานกิจกรรมโรงเรียนอยู่เป็นสุขอนุสรณ์ (ซอยสุภาพงษ์ 1 แยก 7)",6,391,260,391,651
4102,"หนองบอน","เขตประเวศ",103202,"ห้องประชุมโรงเรียนอยู่เป็นสุขอนุสรณ์ (ซอยสุภาพงษ์ 1 แยก 7)",7,162,305,358,663
4103,"หนองบอน","เขตประเวศ",103202,"ห้องประชุมโรงเรียนอยู่เป็นสุขอนุสรณ์ (ซอยสุภาพงษ์ 1 แยก 7)",8,408,345,453,798
4104,"หนองบอน","เขตประเวศ",103202,"ห้องประชุมโรงเรียนอยู่เป็นสุขอนุสรณ์ (ซอยสุภาพงษ์ 1 แยก 7)",9,370,357,440,797
4105,"หนองบอน","เขตประเวศ",103202,"โรงอาหารโรงเรียนอยู่เป็นสุขอนุสรณ์ (ซอยสุภาพงษ์ 1 แยก 7)",10,294,302,342,644
4106,"หนองบอน","เขตประเวศ",103202,"โรงอาหารโรงเรียนอยู่เป็นสุขอนุสรณ์ (ซอยสุภาพงษ์ 1 แยก 7)",11,220,308,305,613
4107,"หนองบอน","เขตประเวศ",103202,"เต็นท์บริเวณหน้าตลาดยอดมิตรภาพ (ซอยอ่อนนุช 46)",12,212,263,338,601
4108,"หนองบอน","เขตประเวศ",103202,"เต็นท์บริเวณหน้าตลาดยอดมิตรภาพ (ซอยอ่อนนุช 46)",13,151,292,312,604
4109,"หนองบอน","เขตประเวศ",103202,"เต็นท์บริเวณหน้าตลาดยอดมิตรภาพ (ซอยอ่อนนุช 46)",14,140,250,317,567
4110,"หนองบอน","เขตประเวศ",103202,"เต็นท์บริเวณหน้าตลาดยอดมิตรภาพ (ซอยอ่อนนุช 46)",15,300,307,361,668
4111,"หนองบอน","เขตประเวศ",103202,"เต็นท์บริเวณชุมชนเปรมฤทัย 20 (ซอยศรีนครินทร์ 48)",16,127,199,256,455
4112,"หนองบอน","เขตประเวศ",103202,"เต็นท์บริเวณชุมชนเปรมฤทัย 20 (ซอยศรีนครินทร์ 48)",17,120,185,219,404
4113,"หนองบอน","เขตประเวศ",103202,"เต็นท์บริเวณชุมชนเปรมฤทัย 20 (ซอยศรีนครินทร์ 48)",18,144,210,266,476
4114,"หนองบอน","เขตประเวศ",103202,"เต็นท์บริเวณมัสยิดเราะห์ม่าตุ้ลอิสลาม (ซอยหมู่บ้านเสรีวิลล่า)",19,272,410,398,808
4115,"หนองบอน","เขตประเวศ",103202,"เต็นท์บริเวณมัสยิดเราะห์ม่าตุ้ลอิสลาม (ซอยหมู่บ้านเสรีวิลล่า)",20,338,353,447,800
4116,"หนองบอน","เขตประเวศ",103202,"เต็นท์บริเวณมัสยิดเราะห์ม่าตุ้ลอิสลาม (ซอยหมู่บ้านเสรีวิลล่า)",21,289,376,424,800
4117,"หนองบอน","เขตประเวศ",103202,"เต็นท์บริเวณมัสยิดเราะห์ม่าตุ้ลอิสลาม (ซอยหมู่บ้านเสรีวิลล่า)",22,345,351,449,800
4118,"หนองบอน","เขตประเวศ",103202,"เต็นท์บริเวณลานจอดรถวัดตะกล่ำ(ซอยเฉลิมพระเกียรติ ร.๙ ซอย 22)",23,192,286,345,631
4119,"หนองบอน","เขตประเวศ",103202,"เต็นท์บริเวณลานจอดรถวัดตะกล่ำ(ซอยเฉลิมพระเกียรติ ร.๙ ซอย 22)",24,151,285,305,590
4120,"หนองบอน","เขตประเวศ",103202,"เต็นท์บริเวณลานจอดรถวัดตะกล่ำ(ซอยเฉลิมพระเกียรติ ร.๙ ซอย 22)",25,143,229,304,533
4121,"หนองบอน","เขตประเวศ",103202,"เต็นท์บริเวณลานจอดรถวัดตะกล่ำ (ซอยเฉลิมพระเกียรติ ร.๙ ซอย 22)",26,192,286,365,651
4122,"หนองบอน","เขตประเวศ",103202,"เต็นท์บริเวณลานจอดรถวัดตะกล่ำ(ซอยเฉลิมพระเกียรติ ร.๙ ซอย 22)",27,213,324,329,653
4123,"หนองบอน","เขตประเวศ",103202,"เต็นท์บริเวณลานจอดรถวัดตะกล่ำ(ซอยเฉลิมพระเกียรติ ร.๙ ซอย 22)",28,184,304,366,670
4124,"หนองบอน","เขตประเวศ",103202,"เต็นท์บริเวณลานจอดรถวัดตะกล่ำ(ซอยเฉลิมพระเกียรติ ร.๙ ซอย 22)",29,162,290,314,604
4125,"หนองบอน","เขตประเวศ",103202,"เต็นท์บริเวณลานจอดรถวัดตะกล่ำ(ซอยเฉลิมพระเกียรติ ร.๙ ซอย 22)",30,130,260,254,514
4126,"หนองบอน","เขตประเวศ",103202,"เต็นท์บริเวณลานจอดรถวัดตะกล่ำ(ซอยเฉลิมพระเกียรติ ร.๙ ซอย 22)",31,206,278,300,578
4127,"หนองบอน","เขตประเวศ",103202,"เต็นท์บริเวณลานกิจกรรมโรงเรียนวัดตะกล่ำ(ซอยเฉลิมพระเกียรติ ร.๙ ซอย 22)",32,226,296,360,656
4128,"หนองบอน","เขตประเวศ",103202,"เต็นท์บริเวณลานกิจกรรมโรงเรียนวัดตะกล่ำ(ซอยเฉลิมพระเกียรติ ร.๙ ซอย 22)",33,233,298,368,666
4129,"หนองบอน","เขตประเวศ",103202,"เต็นท์บริเวณลานกิจกรรมโรงเรียนวัดตะกล่ำ(ซอยเฉลิมพระเกียรติ ร.๙ ซอย 22)",34,261,307,385,692
4130,"หนองบอน","เขตประเวศ",103202,"เต็นท์บริเวณลานกิจกรรมโรงเรียนวัดตะกล่ำ(ซอยเฉลิมพระเกียรติ ร.๙ ซอย 22)",35,262,343,410,753
4131,"หนองบอน","เขตประเวศ",103202,"เต็นท์บริเวณลานกิจกรรมโรงเรียนวัดตะกล่ำ(ซอยเฉลิมพระเกียรติ ร.๙ ซอย 22)",36,231,321,410,731
4132,"หนองบอน","เขตประเวศ",103202,"เต็นท์บริเวณลานกิจกรรมโรงเรียนวัดตะกล่ำ(ซอยเฉลิมพระเกียรติ ร.๙ ซอย 22)",37,238,332,394,726
4133,"หนองบอน","เขตประเวศ",103202,"เต็นท์บริเวณลานกิจกรรมโรงเรียนวัดตะกล่ำ(ซอยเฉลิมพระเกียรติ ร.๙ ซอย 22)",38,288,339,419,758
4134,"หนองบอน","เขตประเวศ",103202,"เต็นท์บริเวณลานกิจกรรมโรงเรียนวัดตะกล่ำ(ซอยเฉลิมพระเกียรติ ร.๙ ซอย 22)",39,233,344,408,752
4135,"หนองบอน","เขตประเวศ",103202,"เต็นท์บริเวณลานกิจกรรมโรงเรียนวัดตะกล่ำ(ซอยเฉลิมพระเกียรติ ร.๙ ซอย 22)",40,290,348,448,796
4136,"หนองบอน","เขตประเวศ",103202,"เต็นท์บริเวณลานกิจกรรมโรงเรียนวัดตะกล่ำ(ซอยเฉลิมพระเกียรติ ร.๙ ซอย 22)",41,259,269,367,636
4137,"หนองบอน","เขตประเวศ",103202,"ศาลากิจกรรมโรงเรียนวัดตะกล่ำ (ซอยเฉลิมพระเกียรติ ร.๙ ซอย 22)",42,262,299,359,658
4138,"หนองบอน","เขตประเวศ",103202,"เต็นท์บริเวณลานกิจกรรมโรงเรียนบ้านหนองบอน(ถนนเฉลิมพระเกียรติ ร.๙)",43,311,293,394,687
4139,"หนองบอน","เขตประเวศ",103202,"เต็นท์บริเวณลานกิจกรรมโรงเรียนบ้านหนองบอน (ถนนเฉลิมพระเกียรติ ร.๙)",44,320,280,389,669
4140,"หนองบอน","เขตประเวศ",103202,"เต็นท์บริเวณลานกิจกรรมโรงเรียนบ้านหนองบอน (ถนนเฉลิมพระเกียรติ ร.๙)",45,244,301,364,665
4141,"หนองบอน","เขตประเวศ",103202,"เต็นท์บริเวณลานกิจกรรมโรงเรียนบ้านหนองบอน (ถนนเฉลิมพระเกียรติ ร.๙)",46,262,270,322,592
4142,"หนองบอน","เขตประเวศ",103202,"เต็นท์บริเวณลานกิจกรรมโรงเรียนบ้านหนองบอน (ถนนเฉลิมพระเกียรติ ร.๙)",47,187,254,347,601
4143,"หนองบอน","เขตประเวศ",103202,"เต็นท์บริเวณลานกิจกรรมโรงเรียนบ้านหนองบอน (ถนนเฉลิมพระเกียรติ ร.๙)",48,226,306,319,625
4144,"หนองบอน","เขตประเวศ",103202,"เต็นท์บริเวณลานกิจกรรมโรงเรียนบ้านหนองบอน(ถนนเฉลิมพระเกียรติ ร.๙)",49,256,301,356,657
4145,"หนองบอน","เขตประเวศ",103202,"เต็นท์บริเวณลานกิจกรรมโรงเรียนบ้านหนองบอน (ถนนเฉลิมพระเกียรติ ร.๙)",50,235,310,391,701
4146,"ดอกไม้","เขตประเวศ",103203,"เต็นท์บริเวณแฟลตข้าราชการตำรวจส่วนกลาง",1,262,275,264,539
4147,"ดอกไม้","เขตประเวศ",103203,"เต็นท์บริเวณแฟลตข้าราชการตำรวจส่วนกลาง",2,286,305,243,548
4148,"ดอกไม้","เขตประเวศ",103203,"เต็นท์บริเวณแฟลตข้าราชการตำรวจส่วนกลาง",3,202,230,305,535
4149,"ดอกไม้","เขตประเวศ",103203,"เต็นท์บริเวณแฟลตข้าราชการตำรวจส่วนกลาง",4,205,304,254,558
4150,"ดอกไม้","เขตประเวศ",103203,"เต็นท์บริเวณแฟลตข้าราชการตำรวจส่วนกลาง",5,238,234,308,542
4151,"ดอกไม้","เขตประเวศ",103203,"โรงเรียนคลองมะขามเทศ (ซอยเฉลิมพระเกียรติ ร.๙ ซอย 44)",6,157,197,244,441
4152,"ดอกไม้","เขตประเวศ",103203,"โรงเรียนคชเผือกอนุสรณ์(ซอยเฉลิมพระเกียรติ ร.๙ ซอย 48 แยก 10-4)",7,260,320,364,684
4153,"ดอกไม้","เขตประเวศ",103203,"โรงเรียนคชเผือกอนุสรณ์(ซอยเฉลิมพระเกียรติ ร.๙ ซอย 48 แยก 10-4)",8,176,311,326,637
4154,"ดอกไม้","เขตประเวศ",103203,"โรงเรียนคชเผือกอนุสรณ์(ซอยเฉลิมพระเกียรติ ร.๙ ซอย 48 แยก 10-4)",9,290,362,409,771
4155,"ดอกไม้","เขตประเวศ",103203,"เต็นท์บริเวณมัสยิดซะห์ร่อตุ้ลอิสลาม (สุเหร่าดอกไม้)(ถนนเฉลิมพระเกียรติ ร.๙)",10,234,379,393,772
4156,"ดอกไม้","เขตประเวศ",103203,"เต็นท์บริเวณมัสยิดซะห์ร่อตุ้ลอิสลาม (สุเหร่าดอกไม้)(ถนนเฉลิมพระเกียรติ ร.๙)",11,317,358,457,815
4157,"ดอกไม้","เขตประเวศ",103203,"เต็นท์บริเวณมัสยิดซะห์ร่อตุ้ลอิสลาม (สุเหร่าดอกไม้)(ถนนเฉลิมพระเกียรติ ร.๙)",12,342,353,461,814
4158,"ดอกไม้","เขตประเวศ",103203,"เต็นท์บริเวณลานกิจกรรมโรงเรียนคลองปักหลัก(ซอยเฉลิมพระเกียรติ ร.๙ ซอย 30)",13,408,348,390,738
4159,"ดอกไม้","เขตประเวศ",103203,"เต็นท์บริเวณลานกิจกรรมโรงเรียนคลองปักหลัก(ซอยเฉลิมพระเกียรติ ร.๙ ซอย 30)",14,368,339,387,726
4160,"ดอกไม้","เขตประเวศ",103203,"เต็นท์บริเวณลานกิจกรรมโรงเรียนคลองปักหลัก(ซอยเฉลิมพระเกียรติ ร.๙ ซอย 30)",15,463,325,420,745
4161,"ดอกไม้","เขตประเวศ",103203,"เต็นท์บริเวณลานกิจกรรมโรงเรียนคลองปักหลัก(ซอยเฉลิมพระเกียรติ ร.๙ ซอย 30)",16,427,333,448,781
4162,"ดอกไม้","เขตประเวศ",103203,"เต็นท์บริเวณลานกิจกรรมโรงเรียนคลองปักหลัก (ซอยเฉลิมพระเกียรติ ร.๙ ซอย 30)",17,482,323,495,818
4163,"ดอกไม้","เขตประเวศ",103203,"เต็นท์บริเวณลานกิจกรรมโรงเรียนคลองปักหลัก (ซอยเฉลิมพระเกียรติ ร.๙ ซอย 30)",18,405,275,400,675
4164,"ดอกไม้","เขตประเวศ",103203,"เต็นท์บริเวณลานกิจกรรมโรงเรียนคลองปักหลัก(ซอยเฉลิมพระเกียรติ ร.๙ ซอย 30)",19,341,281,395,676
4165,"ดอกไม้","เขตประเวศ",103203,"เต็นท์บริเวณลานกิจกรรมโรงเรียนคลองปักหลัก(ซอยเฉลิมพระเกียรติ ร.๙ ซอย 30)",20,393,338,417,755
4166,"ดอกไม้","เขตประเวศ",103203,"เต็นท์บริเวณลานกิจกรรมโรงเรียนคลองปักหลัก(ซอยเฉลิมพระเกียรติ ร.๙ ซอย 30)",21,388,375,442,817
4167,"ดอกไม้","เขตประเวศ",103203,"เต็นท์บริเวณตลาดวีด้า เจมโมโปลิส (ถนนกาญจนาภิเษก)",22,373,341,430,771
4168,"ดอกไม้","เขตประเวศ",103203,"เต็นท์บริเวณตลาดวีด้า เจมโมโปลิส (ถนนกาญจนาภิเษก)",23,437,354,445,799
4169,"ดอกไม้","เขตประเวศ",103203,"เต็นท์บริเวณตลาดวีด้า เจมโมโปลิส (ถนนกาญจนาภิเษก)",24,502,358,442,800
4170,"ดอกไม้","เขตประเวศ",103203,"เต็นท์บริเวณตลาดวีด้า เจมโมโปลิส (ถนนกาญจนาภิเษก)",25,350,369,393,762
4171,"ดอกไม้","เขตประเวศ",103203,"เต็นท์บริเวณตลาดวีด้า เจมโมโปลิส (ถนนกาญจนาภิเษก)",26,397,329,428,757
4172,"ดอกไม้","เขตประเวศ",103203,"เต็นท์บริเวณตลาดวีด้า เจมโมโปลิส (ถนนกาญจนาภิเษก)",27,388,355,421,776
4173,"ดอกไม้","เขตประเวศ",103203,"ที่ทำการชุมชนอ่อนนุช 19 ไร่",28,166,279,290,569
4174,"ดอกไม้","เขตประเวศ",103203,"เต็นท์บริเวณที่ทำการชุมชนอ่อนนุช 19 ไร่",29,148,247,280,527
4175,"ดอกไม้","เขตประเวศ",103203,"เต็นท์บริเวณมหาวิทยาลัยรามคำแหง 2 (ถนนรามคำแหง 2)",30,239,291,363,654
4176,"ดอกไม้","เขตประเวศ",103203,"เต็นท์บริเวณมหาวิทยาลัยรามคำแหง 2 (ถนนรามคำแหง 2)",31,239,310,384,694
4177,"ดอกไม้","เขตประเวศ",103203,"เต็นท์บริเวณมหาวิทยาลัยรามคำแหง 2 (ถนนรามคำแหง 2)",32,202,345,383,728
4178,"ดอกไม้","เขตประเวศ",103203,"เต็นท์บริเวณมหาวิทยาลัยรามคำแหง 2 (ถนนรามคำแหง 2)",33,207,291,385,676
4179,"ดอกไม้","เขตประเวศ",103203,"เต็นท์บริเวณมหาวิทยาลัยรามคำแหง 2 (ถนนรามคำแหง 2)",34,440,357,473,830
4180,"ดอกไม้","เขตประเวศ",103203,"เต็นท์บริเวณมหาวิทยาลัยรามคำแหง 2 (ถนนรามคำแหง 2)",35,246,298,359,657
4181,"ดอกไม้","เขตประเวศ",103203,"เต็นท์บริเวณมหาวิทยาลัยรามคำแหง 2 (ถนนรามคำแหง 2)",36,309,265,334,599
4182,"ดอกไม้","เขตประเวศ",103203,"เต็นท์บริเวณมหาวิทยาลัยรามคำแหง 2 (ถนนรามคำแหง 2)",37,275,263,370,633
4183,"ดอกไม้","เขตประเวศ",103203,"เต็นท์บริเวณมหาวิทยาลัยรามคำแหง 2 (ถนนรามคำแหง 2)",38,377,279,381,660
4184,"ดอกไม้","เขตประเวศ",103203,"เต็นท์บริเวณมหาวิทยาลัยรามคำแหง 2 (ถนนรามคำแหง 2)",39,323,292,338,630
4185,"ดอกไม้","เขตประเวศ",103203,"เต็นท์บริเวณมหาวิทยาลัยรามคำแหง 2 (ถนนรามคำแหง 2)",40,383,327,413,740
4186,"ดอกไม้","เขตประเวศ",103203,"เต็นท์บริเวณมหาวิทยาลัยรามคำแหง 2 (ถนนรามคำแหง 2)",41,399,347,379,726
4187,"ดอกไม้","เขตประเวศ",103203,"เต็นท์บริเวณมหาวิทยาลัยรามคำแหง 2 (ถนนรามคำแหง 2)",42,388,329,397,726
4188,"ดอกไม้","เขตประเวศ",103203,"เต็นท์บริเวณมหาวิทยาลัยรามคำแหง 2 (ถนนรามคำแหง 2)",43,322,273,346,619
4189,"ดอกไม้","เขตประเวศ",103203,"เต็นท์บริเวณลานกิจกรรมโรงเรียนราชดำริ(ซอยเฉลิมพระเกียรติ ร.๙ ซอย 28)",44,201,303,405,708
4190,"ดอกไม้","เขตประเวศ",103203,"เต็นท์บริเวณลานกิจกรรมโรงเรียนราชดำริ (ซอยเฉลิมพระเกียรติ ร.๙ ซอย 28)",45,259,309,409,718
4191,"ดอกไม้","เขตประเวศ",103203,"เต็นท์บริเวณลานกิจกรรมโรงเรียนราชดำริ (ซอยเฉลิมพระเกียรติ ร.๙ ซอย 28)",46,282,310,419,729
4192,"ดอกไม้","เขตประเวศ",103203,"เต็นท์บริเวณลานกิจกรรมโรงเรียนราชดำริ (ซอยเฉลิมพระเกียรติ ร.๙ ซอย 28)",47,351,349,415,764
4193,"ดอกไม้","เขตประเวศ",103203,"เต็นท์บริเวณลานกิจกรรมโรงเรียนราชดำริ(ซอยเฉลิมพระเกียรติ ร.๙ ซอย 28)",48,284,302,365,667
4194,"ดอกไม้","เขตประเวศ",103203,"เต็นท์บริเวณลานกิจกรรมโรงเรียนราชดำริ (ซอยเฉลิมพระเกียรติ ร.๙ ซอย 28)",49,284,329,400,729
4195,"ดอกไม้","เขตประเวศ",103203,"เต็นท์บริเวณลานกิจกรรมโรงเรียนราชดำริ (ซอยเฉลิมพระเกียรติ ร.๙ ซอย 28)",50,248,355,372,727
4196,"ดอกไม้","เขตประเวศ",103203,"เต็นท์บริเวณลานกิจกรรมโรงเรียนราชดำริ (ซอยเฉลิมพระเกียรติ ร.๙ ซอย 28)",51,255,340,385,725
4197,"ดอกไม้","เขตประเวศ",103203,"เต็นท์บริเวณลานกิจกรรมโรงเรียนราชดำริ (ซอยเฉลิมพระเกียรติ ร.๙ ซอย 28)",52,311,361,378,739
4198,"ดอกไม้","เขตประเวศ",103203,"เต็นท์บริเวณลานกิจกรรมโรงเรียนราชดำริ (ซอยเฉลิมพระเกียรติ ร.๙ ซอย 28)",53,408,330,439,769
4199,"ดอกไม้","เขตประเวศ",103203,"เต็นท์บริเวณลานกิจกรรมโรงเรียนราชดำริ (ซอยเฉลิมพระเกียรติ ร.๙ ซอย 28)",54,349,353,388,741
4200,"ดอกไม้","เขตประเวศ",103203,"เต็นท์บริเวณลานกิจกรรมโรงเรียนราชดำริ (ซอยเฉลิมพระเกียรติ ร.๙ ซอย 28)",55,306,352,425,777
4201,"ดอกไม้","เขตประเวศ",103203,"เต็นท์บริเวณลานกิจกรรมโรงเรียนราชดำริ (ซอยเฉลิมพระเกียรติ ร.๙ ซอย 28)",56,289,393,424,817
4202,"ดอกไม้","เขตประเวศ",103203,"เต็นท์บริเวณลานกิจกรรมโรงเรียนราชดำริ (ซอยเฉลิมพระเกียรติ ร.๙ ซอย 28)",57,276,374,439,813
4203,"ดอกไม้","เขตประเวศ",103203,"เต็นท์บริเวณลานกิจกรรมโรงเรียนราชดำริ (ซอยเฉลิมพระเกียรติ ร.๙ ซอย 28)",58,288,374,407,781
4204,"คลองเตย","เขตคลองเตย",103301,"บริเวณตลาดยาสูบ ด้านถนนพระราม 4",1,204,251,306,557
4205,"คลองเตย","เขตคลองเตย",103301,"บริเวณตลาดยาสูบ ด้านถนนพระราม 4",2,193,244,303,547
4206,"คลองเตย","เขตคลองเตย",103301,"บริเวณตลาดยาสูบ ด้านถนนพระราม 4",3,163,244,317,561
4207,"คลองเตย","เขตคลองเตย",103301,"บริเวณตลาดยาสูบ ด้านถนนพระราม 4",4,178,256,303,559
4208,"คลองเตย","เขตคลองเตย",103301,"บริเวณตลาดยาสูบ ด้านถนนพระราม 4",5,211,258,298,556
4209,"คลองเตย","เขตคลองเตย",103301,"บริเวณตลาดยาสูบ ด้านถนนพระราม 4",6,194,259,298,557
4210,"คลองเตย","เขตคลองเตย",103301,"บริเวณตลาดยาสูบ ด้านถนนพระราม 4",7,275,285,272,557
4211,"คลองเตย","เขตคลองเตย",103301,"บริเวณตลาดยาสูบ ด้านถนนพระราม 4",8,219,243,311,554
4212,"คลองเตย","เขตคลองเตย",103301,"เต็นท์บริเวณหน้าร้านรสนิยม ท้ายซอยสุขุมวิท 4",9,273,241,334,575
4213,"คลองเตย","เขตคลองเตย",103301,"เต็นท์บริเวณด้านหน้าสมาคมอนุเคราะห์คลองเตย",10,138,222,245,467
4214,"คลองเตย","เขตคลองเตย",103301,"บริเวณที่จอดรถใต้อาคารพระราม 4 เรสซิเด้นท์",11,164,252,275,527
4215,"คลองเตย","เขตคลองเตย",103301,"เต็นท์บริเวณอาคารไอสโตร์ ซอยสุขุมวิท 24",12,133,240,278,518
4216,"คลองเตย","เขตคลองเตย",103301,"เต็นท์บริเวณอาคารไอสโตร์ ซอยสุขุมวิท 24",13,177,248,261,509
4217,"คลองเตย","เขตคลองเตย",103301,"เต็นท์บริเวณอาคารไอสโตร์ ซอยสุขุมวิท 24",14,231,225,308,533
4218,"คลองเตย","เขตคลองเตย",103301,"เต็นท์บริเวณอาคารไอสโตร์ ซอยสุขุมวิท 24",15,189,233,290,523
4219,"คลองเตย","เขตคลองเตย",103301,"เต็นท์บริเวณอาคารไอสโตร์ ซอยสุขุมวิท 24",16,163,222,292,514
4220,"คลองเตย","เขตคลองเตย",103301,"โรงเรียนวรรณวิทย์ ซอยสุขุมวิท 8",17,397,312,431,743
4221,"คลองเตย","เขตคลองเตย",103301,"โรงเรียนวรรณวิทย์ ซอยสุขุมวิท 8",18,369,332,408,740
4222,"คลองเตย","เขตคลองเตย",103301,"โรงจอดรถอาคารชุดซิตี้เลคทาวเวอร์ ซอยสุขุมวิท 16",19,358,265,369,634
4223,"คลองเตย","เขตคลองเตย",103301,"เต็นท์บริเวณลานกิจกรรมโรงเรียนสายน้ำผึ้ง",20,219,170,281,451
4224,"คลองเตย","เขตคลองเตย",103301,"เต็นท์บริเวณลานกิจกรรมโรงเรียนสายน้ำผึ้ง",21,278,236,315,551
4225,"คลองเตย","เขตคลองเตย",103301,"เต็นท์บริเวณลานกิจกรรมโรงเรียนสายน้ำผึ้ง",22,255,240,318,558
4226,"คลองเตย","เขตคลองเตย",103301,"เต็นท์บริเวณลานกิจกรรมโรงเรียนสายน้ำผึ้ง",23,201,234,318,552
4227,"คลองเตย","เขตคลองเตย",103301,"เต็นท์บริเวณที่จอดรถหน้าศูนย์อาหาร 130 ปี กรมศุลกากร",24,159,267,260,527
4228,"คลองเตย","เขตคลองเตย",103301,"เต็นท์บริเวณที่จอดรถหน้าศูนย์อาหาร 130 ปี กรมศุลกากร",25,177,256,310,566
4229,"คลองเตย","เขตคลองเตย",103301,"เต็นท์บริเวณที่จอดรถหน้าศูนย์อาหาร 130 ปี กรมศุลกากร",26,203,262,308,570
4230,"คลองเตย","เขตคลองเตย",103301,"เต็นท์บริเวณที่จอดรถหน้าศูนย์อาหาร 130 ปี กรมศุลกากร",27,246,269,288,557
4231,"คลองเตย","เขตคลองเตย",103301,"ที่จอดรถข้างอาคาร 2 ศูนย์บริการสาธารณสุข 41 คลองเตย",28,182,237,259,496
4232,"คลองเตย","เขตคลองเตย",103301,"อาคารที่พักผู้ปกครองหน้าโรงเรียนพระหฤทัยคอนแวนต์",29,198,292,272,564
4233,"คลองเตย","เขตคลองเตย",103301,"อาคารที่พักผู้ปกครองหน้าโรงเรียนพระหฤทัยคอนแวนต์",30,211,262,300,562
4234,"คลองเตย","เขตคลองเตย",103301,"อาคารที่พักผู้ปกครองหน้าโรงเรียนพระหฤทัยคอนแวนต์",31,205,261,298,559
4235,"คลองเตย","เขตคลองเตย",103301,"อาคารที่พักผู้ปกครองหน้าโรงเรียนพระหฤทัยคอนแวนต์",32,213,253,360,613
4236,"คลองเตย","เขตคลองเตย",103301,"เต็นท์หน้าบริษัท คอลเกต-ปาล์ม โอลีฟ (ข้างร้านน้องแพรว)",33,278,291,353,644
4237,"คลองเตย","เขตคลองเตย",103301,"เต็นท์หน้าอาคารสโมสรการท่าเรือ",34,168,206,170,376
4238,"คลองเตย","เขตคลองเตย",103301,"เต็นท์หน้าอาคารสโมสรการท่าเรือ",35,144,217,181,398
4239,"คลองเตย","เขตคลองเตย",103301,"โรงเรียนไทยประสิทธิ์ศาสตร์ วัดคลองเตยนอก",36,148,194,133,327
4240,"คลองเตย","เขตคลองเตย",103301,"เต็นท์บริเวณสวนสมเด็จย่า ถนนพระราม 3",37,112,177,165,342
4241,"คลองเตย","เขตคลองเตย",103301,"โรงเรียนสามัคคีสงเคราะห์",38,190,275,287,562
4242,"คลองเตย","เขตคลองเตย",103301,"โรงเรียนสามัคคีสงเคราะห์",39,230,253,314,567
4243,"คลองเตย","เขตคลองเตย",103301,"โรงเรียนสามัคคีสงเคราะห์",40,192,285,311,596
4244,"คลองเตย","เขตคลองเตย",103301,"โรงเรียนสามัคคีสงเคราะห์",41,222,292,310,602
4245,"คลองเตย","เขตคลองเตย",103301,"โรงเรียนสามัคคีสงเคราะห์",42,256,275,317,592
4246,"คลองเตย","เขตคลองเตย",103301,"โรงเรียนสามัคคีสงเคราะห์",43,280,289,321,610
4247,"คลองเตย","เขตคลองเตย",103301,"โรงเรียนสามัคคีสงเคราะห์",44,389,351,282,633
4248,"คลองเตย","เขตคลองเตย",103301,"โรงเรียนศูนย์รวมน้ำใจ",45,280,275,228,503
4249,"คลองเตย","เขตคลองเตย",103301,"โรงเรียนศูนย์รวมน้ำใจ",46,205,240,271,511
4250,"คลองเตย","เขตคลองเตย",103301,"โรงเรียนศูนย์รวมน้ำใจ",47,197,248,275,523
4251,"คลองเตย","เขตคลองเตย",103301,"โรงเรียนศูนย์รวมน้ำใจ",48,211,239,273,512
4252,"คลองเตย","เขตคลองเตย",103301,"เต็นท์บริเวณลานกีฬาฯ ระหว่างอาคารแฟลต 2 และอาคารแฟลต 3",49,263,264,220,484
4253,"คลองเตย","เขตคลองเตย",103301,"เต็นท์บริเวณลานกีฬาฯ ระหว่างอาคารแฟลต 2 และอาคารแฟลต 3",50,233,231,264,495
4254,"คลองเตย","เขตคลองเตย",103301,"เต็นท์บริเวณลานกีฬาฯ ระหว่างอาคารแฟลต 6 และอาคารแฟลต 7",51,242,236,320,556
4255,"คลองเตย","เขตคลองเตย",103301,"เต็นท์บริเวณลานกีฬาฯ ระหว่างอาคารแฟลต 6 และอาคารแฟลต 7",52,241,266,223,489
4256,"คลองเตย","เขตคลองเตย",103301,"เต็นท์บริเวณลานกีฬาฯ ระหว่างอาคารแฟลต 6 และอาคารแฟลต 7",53,256,262,301,563
4257,"คลองเตย","เขตคลองเตย",103301,"เต็นท์บริเวณลานกีฬาฯ ระหว่างอาคารแฟลต 6 และอาคารแฟลต 7",54,240,246,295,541
4258,"คลองเตย","เขตคลองเตย",103301,"ชั้นล่างอาคารแฟลต 9",55,216,265,308,573
4259,"คลองเตย","เขตคลองเตย",103301,"โรงเรียนฝึกอาชีพ กทม.(คลองเตย)",56,219,284,323,607
4260,"คลองเตย","เขตคลองเตย",103301,"โรงเรียนฝึกอาชีพ กทม.(คลองเตย)",57,214,275,309,584
4261,"คลองเตย","เขตคลองเตย",103301,"เต็นท์ลานจอดรถโรงเรียนฝึกอาชีพ กทม.(คลองเตย)",58,207,301,308,609
4262,"คลองเตย","เขตคลองเตย",103301,"เต็นท์ลานจอดรถโรงเรียนฝึกอาชีพ กทม.(คลองเตย)",59,232,303,304,607
4263,"คลองเตย","เขตคลองเตย",103301,"โรงเรียนชุมชนหมู่บ้านพัฒนา",60,179,253,251,504
4264,"คลองเตย","เขตคลองเตย",103301,"โรงเรียนชุมชนหมู่บ้านพัฒนา",61,178,257,259,516
4265,"คลองเตย","เขตคลองเตย",103301,"โรงเรียนชุมชนหมู่บ้านพัฒนา",62,209,270,259,529
4266,"คลองเตย","เขตคลองเตย",103301,"โรงเรียนชุมชนหมู่บ้านพัฒนา",63,177,250,271,521
4267,"คลองเตย","เขตคลองเตย",103301,"เต็นท์ลานกิจกรรมโรงเรียนชุมชนหมู่บ้านพัฒนา",64,155,268,260,528
4268,"คลองเตย","เขตคลองเตย",103301,"เต็นท์ลานกิจกรรมโรงเรียนชุมชนหมู่บ้านพัฒนา",65,184,259,280,539
4269,"คลองเตย","เขตคลองเตย",103301,"อาคารศูนย์ส่งเสริมการพัฒนาบุคคล",66,194,230,265,495
4270,"คลองเตย","เขตคลองเตย",103301,"เต็นท์บริเวณลานกีฬาศูนย์เยาวชนคลองเตย",67,274,299,343,642
4271,"คลองเตย","เขตคลองเตย",103301,"เต็นท์บริเวณลานกีฬาศูนย์เยาวชนคลองเตย",68,199,299,317,616
4272,"คลองเตย","เขตคลองเตย",103301,"เต็นท์บริเวณลานกีฬาศูนย์เยาวชนคลองเตย",69,179,277,329,606
4273,"คลองเตย","เขตคลองเตย",103301,"เต็นท์บริเวณลานกีฬาศูนย์เยาวชนคลองเตย",70,255,288,350,638
4274,"คลองเตย","เขตคลองเตย",103301,"เต็นท์บริเวณลานกีฬา กทม. ชุมชนแฟลต 11-18",71,235,252,205,457
4275,"คลองเตย","เขตคลองเตย",103301,"เต็นท์บริเวณลานกีฬา กทม. ชุมชนแฟลต 11-18",72,300,282,147,429
4276,"คลองเตย","เขตคลองเตย",103301,"เต็นท์บริเวณลานกีฬา กทม. ชุมชนแฟลต 11-18",73,177,194,221,415
4277,"คลองเตย","เขตคลองเตย",103301,"เต็นท์บริเวณลานกีฬา กทม. ชุมชนพัฒนาชุมชนใหม่ แฟลต 19-22",74,267,287,325,612
4278,"คลองเตย","เขตคลองเตย",103301,"เต็นท์บริเวณลานกีฬา กทม. ชุมชนพัฒนาชุมชนใหม่ แฟลต 19-22",75,247,275,329,604
4279,"คลองเตย","เขตคลองเตย",103301,"เต็นท์บริเวณลานกีฬา กทม. ชุมชนหมู่บ้านพัฒนา 70 ไร่",76,152,273,275,548
4280,"คลองเตย","เขตคลองเตย",103301,"เต็นท์บริเวณลานกีฬา กทม. ชุมชนหมู่บ้านพัฒนา 70 ไร่",77,168,244,293,537
4281,"คลองเตย","เขตคลองเตย",103301,"เต็นท์บริเวณลานกีฬา กทม. ชุมชนหมู่บ้านพัฒนา 70 ไร่",78,169,286,267,553
4282,"คลองเตย","เขตคลองเตย",103301,"เต็นท์บริเวณลานกีฬา กทม. ชุมชนหมู่บ้านพัฒนา 70 ไร่",79,154,252,297,549
4283,"คลองเตย","เขตคลองเตย",103301,"เต็นท์บริเวณลานกีฬา กทม. ชุมชนหมู่บ้านพัฒนา 70 ไร่",80,174,265,285,550
4284,"คลองเตย","เขตคลองเตย",103301,"เต็นท์บริเวณลานกีฬา กทม. ชุมชนหมู่บ้านพัฒนา 70 ไร่",81,158,268,280,548
4285,"คลองเตย","เขตคลองเตย",103301,"เต็นท์บริเวณลานกีฬา กทม. ชุมชนริมทางรถไฟสายท่าเรือ",82,173,252,261,513
4286,"คลองเตย","เขตคลองเตย",103301,"เต็นท์บริเวณลานกีฬา กทม. ชุมชนริมทางรถไฟสายท่าเรือ",83,188,257,269,526
4287,"คลองเตย","เขตคลองเตย",103301,"โรงเรียนวัดคลองเตย",84,256,263,345,608
4288,"คลองเตย","เขตคลองเตย",103301,"โรงเรียนวัดคลองเตย",85,249,283,315,598
4289,"คลองเตย","เขตคลองเตย",103301,"โรงเรียนวัดคลองเตย",86,197,289,300,589
4290,"คลองตัน","เขตคลองเตย",103302,"โรงเรียนสายน้ำทิพย์",1,155,174,234,408
4291,"คลองตัน","เขตคลองเตย",103302,"โรงเรียนสายน้ำทิพย์",2,138,177,211,388
4292,"คลองตัน","เขตคลองเตย",103302,"เต็นท์บริเวณอุทยานเบญจสิริ",3,433,258,353,611
4293,"คลองตัน","เขตคลองเตย",103302,"เต็นท์บริเวณอุทยานเบญจสิริ",4,434,263,354,617
4294,"คลองตัน","เขตคลองเตย",103302,"เต็นท์บริเวณอุทยานเบญจสิริ",5,300,266,352,618
4295,"คลองตัน","เขตคลองเตย",103302,"เต็นท์บริเวณอุทยานเบญจสิริ",6,456,247,380,627
4296,"คลองตัน","เขตคลองเตย",103302,"เต็นท์บริเวณลานกิจกรรมหน้าห้างโลตัส พระราม 4",7,228,217,272,489
4297,"คลองตัน","เขตคลองเตย",103302,"เต็นท์บริเวณลานกิจกรรมหน้าห้างโลตัส พระราม 4",8,160,240,284,524
4298,"คลองตัน","เขตคลองเตย",103302,"เต็นท์บริเวณลานกิจกรรมหน้าห้างโลตัส พระราม 4",9,182,225,297,522
4299,"คลองตัน","เขตคลองเตย",103302,"โรงเรียนสิงฟ้า",10,325,303,370,673
4300,"คลองตัน","เขตคลองเตย",103302,"โรงเรียนสิงฟ้า",11,348,286,406,692
4301,"คลองตัน","เขตคลองเตย",103302,"เต็นท์บริเวณโรงเรียนดรุณาลัย สุขุมวิท 36",12,206,195,280,475
4302,"คลองตัน","เขตคลองเตย",103302,"เต็นท์บริเวณโรงเรียนดรุณาลัย สุขุมวิท 36",13,149,213,281,494
4303,"คลองตัน","เขตคลองเตย",103302,"เต็นท์บริเวณโรงเรียนดรุณาลัย สุขุมวิท 36",14,108,219,243,462
4304,"คลองตัน","เขตคลองเตย",103302,"เต็นท์บริเวณโรงเรียนดรุณาลัย สุขุมวิท 36",15,147,234,265,499
4305,"คลองตัน","เขตคลองเตย",103302,"เต็นท์บริเวณโรงเรียนดรุณาลัย สุขุมวิท 36",16,137,223,268,491
4306,"พระโขนง","เขตคลองเตย",103303,"เต็นท์บริเวณลานกิจกรรมโรงเรียนปทุมคงคา",1,402,265,366,631
4307,"พระโขนง","เขตคลองเตย",103303,"เต็นท์บริเวณลานกิจกรรมโรงเรียนปทุมคงคา",2,362,246,377,623
4308,"พระโขนง","เขตคลองเตย",103303,"เต็นท์บริเวณลานกิจกรรมโรงเรียนปทุมคงคา",3,330,256,365,621
4309,"พระโขนง","เขตคลองเตย",103303,"เต็นท์บริเวณลานกิจกรรมโรงเรียนปทุมคงคา",4,311,252,341,593
4310,"พระโขนง","เขตคลองเตย",103303,"เต็นท์บริเวณลานกิจกรรมโรงเรียนปทุมคงคา",5,312,263,344,607
4311,"พระโขนง","เขตคลองเตย",103303,"เต็นท์บริเวณลานกิจกรรมโรงเรียนปทุมคงคา",6,375,238,364,602
4312,"พระโขนง","เขตคลองเตย",103303,"เต็นท์บริเวณลานกิจกรรมโรงเรียนปทุมคงคา",7,398,230,360,590
4313,"พระโขนง","เขตคลองเตย",103303,"เต็นท์บริเวณสมาคมสกุลคู (ศาลเจ้า)",8,438,202,302,504
4314,"พระโขนง","เขตคลองเตย",103303,"เต็นท์บริเวณสมาคมสกุลคู (ศาลเจ้า)",9,288,223,280,503
4315,"พระโขนง","เขตคลองเตย",103303,"เต็นท์บริเวณด้านหน้ามหาวิทยาลัยกรุงเทพ (ประตู3)",10,243,213,264,477
4316,"พระโขนง","เขตคลองเตย",103303,"เต็นท์บริเวณด้านหน้ามหาวิทยาลัยกรุงเทพ (ประตู3)",11,103,252,224,476
4317,"พระโขนง","เขตคลองเตย",103303,"เต็นท์บริเวณด้านหน้ามหาวิทยาลัยกรุงเทพ (ประตู3)",12,295,182,269,451
4318,"พระโขนง","เขตคลองเตย",103303,"โรงเรียนพระโขนงวิทยา",13,199,251,279,530
4319,"พระโขนง","เขตคลองเตย",103303,"โรงเรียนพระโขนงวิทยา",14,143,253,278,531
4320,"พระโขนง","เขตคลองเตย",103303,"โรงเรียนพระโขนงวิทยา",15,282,196,333,529
4321,"พระโขนง","เขตคลองเตย",103303,"โรงเรียนพระโขนงวิทยา",16,175,246,280,526
4322,"พระโขนง","เขตคลองเตย",103303,"เต็นท์บริเวณโรงเรียนพระโขนงวิทยา",17,161,252,265,517
4323,"พระโขนง","เขตคลองเตย",103303,"เต็นท์บริเวณโรงเรียนพระโขนงวิทยา",18,394,211,316,527
4324,"พระโขนง","เขตคลองเตย",103303,"เต็นท์บริเวณโรงเรียนพระโขนงวิทยา",19,278,212,301,513
4325,"พระโขนง","เขตคลองเตย",103303,"โรงเรียนซินหยกฮั้วกงฮัก",20,140,241,272,513
4326,"พระโขนง","เขตคลองเตย",103303,"โรงเรียนซินหยกฮั้วกงฮัก",21,171,238,248,486
4327,"พระโขนง","เขตคลองเตย",103303,"โรงเรียนวัดสะพาน",22,221,261,256,517
4328,"พระโขนง","เขตคลองเตย",103303,"โรงเรียนวัดสะพาน",23,184,253,281,534
4329,"พระโขนง","เขตคลองเตย",103303,"โรงเรียนวัดสะพาน",24,208,292,266,558
4330,"พระโขนง","เขตคลองเตย",103303,"โรงอาหารการประปานครหลวง สาขาพระโขนง",25,326,226,310,536
4331,"พระโขนง","เขตคลองเตย",103303,"บริเวณโรงจอดรถสถานีสูบน้ำพระโขนง",26,152,271,282,553
4332,"พระโขนง","เขตคลองเตย",103303,"เต็นท์บริเวณลานกีฬาใต้ทางด่วนปากซอยเริ่มเจริญ",27,263,239,362,601
4333,"พระโขนง","เขตคลองเตย",103303,"เต็นท์บริเวณลานกีฬาใต้ทางด่วนปากซอยเริ่มเจริญ",28,226,264,339,603
4334,"พระโขนง","เขตคลองเตย",103303,"เต็นท์บริเวณลานกีฬาใต้ทางด่วนปากซอยเริ่มเจริญ",29,474,237,378,615
4335,"พระโขนง","เขตคลองเตย",103303,"เต็นท์บริเวณลานกีฬาใต้ทางด่วนปากซอยเริ่มเจริญ",30,268,251,348,599
4336,"พระโขนง","เขตคลองเตย",103303,"เต็นท์บริเวณลานกีฬาใต้ทางด่วนปากซอยเริ่มเจริญ",31,319,261,353,614
4337,"พระโขนง","เขตคลองเตย",103303,"เต็นท์บริเวณลานกีฬาใต้ทางด่วนปากซอยเริ่มเจริญ",32,389,245,379,624
4338,"สวนหลวง","เขตสวนหลวง",103401,"มัสยิดอันวารุ้ลอับร๊อด (ซอยพัฒนาการ 38)",1,241,375,411,786
4339,"สวนหลวง","เขตสวนหลวง",103401,"มัสยิดอันวารุ๊ลอับร๊อด (ซอยพัฒนาการ 38)",2,323,318,434,752
4340,"สวนหลวง","เขตสวนหลวง",103401,"มัสยิดอันวารุ๊ลอับร๊อด (ซอยพัฒนาการ 38)",3,440,309,481,790
4341,"สวนหลวง","เขตสวนหลวง",103401,"มัสยิดอันวารุ๊ลอับร๊อด (ซอยพัฒนาการ 38)",4,462,335,462,797
4342,"สวนหลวง","เขตสวนหลวง",103401,"มัสยิดอันวารุ๊ลอับร๊อด (ซอยพัฒนาการ 38)",5,466,325,473,798
4343,"สวนหลวง","เขตสวนหลวง",103401,"เต็นท์บริเวณหมู่บ้านเดอะคอนเนค (ซอยพัฒนาการ 38)",6,494,350,474,824
4344,"สวนหลวง","เขตสวนหลวง",103401,"เต็นท์บริเวณหมู่บ้านวิลเลตซิตี้ (ซอยพัฒนาการ 38)",7,377,326,445,771
4345,"สวนหลวง","เขตสวนหลวง",103401,"เต็นท์บริเวณหมู่บ้านวิลเลตไลต์ (ซอยพัฒนาการ 38)",8,416,315,445,760
4346,"สวนหลวง","เขตสวนหลวง",103401,"เต็นท์บริเวณศูนย์รถเช่า (ซอยพัฒนาการ 29)",9,414,325,456,781
4347,"สวนหลวง","เขตสวนหลวง",103401,"เต็นท์บริเวณศูนย์รถเช่า (ซอยพัฒนาการ 29)",10,470,318,468,786
4348,"สวนหลวง","เขตสวนหลวง",103401,"เต็นท์บริเวณศูนย์รถเช่า (ซอยพัฒนาการ 29)",11,315,331,445,776
4349,"สวนหลวง","เขตสวนหลวง",103401,"เต็นท์บริเวณลานจอดรถบางกอกแนชเชอรัลสปา (ซอยพัฒนาการ30)",12,367,387,399,786
4350,"สวนหลวง","เขตสวนหลวง",103401,"เต็นท์บริเวณลานจอดรถบางกอกแนชเชอรัลสปา (ซอยพัฒนาการ30)",13,316,347,404,751
4351,"สวนหลวง","เขตสวนหลวง",103401,"เต็นท์บริเวณลานจอดรถบางกอกแนชเชอรัลสปา (ซอยพัฒนาการ30)",14,355,334,427,761
4352,"สวนหลวง","เขตสวนหลวง",103401,"เต็นท์บริเวณลานจอดรถบางกอกแนชเชอรัลสปา (ซอยพัฒนาการ30)",15,346,377,439,816
4353,"สวนหลวง","เขตสวนหลวง",103401,"เต็นท์บริเวณหมู่บ้านปัญญา (ซอยพัฒนาการ30)",16,272,329,430,759
4354,"สวนหลวง","เขตสวนหลวง",103401,"เต็นท์บริเวณหมู่บ้านปัญญา (ซอยพัฒนาการ30)",17,296,339,422,761
4355,"สวนหลวง","เขตสวนหลวง",103401,"เต็นท์บริเวณลานจอดรถบริษัทเซ็นคอร์ปอเรชั่นกรุ๊ป จำกัด(มหาชน)(ระหว่างซอยอ่อนนุช 17 แยก 16-18))",18,290,299,401,700
4356,"สวนหลวง","เขตสวนหลวง",103401,"เต็นท์บริเวณลานจอดรถบริษัทเซ็นคอร์ปอเรชั่นกรุ๊ป จำกัด(มหาชน)(ระหว่างซอยอ่อนนุช 17 แยก 16-18)",19,178,323,381,704
4357,"สวนหลวง","เขตสวนหลวง",103401,"เต็นท์บริเวณลานจอดรถบริษัทเซ็นคอร์ปอเรชั่นกรุ๊ป จำกัด(มหาชน)(ระหว่างซอยอ่อนนุช 17 แยก 16-18)",20,249,293,403,696
4358,"สวนหลวง","เขตสวนหลวง",103401,"เต็นท์บริเวณลานจอดรถบริษัทเซ็นคอร์ปอเรชั่นกรุ๊ป จำกัด(มหาชน)(ระหว่างซอยอ่อนนุช 17 แยก 16-18)",21,301,306,406,712
4359,"สวนหลวง","เขตสวนหลวง",103401,"เต็นท์บริเวณลานจอดรถบริษัทเซ็นคอร์ปอเรชั่นกรุ๊ป จำกัด(มหาชน)(ระหว่างซอยอ่อนนุช 17 แยก 16-18)",22,325,303,394,697
4360,"สวนหลวง","เขตสวนหลวง",103401,"เต็นท์บริเวณลานจอดรถบริษัทเซ็นคอร์ปอเรชั่นกรุ๊ป จำกัด(มหาชน)(ระหว่างซอยอ่อนนุช 17 แยก 16-18)",23,249,327,378,705
4361,"สวนหลวง","เขตสวนหลวง",103401,"เต็นท์บริเวณลานจอดรถบริษัทเซ็นคอร์ปอเรชั่นกรุ๊ป จำกัด(มหาชน)(ระหว่างซอยอ่อนนุช 17 แยก 16-18)",24,216,316,387,703
4362,"สวนหลวง","เขตสวนหลวง",103401,"เต็นท์บริเวณลานจอดรถบริษัทเซ็นคอร์ปอเรชั่นกรุ๊ป จำกัด(มหาชน)(ระหว่างซอยอ่อนนุช 17 แยก 16-18)",25,355,309,396,705
4363,"สวนหลวง","เขตสวนหลวง",103401,"เต็นท์บริเวณลานจอดรถบริษัทเซ็นคอร์ปอเรชั่นกรุ๊ป จำกัด(มหาชน)(ระหว่างซอยอ่อนนุช 17 แยก 16-18)",26,251,313,389,702
4364,"สวนหลวง","เขตสวนหลวง",103401,"วัดยาง (บริเวณโดมศาลา 5) (ซอยอ่อนนุช 23)",27,157,342,388,730
4365,"สวนหลวง","เขตสวนหลวง",103401,"เต็นท์บริเวณลานกีฬาชุมชนซอยเพียรมานะ(ซ.อ่อนนุช17แยก20)",28,246,263,313,576
4366,"สวนหลวง","เขตสวนหลวง",103401,"เต็นท์บริเวณลานกีฬาชุมชนซอยเพียรมานะ (ซอยอ่อนนุช17 แยก 20)",29,216,265,293,558
4367,"สวนหลวง","เขตสวนหลวง",103401,"เต็นท์บริเวณลานกีฬาชุมชนซอยเพียรมานะ(ซ.อ่อนนุช17แยก20)",30,232,240,322,562
4368,"สวนหลวง","เขตสวนหลวง",103401,"สโมสรหมู่บ้านสวนแหลมทอง (ซอยพัฒนาการ 28)",31,268,321,431,752
4369,"สวนหลวง","เขตสวนหลวง",103401,"โรงเรียนนาคนาวาอุปถัมภ์ (ซอยอ่อนนุช 17 แยก 24)",32,460,213,359,572
4370,"สวนหลวง","เขตสวนหลวง",103401,"โรงเรียนนาคนาวาอุปถัมภ์ (ซอยอ่อนนุช 17 แยก 24)",33,135,261,310,571
4371,"สวนหลวง","เขตสวนหลวง",103401,"โรงเรียนนาคนาวาอุปถัมภ์ (ซอยอ่อนนุช 17 แยก 24)",34,151,273,306,579
4372,"สวนหลวง","เขตสวนหลวง",103401,"โรงเรียนสวนรัฐวิทยา (ซอยพัฒนาการ 20 แยก 6/2)",35,164,317,338,655
4373,"สวนหลวง","เขตสวนหลวง",103401,"โรงเรียนสวนรัฐวิทยา (ซอยพัฒนาการ 20 แยก 6/2)",36,144,324,319,643
4374,"สวนหลวง","เขตสวนหลวง",103401,"โรงเรียนสวนรัฐวิทยา (ซอยพัฒนาการ 20 แยก 6/2)",37,185,308,361,669
4375,"สวนหลวง","เขตสวนหลวง",103401,"โรงเรียนสวนรัฐวิทยา (ซอยพัฒนาการ 20 แยก 6/2)",38,250,317,328,645
4376,"สวนหลวง","เขตสวนหลวง",103401,"โรงเรียนสวนรัฐวิทยา (ซอยพัฒนาการ 20 แยก 6/2)",39,291,293,382,675
4377,"สวนหลวง","เขตสวนหลวง",103401,"โรงเรียนสวนรัฐวิทยา (ซอยพัฒนาการ 20 แยก 6/2)",40,204,282,383,665
4378,"สวนหลวง","เขตสวนหลวง",103401,"เต็นท์บริเวณที่จอดรถสำนักงานหมู่บ้านผกามาศ(ซอยพัฒนาการ 20 แยก 8)",41,133,228,256,484
4379,"สวนหลวง","เขตสวนหลวง",103401,"เต็นท์บริเวณที่จอดรถสำนักงานหมู่บ้านผกามาศ(ซอยพัฒนาการ 20 แยก 8)",42,166,234,265,499
4380,"สวนหลวง","เขตสวนหลวง",103401,"เต็นท์บริเวณที่จอดรถหน้าอาคารร่มเย็นอพาร์ทเม้นท์(ซอยพัฒนาการ 17)",43,312,361,410,771
4381,"สวนหลวง","เขตสวนหลวง",103401,"เต็นท์บริเวณที่จอดรถร้านตะวันแดง (ถนนพัฒนาการ)(ซอยพัฒนาการ 17)",44,527,290,420,710
4382,"สวนหลวง","เขตสวนหลวง",103401,"เต็นท์บริเวณที่จอดรถร้านตะวันแดง (ถนนพัฒนาการ)",45,248,325,379,704
4383,"สวนหลวง","เขตสวนหลวง",103401,"เต็นท์บริเวณที่จอดรถมัสยิดยามิอุ้ลอิสลาม คลองตัน (ถนนเพชรบุรี)",46,426,307,386,693
4384,"สวนหลวง","เขตสวนหลวง",103401,"เต็นท์บริเวณที่จอดรถมัสยิดยามิอุ้ลอิสลาม คลองตัน(ถนนเพชรบุรี)",47,290,293,379,672
4385,"สวนหลวง","เขตสวนหลวง",103401,"เต็นท์บริเวณที่จอดรถมัสยิดยามิอุ้ลอิสลาม คลองตัน(ถนนเพชรบุรี)",48,596,283,408,691
4386,"สวนหลวง","เขตสวนหลวง",103401,"ศูนย์กลางอิสลามแห่งประเทศไทย (ซอยรามคำแหง 2)",49,247,256,338,594
4387,"สวนหลวง","เขตสวนหลวง",103401,"ศูนย์กลางอิสลามแห่งประเทศไทย (ซอยรามคำแหง 2)",50,269,254,339,593
4388,"สวนหลวง","เขตสวนหลวง",103401,"ศูนย์กลางอิสลามแห่งประเทศไทย (ซอยรามคำแหง 2)",51,433,257,368,625
4389,"สวนหลวง","เขตสวนหลวง",103401,"เต็นท์บริเวณที่จอดรถตลาดเสรีมาร์เก็ต (ซอยพระรามเก้า 41)",52,302,298,345,643
4390,"สวนหลวง","เขตสวนหลวง",103401,"เต็นท์บริเวณที่จอดรถตลาดเสรีมาร์เก็ต (ซอยพระรามเก้า 41)",53,308,244,383,627
4391,"สวนหลวง","เขตสวนหลวง",103401,"บริเวณอาคารมัสยิดอัลกุ๊บรอ (ซอยพัฒนาการ 32)",54,151,338,379,717
4392,"สวนหลวง","เขตสวนหลวง",103401,"เต็นท์บริเวณโรงจอดรถบ้านมะพร้าว (ซอยอ่อนนุช 39)",55,99,212,236,448
4393,"อ่อนนุช","เขตสวนหลวง",103402,"โรงเรียนวัดใต้ (ซอยอ่อนนุช 3)",1,199,368,382,750
4394,"อ่อนนุช","เขตสวนหลวง",103402,"โรงเรียนวัดใต้ (ซอยอ่อนนุช 3)",2,425,295,466,761
4395,"อ่อนนุช","เขตสวนหลวง",103402,"โรงเรียนวัดใต้ (ซอยอ่อนนุช 3)",3,455,280,486,766
4396,"อ่อนนุช","เขตสวนหลวง",103402,"โรงเรียนวัดใต้ (ซอยอ่อนนุช 3)",4,536,259,504,763
4397,"อ่อนนุช","เขตสวนหลวง",103402,"โรงเรียนวัดมหาบุศย์ (ซอยอ่อนนุช 7)",5,216,340,396,736
4398,"อ่อนนุช","เขตสวนหลวง",103402,"โรงเรียนวัดมหาบุศย์ (ซอยอ่อนนุช 7)",6,467,269,470,739
4399,"อ่อนนุช","เขตสวนหลวง",103402,"โรงเรียนวัดมหาบุศย์ (ซอยอ่อนนุช 7)",7,353,324,437,761
4400,"อ่อนนุช","เขตสวนหลวง",103402,"โรงเรียนวัดมหาบุศย์ (ซอยอ่อนนุช 7)",8,293,361,402,763
4401,"อ่อนนุช","เขตสวนหลวง",103402,"โรงเรียนวัดมหาบุศย์ (ซอยอ่อนนุช 7)",9,255,353,381,734
4402,"อ่อนนุช","เขตสวนหลวง",103402,"โรงเรียนวัดมหาบุศย์ (ซอยอ่อนนุช 7)",10,304,330,422,752
4403,"อ่อนนุช","เขตสวนหลวง",103402,"โรงเรียนวัดมหาบุศย์ (ซอยอ่อนนุช 7)",11,239,349,397,746
4404,"อ่อนนุช","เขตสวนหลวง",103402,"เต็นท์บริเวณอาคารบ้านรัตนพราหมณ์ (ซอยอ่อนนุช 17)",12,195,301,354,655
4405,"อ่อนนุช","เขตสวนหลวง",103402,"โรงเรียนจินดาพงศ์ (ซอยอ่อนนุช 30)",13,170,276,314,590
4406,"อ่อนนุช","เขตสวนหลวง",103402,"โรงเรียนจินดาพงศ์ (ซอยอ่อนนุช 30)",14,196,264,325,589
4407,"อ่อนนุช","เขตสวนหลวง",103402,"โรงเรียนจินดาพงศ์ (ซอยอ่อนนุช 30)",15,225,278,317,595
4408,"อ่อนนุช","เขตสวนหลวง",103402,"วัดยาง (บริเวณโดมศาลา 5) (ซอยอ่อนนุช 23)",16,336,336,424,760
4409,"อ่อนนุช","เขตสวนหลวง",103402,"วัดยาง (บริเวณโดมศาลา 5) (ซอยอ่อนนุช 23)",17,387,313,446,759
4410,"อ่อนนุช","เขตสวนหลวง",103402,"โรงเรียนวัดทองใน (ซอยอ่อนนุช 25)",18,184,266,307,573
4411,"อ่อนนุช","เขตสวนหลวง",103402,"โรงเรียนวัดทองใน (ซอยอ่อนนุช 25)",19,166,255,330,585
4412,"อ่อนนุช","เขตสวนหลวง",103402,"โรงเรียนวัดทองใน (ซอยอ่อนนุช 25)",20,203,278,297,575
4413,"อ่อนนุช","เขตสวนหลวง",103402,"ศาลาการเปรียญวัดต้นไทรย์ (ซอยอ่อนนุช 29)",21,183,269,326,595
4414,"อ่อนนุช","เขตสวนหลวง",103402,"โรงเรียนอโศกวิทย์ (ระหว่างซอยอ่อนนุช 40 - 42)",22,274,333,419,752
4415,"อ่อนนุช","เขตสวนหลวง",103402,"โรงเรียนอโศกวิทย์ (ระหว่างซอยอ่อนนุช 40 - 42)",23,328,291,459,750
4416,"อ่อนนุช","เขตสวนหลวง",103402,"โรงเรียนอโศกวิทย์ (ระหว่างซอยอ่อนนุช 40 - 42)",24,263,315,440,755
4417,"อ่อนนุช","เขตสวนหลวง",103402,"โรงเรียนอโศกวิทย์ (ระหว่างซอยอ่อนนุช 40 - 42)",25,324,336,438,774
4418,"อ่อนนุช","เขตสวนหลวง",103402,"เต็นท์บริเวณลานจอดรถรทวีวัฒน์ผ้าใบ (ซอยอ่อนนุช 44)(ซอยสุขฤดี)",26,165,185,239,424
4419,"อ่อนนุช","เขตสวนหลวง",103402,"เต็นท์บริเวณลานจอดรถทวีวัฒน์ผ้าใบ (ซอยอ่อนนุช 44)(ซอยสุขฤดี)",27,136,184,244,428
4420,"อ่อนนุช","เขตสวนหลวง",103402,"โรงเรียนวัดปากบ่อ (ซอยอ่อนนุช 35)",28,166,262,298,560
4421,"อ่อนนุช","เขตสวนหลวง",103402,"โรงเรียนวัดปากบ่อ (ซอยอ่อนนุช 35)",29,119,269,297,566
4422,"อ่อนนุช","เขตสวนหลวง",103402,"โรงเรียนวัดปากบ่อ (ซอยอ่อนนุช 35)",30,181,255,324,579
4423,"อ่อนนุช","เขตสวนหลวง",103402,"โรงเรียนวัดปากบ่อ (ซอยอ่อนนุช 35)",31,234,230,345,575
4424,"อ่อนนุช","เขตสวนหลวง",103402,"เต็นท์บริเวณโรงเรียนทวีศักดิ์ศึกษา (มัสยิดริยาดุสซอลิฮีน)(ซอยอ่อนนุช 46)",32,265,280,400,680
4425,"อ่อนนุช","เขตสวนหลวง",103402,"เต็นท์บริเวณโรงเรียนทวีศักดิ์ศึกษา (มัสยิดริยาดุสซอลิฮีน)(ซอยอ่อนนุช 46)",33,401,277,417,694
4426,"อ่อนนุช","เขตสวนหลวง",103402,"เต็นท์บริเวณโรงเรียนทวีศักดิ์ศึกษา (มัสยิดริยาดุสซอลิฮีน)(ซอยอ่อนนุช 46)",34,476,259,425,684
4427,"อ่อนนุช","เขตสวนหลวง",103402,"เต็นท์บริเวณโรงเรียนทวีศักดิ์ศึกษา (มัสยิดริยาดุสซอลิฮีน)(ซอยอ่อนนุช 46)",35,265,314,369,683
4428,"อ่อนนุช","เขตสวนหลวง",103402,"เต็นท์บริเวณโรงเรียนทวีศักดิ์ศึกษา (มัสยิดริยาดุสซอลิฮีน)(ซอยอ่อนนุช 46)",36,227,306,379,685
4429,"อ่อนนุช","เขตสวนหลวง",103402,"เต็นท์บริเวณโรงเรียนทวีศักดิ์ศึกษา (มัสยิดริยาดุสซอลิฮีน)(ซอยอ่อนนุช 46)",37,271,316,371,687
4430,"อ่อนนุช","เขตสวนหลวง",103402,"เต็นท์บริเวณโรงเรียนทวีศักดิ์ศึกษา (มัสยิดริยาดุสซอลิฮีน)(ซอยอ่อนนุช 46)",38,251,290,388,678
4431,"อ่อนนุช","เขตสวนหลวง",103402,"โรงเรียนสะและน้อยอุปถัมภ์ (ซอยอ่อนนุช 54)",39,128,234,292,526
4432,"อ่อนนุช","เขตสวนหลวง",103402,"โรงเรียนสะและน้อยอุปถัมภ์ (ซอยอ่อนนุช 54)",40,142,251,277,528
4433,"อ่อนนุช","เขตสวนหลวง",103402,"โรงเรียนสะและน้อยอุปถัมภ์ (ซอยอ่อนนุช 54)",41,158,251,280,531
4434,"อ่อนนุช","เขตสวนหลวง",103402,"เต็นท์บริเวณหน้าตลาดเอี่ยมสมบัติ (ถนนศรีนครินทร์)",42,276,304,363,667
4435,"อ่อนนุช","เขตสวนหลวง",103402,"เต็นท์บริเวณหน้าตลาดเอี่ยมสมบัติ (ถนนศรีนครินทร์)",43,169,311,329,640
4436,"อ่อนนุช","เขตสวนหลวง",103402,"เต็นท์บริเวณหน้าตลาดเอี่ยมสมบัติ (ถนนศรีนครินทร์)",44,267,277,358,635
4437,"อ่อนนุช","เขตสวนหลวง",103402,"เต็นท์บริเวณหน้าตลาดเอี่ยมสมบัติ (ถนนศรีนครินทร์)",45,212,292,358,650
4438,"อ่อนนุช","เขตสวนหลวง",103402,"เต็นท์บริเวณหน้าตลาดเอี่ยมสมบัติ (ถนนศรีนครินทร์)",46,197,323,345,668
4439,"อ่อนนุช","เขตสวนหลวง",103402,"เต็นท์บริเวณหน้าตลาดเอี่ยมสมบัติ (ถนนศรีนครินทร์)",47,228,307,377,684
4440,"อ่อนนุช","เขตสวนหลวง",103402,"เต็นท์บริเวณหน้าตลาดเอี่ยมสมบัติ (ถนนศรีนครินทร์)",48,342,305,380,685
4441,"อ่อนนุช","เขตสวนหลวง",103402,"เต็นท์บริเวณชุมชนโมราวรรณ 1 (ซอย่อนนุช 49)",49,469,231,406,637
4442,"อ่อนนุช","เขตสวนหลวง",103402,"เต็นท์บริเวณชุมชนโมราวรรณ 1 (ซอย่อนนุช 49)",50,468,253,375,628
4443,"อ่อนนุช","เขตสวนหลวง",103402,"เต็นท์บริเวณชุมชนโมราวรรณ 1 (ซอย่อนนุช 49)",51,129,307,328,635
4444,"อ่อนนุช","เขตสวนหลวง",103402,"เต็นท์บริเวณชุมชนโมราวรรณ 1 (ซอยอ่อนนุช 49)",52,129,304,308,612
4445,"อ่อนนุช","เขตสวนหลวง",103402,"เต็นท์บริเวณที่ทำการไปรษณีย์อ่อนนุช (ระหว่างซอยอ่อนนุช 66/1 - 68)",53,229,257,292,549
4446,"อ่อนนุช","เขตสวนหลวง",103402,"เต็นท์บริเวณที่ทำการไปรษรีย์อ่อนนุช (ระหว่างซอยอ่อนนุช 66/1 - 68)",54,185,245,307,552
4447,"อ่อนนุช","เขตสวนหลวง",103402,"เต็นท์บริเวณที่ทำการไปรษณีย์อ่อนนุช  (ระหว่างซอยอ่อนนุช 66/1 - 68)",55,173,246,305,551
4448,"พัฒนาการ","เขตสวนหลวง",103403,"เต็นท์บริเวณลานจอดรถภัตตาคารจรินทร์ทิพย์ (ระหว่างคลองโคกวัด-ซอยศรีนครินทร์ 24)",1,171,242,227,469
4449,"พัฒนาการ","เขตสวนหลวง",103403,"เต็นท์บริเวณลานจอดรถภัตตาคารจรินทร์ทิพย์(ระหว่างคลองโคกวัด-ซอยศรีนครินทร์ 24)",2,212,195,274,469
4450,"พัฒนาการ","เขตสวนหลวง",103403,"โรงเรียนนูรุ่ลอิสลาม (คลองจวน) (ซอยอ่อนนุช 39)",3,178,245,261,506
4451,"พัฒนาการ","เขตสวนหลวง",103403,"โรงเรียนนูรุ่ลอิสลาม (คลองจวน) (ซอยอ่อนนุช 39)",4,184,234,278,512
4452,"พัฒนาการ","เขตสวนหลวง",103403,"โรงเรียนสุเหร่าใหม่ (ซอยอ่อนนุช 39)",5,143,280,312,592
4453,"พัฒนาการ","เขตสวนหลวง",103403,"โรงเรียนสุเหร่าใหม่ (ซอยอ่อนนุช 39)",6,157,286,304,590
4454,"พัฒนาการ","เขตสวนหลวง",103403,"เต็นท์บริเวณศูนย์บริการสาธารณสุข 37(ระหว่างซอยพัฒนาการ 54 - ถนนศรีนครินทร์)",7,230,152,256,408
4455,"พัฒนาการ","เขตสวนหลวง",103403,"เต็นท์บริเวณศูนย์บริการสาธารณสุข 37(ระหว่างซอยพัฒนาการ 54 - ถนนศรีนครินทร์)",8,191,180,240,420
4456,"พัฒนาการ","เขตสวนหลวง",103403,"โรงเรียนคลองกลันตัน (ซอยศรีนครินทร์ 18)",9,238,222,311,533
4457,"พัฒนาการ","เขตสวนหลวง",103403,"โรงเรียนคลองกลันตัน (ซอยศรีนครินทร์ 18)",10,254,237,309,546
4458,"พัฒนาการ","เขตสวนหลวง",103403,"โรงเรียนเตรียมอุดมศึกษาพัฒนาการ (ซอยพัฒนาการ 58)",11,170,247,301,548
4459,"พัฒนาการ","เขตสวนหลวง",103403,"โรงเรียนเตรียมอุดมศึกษาพัฒนาการ (ซอยพัฒนาการ 58)",12,193,225,328,553
4460,"พัฒนาการ","เขตสวนหลวง",103403,"โรงเรียนเตรียมอุดมศึกษาพัฒนาการ (ซอยพัฒนาการ 58)",13,181,266,284,550
4461,"พัฒนาการ","เขตสวนหลวง",103403,"เต็นท์บริเวณใกล้สระน้ำหมู่บ้านเมืองทอง 2/3 (ซอยพัฒนาการ 53)",14,299,315,342,657
4462,"พัฒนาการ","เขตสวนหลวง",103403,"เต็นท์บริเวณใกล้สระน้ำหมู่บ้านเมืองทอง 2/3 (ซอยพัฒนาการ 53)",15,237,288,360,648
4463,"พัฒนาการ","เขตสวนหลวง",103403,"เต็นท์บริเวณใกล้สระน้ำหมู่บ้านเมืองทอง 2/3 (ซอยพัฒนาการ 53)",16,218,294,347,641
4464,"พัฒนาการ","เขตสวนหลวง",103403,"โรงเรียนหัวหมาก (ซอยศรีนครินทร์ 17)",17,432,307,409,716
4465,"พัฒนาการ","เขตสวนหลวง",103403,"โรงเรียนหัวหมาก (ซอยศรีนครินทร์ 17)",18,266,322,352,674
4466,"พัฒนาการ","เขตสวนหลวง",103403,"โรงเรียนหัวหมาก (ซอยศรีนครินทร์ 17)",19,443,294,412,706
4467,"พัฒนาการ","เขตสวนหลวง",103403,"เต็นท์บริเวณลานกีฬาหมู่บ้านเคหะนคร 3 (ซอยพัฒนาการ 50)",20,218,257,306,563
4468,"พัฒนาการ","เขตสวนหลวง",103403,"เต็นท์บริเวณลานกีฬาหมู่บ้านเคหะนคร 3 (ซอยพัฒนาการ 50)",21,168,254,309,563
4469,"พัฒนาการ","เขตสวนหลวง",103403,"เต็นท์บริเวณลานกีฬาหมู่บ้านเคหะนคร 3 (ซอยพัฒนาการ 50)",22,211,271,293,564
4470,"พัฒนาการ","เขตสวนหลวง",103403,"เต็นท์บริเวณลานจอดรถบ้านสิริรังสฤษฎ์ (ระหว่างซอยพัฒนาการ 48-50)",23,270,346,393,739
4471,"พัฒนาการ","เขตสวนหลวง",103403,"เต็นท์บริเวณลานจอดรถบ้านสิริรังสฤษฎ์   (ระหว่างซอยพัฒนาการ 48-50)",24,358,323,461,784
4472,"พัฒนาการ","เขตสวนหลวง",103403,"เต็นท์บริเวณลานจอดรถบ้านสิริรังสฤษฎ์ (ระหว่างซอยพัฒนาการ 48-50)",25,322,323,439,762
4473,"พัฒนาการ","เขตสวนหลวง",103403,"บริเวณลานจอดรถใต้อาคารปรีชากรุ๊ป (ซอยพัฒนาการ 41)",26,213,260,340,600
4474,"พัฒนาการ","เขตสวนหลวง",103403,"บริเวณลานจอดรถใต้อาคารปรีชากรุ๊ป (ซอยพัฒนาการ 41)",27,251,265,337,602
4475,"พัฒนาการ","เขตสวนหลวง",103403,"เต็นท์บริเวณที่จอดรถสามสิบนาทีหน้าแมกซ์แวลู ศูนย์การค้าเดอะไนน์ (ระหว่างคลองลาว-ซอยพระราม ๙ ซอย 41)",28,250,241,318,559
4476,"พัฒนาการ","เขตสวนหลวง",103403,"เต็นท์บริเวณที่จอดรถสามสิบนาทีหน้าแมกซ์แวลูศูนย์การค้าเดอะไนน์ (ระหว่างคลองลาว-ซอยพระราม ๙ ซอย 41)",29,215,258,302,560
4477,"พัฒนาการ","เขตสวนหลวง",103403,"เต็นท์บริเวณที่จอดรถสามสิบนาทีหน้าแมกซ์แวลูศูนย์การค้าเดอะไนน์ (ระหว่างคลองลาว-ซอยพระราม ๙ ซอย 41)",30,200,233,322,555
4478,"พัฒนาการ","เขตสวนหลวง",103403,"เต็นท์บริเวณหมู่บ้านเสรี (ซอยพระรามเก้า 45)",31,285,265,376,641
4479,"พัฒนาการ","เขตสวนหลวง",103403,"เต็นท์บริเวณหมู่บ้านเสรี (ซอยพระรามเก้า 45)",32,298,287,364,651
4480,"พัฒนาการ","เขตสวนหลวง",103403,"เต็นท์บริเวณหมู่บ้านเสรี (ซอยพระรามเก้า 45)",33,307,250,400,650
4481,"พัฒนาการ","เขตสวนหลวง",103403,"โรงเรียนธรรมานุรักษ์ (ซอยศิริถาวร แยกพระรามเก้า 41)",34,152,243,290,533
4482,"พัฒนาการ","เขตสวนหลวง",103403,"โรงเรียนธรรมานุรักษ์ (ซอยศิริถาวร แยกพระรามเก้า 41)",35,168,249,289,538
4483,"พัฒนาการ","เขตสวนหลวง",103403,"เต็นท์บริเวณศูนย์พัฒนาเด็กอ่อนก่อนวัยเรียนชุมชนนาคภาษิต(ซอยพระรามเก้า 47/1)",36,182,350,387,737
4484,"พัฒนาการ","เขตสวนหลวง",103403,"เต็นท์บริเวณลานจอดรถบริษัทสยามรอยัลวิลล์ (ซอยพระรามเก้า 57)",37,222,285,325,610
4485,"พัฒนาการ","เขตสวนหลวง",103403,"บริเวณสถานีรถไฟหัวหมาก (ซอยศรีนครินทร์ 12)",38,139,225,276,501
4486,"พัฒนาการ","เขตสวนหลวง",103403,"เต็นท์บริเวณลานจอดรถ PIT & GO ศรีนครินทร์ DENSO ธนศิริดีเซล(ถนนศรีนครินทร์)",39,427,175,347,522
4487,"พัฒนาการ","เขตสวนหลวง",103403,"เต็นท์บริเวณลานจอดรถ PIT & GO ศรีนครินทร์ DENSO ธนศิริดีเซล(ถนนศรีนครินทร์)",40,137,213,270,483
4488,"บางขุนเทียน","เขตจอมทอง",103501,"โรงเรียนวัดบางประทุนนอก",1,193,343,333,676
4489,"บางขุนเทียน","เขตจอมทอง",103501,"โรงเรียนวัดบางประทุนนอก",2,195,331,345,676
4490,"บางขุนเทียน","เขตจอมทอง",103501,"โรงเรียนวัดไทร",3,204,325,355,680
4491,"บางขุนเทียน","เขตจอมทอง",103501,"โรงเรียนวัดไทร",4,199,343,394,737
4492,"บางขุนเทียน","เขตจอมทอง",103501,"โรงเรียนวัดไทร",5,212,318,343,661
4493,"บางขุนเทียน","เขตจอมทอง",103501,"โรงเรียนวัดไทร",6,213,335,372,707
4494,"บางขุนเทียน","เขตจอมทอง",103501,"โรงเรียนวัดไทร",7,227,343,383,726
4495,"บางขุนเทียน","เขตจอมทอง",103501,"โรงเรียนวัดไทร",8,220,319,405,724
4496,"บางขุนเทียน","เขตจอมทอง",103501,"โรงเรียนมัธยมวัดสิงห์",9,191,358,360,718
4497,"บางขุนเทียน","เขตจอมทอง",103501,"โรงเรียนมัธยมวัดสิงห์",10,203,317,368,685
4498,"บางขุนเทียน","เขตจอมทอง",103501,"โรงเรียนมัธยมวัดสิงห์",11,205,380,390,770
4499,"บางขุนเทียน","เขตจอมทอง",103501,"โรงเรียนมัธยมวัดสิงห์",12,261,373,397,770
4500,"บางขุนเทียน","เขตจอมทอง",103501,"โรงเรียนมัธยมวัดสิงห์",13,260,332,426,758
4501,"บางขุนเทียน","เขตจอมทอง",103501,"โรงเรียนมัธยมวัดสิงห์",14,255,320,397,717
4502,"บางขุนเทียน","เขตจอมทอง",103501,"โรงเรียนมัธยมวัดสิงห์",15,191,337,386,723
4503,"บางขุนเทียน","เขตจอมทอง",103501,"โรงเรียนมัธยมวัดสิงห์",16,246,306,419,725
4504,"บางขุนเทียน","เขตจอมทอง",103501,"โรงเรียนมัธยมวัดสิงห์",17,280,353,425,778
4505,"บางขุนเทียน","เขตจอมทอง",103501,"เต็นท์บริเวณลานจอดรถ สำนักงานสรรพากรพื้นที่ 27 ถนนเอกชัย",18,284,356,401,757
4506,"บางขุนเทียน","เขตจอมทอง",103501,"เต็นท์บริเวณลานจอดรถ สำนักงานสรรพากรพื้นที่ 27 ถนนเอกชัย",19,218,327,395,722
4507,"บางขุนเทียน","เขตจอมทอง",103501,"เต็นท์บริเวณลานจอดรถ สำนักงานสรรพากรพื้นที่ 27 ถนนเอกชัย",20,225,350,428,778
4508,"บางขุนเทียน","เขตจอมทอง",103501,"เต็นท์บริเวณลานจอดรถ สำนักงานสรรพากรพื้นที่ 27 ถนนเอกชัย",21,252,383,438,821
4509,"บางขุนเทียน","เขตจอมทอง",103501,"เต็นท์บริเวณลานจอดรถ สำนักงานสรรพากรพื้นที่ 27 ถนนเอกชัย",22,364,378,470,848
4510,"บางขุนเทียน","เขตจอมทอง",103501,"เต็นท์บริเวณลานจอดรถ สำนักงานสรรพากรพื้นที่ 27 ถนนเอกชัย",23,303,382,458,840
4511,"บางขุนเทียน","เขตจอมทอง",103501,"เต็นท์โรงจอดรถอัญชลีอพาร์ทเม้นท์ ซอยกำนันแม้น 28",24,142,248,304,552
4512,"บางขุนเทียน","เขตจอมทอง",103501,"เต็นท์โรงจอดรถอัญชลีอพาร์ทเม้นท์ ซอยกำนันแม้น 28",25,149,276,297,573
4513,"บางขุนเทียน","เขตจอมทอง",103501,"เต็นท์บริเวณสมาคมตระกูลโง้ว ถนนกัลปพฤกษ์",26,385,454,488,942
4514,"บางขุนเทียน","เขตจอมทอง",103501,"เต็นท์บริเวณสมาคมตระกูลโง้ว ถนนกัลปพฤกษ์",27,449,380,527,907
4515,"บางขุนเทียน","เขตจอมทอง",103501,"เต็นท์บริเวณข้างบ้านเลขที่ 44/3 สุดซอยกำนันแม้น 36",28,176,272,319,591
4516,"บางขุนเทียน","เขตจอมทอง",103501,"เต็นท์บริเวณหน้าหมู่บ้านกัสโต้ สาทร-ตากสิน ถนนเทอดไท",29,296,331,422,753
4517,"บางขุนเทียน","เขตจอมทอง",103501,"เต็นท์บริเวณวัดแก้วไพฑูรย์",30,278,355,460,815
4518,"บางขุนเทียน","เขตจอมทอง",103501,"เต็นท์บริเวณวัดแก้วไพฑูรย์",31,196,319,366,685
4519,"บางขุนเทียน","เขตจอมทอง",103501,"เต็นท์บริเวณวัดแก้วไพฑูรย์",32,219,323,365,688
4520,"บางขุนเทียน","เขตจอมทอง",103501,"เต็นท์บริเวณวัดแก้วไพฑูรย์",33,217,341,385,726
4521,"บางขุนเทียน","เขตจอมทอง",103501,"เต็นท์บริเวณวัดแก้วไพฑูรย์",34,221,331,392,723
4522,"บางขุนเทียน","เขตจอมทอง",103501,"เต็นท์บริเวณวัดแก้วไพฑูรย์",35,246,356,413,769
4523,"บางขุนเทียน","เขตจอมทอง",103501,"โรงเรียนวัดศาลาครืน",36,293,338,419,757
4524,"บางขุนเทียน","เขตจอมทอง",103501,"โรงเรียนวัดศาลาครืน",37,201,342,383,725
4525,"บางขุนเทียน","เขตจอมทอง",103501,"โรงเรียนวัดศาลาครืน",38,215,334,379,713
4526,"บางขุนเทียน","เขตจอมทอง",103501,"โรงเรียนวัดศาลาครืน",39,210,336,393,729
4527,"บางค้อ","เขตจอมทอง",103502,"เต็นท์บริเวณประตูระบายน้ำวัดนาคปรก",1,242,353,469,822
4528,"บางค้อ","เขตจอมทอง",103502,"เต็นท์บริเวณประตูระบายน้ำวัดนาคปรก",2,628,375,542,917
4529,"บางค้อ","เขตจอมทอง",103502,"โรงเรียนวัดหนัง",3,416,433,485,918
4530,"บางค้อ","เขตจอมทอง",103502,"โรงเรียนวัดหนัง",4,741,383,546,929
4531,"บางค้อ","เขตจอมทอง",103502,"โรงเรียนวัดหนัง",5,572,386,556,942
4532,"บางค้อ","เขตจอมทอง",103502,"โรงเรียนวัดหนัง",6,320,420,506,926
4533,"บางค้อ","เขตจอมทอง",103502,"โรงเรียนวัดหนัง",7,331,420,503,923
4534,"บางค้อ","เขตจอมทอง",103502,"โรงเรียนวัดหนัง",8,248,406,509,915
4535,"บางค้อ","เขตจอมทอง",103502,"โรงเรียนวัดหนัง",9,231,428,468,896
4536,"บางค้อ","เขตจอมทอง",103502,"โรงเรียนวัดนางนอง(พิพัฒน์)",10,282,334,426,760
4537,"บางค้อ","เขตจอมทอง",103502,"โรงเรียนวัดนางนอง(พิพัฒน์)",11,227,331,408,739
4538,"บางค้อ","เขตจอมทอง",103502,"โรงเรียนวัดนางนอง(พิพัฒน์)",12,251,332,432,764
4539,"บางค้อ","เขตจอมทอง",103502,"โรงเรียนวัดนางนอง(พิพัฒน์)",13,219,300,385,685
4540,"บางค้อ","เขตจอมทอง",103502,"โรงเรียนวัดนางนอง(พิพัฒน์)",14,169,310,359,669
4541,"บางค้อ","เขตจอมทอง",103502,"โรงเรียนวัดนางนอง(พิพัฒน์)",15,173,377,388,765
4542,"บางค้อ","เขตจอมทอง",103502,"โรงเรียนวัดนางนอง(พิพัฒน์)",16,340,366,435,801
4543,"บางค้อ","เขตจอมทอง",103502,"โรงเรียนแม่พระประจักษ์",17,219,356,410,766
4544,"บางค้อ","เขตจอมทอง",103502,"โรงเรียนแม่พระประจักษ์",18,315,393,415,808
4545,"บางค้อ","เขตจอมทอง",103502,"โรงเรียนแม่พระประจักษ์",19,280,410,439,849
4546,"บางค้อ","เขตจอมทอง",103502,"โรงเรียนแม่พระประจักษ์",20,246,402,456,858
4547,"บางค้อ","เขตจอมทอง",103502,"โรงเรียนแม่พระประจักษ์",21,215,343,422,765
4548,"บางค้อ","เขตจอมทอง",103502,"โรงเรียนแม่พระประจักษ์",22,218,419,438,857
4549,"บางค้อ","เขตจอมทอง",103502,"โรงเรียนแม่พระประจักษ์",23,298,393,417,810
4550,"บางค้อ","เขตจอมทอง",103502,"เต็นท์บริเวณลานจอดรถธนาคารกสิกรไทย สาขาบางขุนเทียน ถนนจอมทอง",24,194,274,351,625
4551,"บางค้อ","เขตจอมทอง",103502,"เต็นท์บริเวณลานจอดรถธนาคารกสิกรไทย สาขาบางขุนเทียน ถนนจอมทอง",25,215,320,375,695
4552,"บางค้อ","เขตจอมทอง",103502,"เต็นท์บริเวณลานจอดรถธนาคารกสิกรไทย สาขาบางขุนเทียน ถนนจอมทอง",26,200,280,329,609
4553,"บางค้อ","เขตจอมทอง",103502,"เต็นท์บริเวณลานจอดรถธนาคารกสิกรไทย สาขาบางขุนเทียน ถนนจอมทอง",27,205,273,340,613
4554,"บางค้อ","เขตจอมทอง",103502,"โรงเรียนวัดมงคลวราราม",28,223,346,365,711
4555,"บางค้อ","เขตจอมทอง",103502,"โรงเรียนวัดมงคลวราราม",29,281,366,427,793
4556,"บางค้อ","เขตจอมทอง",103502,"โรงเรียนวัดมงคลวราราม",30,164,378,377,755
4557,"บางค้อ","เขตจอมทอง",103502,"โรงเรียนวัดมงคลวราราม",31,210,344,378,722
4558,"บางค้อ","เขตจอมทอง",103502,"โรงเรียนวัดมงคลวราราม",32,221,365,350,715
4559,"บางค้อ","เขตจอมทอง",103502,"เต็นท์โรงจอดรถข้างศูนย์พัฒนาเด็กเล็กชุมชนศิลปเดชซอยจอมทอง 12",33,149,323,316,639
4560,"บางค้อ","เขตจอมทอง",103502,"เต็นท์โรงจอดรถข้างศูนย์พัฒนาเด็กเล็กชุมชนศิลปเดชซอยจอมทอง 12",34,169,348,340,688
4561,"บางค้อ","เขตจอมทอง",103502,"เต็นท์ข้างเซเว่นอีเลฟเว่น แฟลตน้ำเงิน ซอยจอมทอง 14",35,227,321,352,673
4562,"บางค้อ","เขตจอมทอง",103502,"เต็นท์ข้างเซเว่นอีเลฟเว่น แฟลตน้ำเงิน ซอยจอมทอง 14",36,218,286,347,633
4563,"บางค้อ","เขตจอมทอง",103502,"เต็นท์ข้างเซเว่นอีเลฟเว่น แฟลตน้ำเงิน ซอยจอมทอง 14",37,161,259,319,578
4564,"บางมด","เขตจอมทอง",103503,"เต็นท์บริเวณลานจอดรถธนาคารกสิกรไทย สาขาบางมด ถนนพระรามที่ 2",1,199,256,309,565
4565,"บางมด","เขตจอมทอง",103503,"เต็นท์บริเวณลานจอดรถธนาคารกสิกรไทย สาขาบางมด ถนนพระรามที่ 2",2,201,270,312,582
4566,"บางมด","เขตจอมทอง",103503,"เต็นท์บริเวณลานจอดรถธนาคารทหารไทยธนชาต จำกัดซอยพระรามที่ 2 ซอย 21",3,255,384,406,790
4567,"บางมด","เขตจอมทอง",103503,"เต็นท์บริเวณลานจอดรถธนาคารทหารไทยธนชาต จำกัดซอยพระรามที่ 2 ซอย 21",4,253,367,409,776
4568,"บางมด","เขตจอมทอง",103503,"เต็นท์บริเวณลานจอดรถสำนักงานเขตจอมทอง",5,188,293,324,617
4569,"บางมด","เขตจอมทอง",103503,"เต็นท์บริเวณลานจอดรถสำนักงานเขตจอมทอง",6,234,359,359,718
4570,"บางมด","เขตจอมทอง",103503,"เต็นท์บริเวณลานจอดรถสำนักงานเขตจอมทอง",7,311,439,457,896
4571,"บางมด","เขตจอมทอง",103503,"เต็นท์บริเวณลานจอดรถสำนักงานเขตจอมทอง",8,278,355,407,762
4572,"บางมด","เขตจอมทอง",103503,"เต็นท์บริเวณลานจอดรถสำนักงานเขตจอมทอง",9,291,338,446,784
4573,"บางมด","เขตจอมทอง",103503,"โรงเรียนบางมดวิทยา",10,246,351,380,731
4574,"บางมด","เขตจอมทอง",103503,"โรงเรียนบางมดวิทยา",11,321,387,510,897
4575,"บางมด","เขตจอมทอง",103503,"โรงเรียนวัดโพธิ์ทอง",12,433,465,563,1028
4576,"บางมด","เขตจอมทอง",103503,"โรงเรียนวัดโพธิ์ทอง",13,399,453,549,1002
4577,"บางมด","เขตจอมทอง",103503,"โรงเรียนวัดโพธิ์ทอง",14,419,458,565,1023
4578,"บางมด","เขตจอมทอง",103503,"เต็นท์บริเวณตลาดพุทธบูชา 95 CENTER FOR U ตรงข้ามซอยพุทธบูชา7/1",15,243,371,421,792
4579,"บางมด","เขตจอมทอง",103503,"เต็นท์บริเวณตลาดพุทธบูชา 95 CENTER FOR U ตรงข้ามซอยพุทธบูชา7/1",16,287,357,394,751
4580,"บางมด","เขตจอมทอง",103503,"โรงเรียนวัดสีสุก",17,117,183,220,403
4581,"บางมด","เขตจอมทอง",103503,"โรงเรียนวัดสีสุก",18,138,168,217,385
4582,"บางมด","เขตจอมทอง",103503,"โรงเรียนวัดยายร่ม",19,672,373,630,1003
4583,"บางมด","เขตจอมทอง",103503,"โรงเรียนวัดยายร่ม",20,447,435,559,994
4584,"บางมด","เขตจอมทอง",103503,"โรงเรียนวัดยายร่ม",21,407,441,559,1000
4585,"บางมด","เขตจอมทอง",103503,"เต็นท์บริเวณลานจอดรถร้านอาหารอิ่มปลาเผา ถนนพุทธบูชา",22,288,377,442,819
4586,"บางมด","เขตจอมทอง",103503,"เต็นท์บริเวณลานจอดรถร้านอาหารอิ่มปลาเผา ถนนพุทธบูชา",23,246,390,386,776
4587,"บางมด","เขตจอมทอง",103503,"เต็นท์บริเวณลานจอดรถร้านอาหารอิ่มปลาเผา ถนนพุทธบูชา",24,278,334,414,748
4588,"บางมด","เขตจอมทอง",103503,"เต็นท์ที่ซอยพระรามที่ 2 ซอย 39 แยก 23 หมู่บ้านวิชิตนคร",25,269,362,415,777
4589,"บางมด","เขตจอมทอง",103503,"เต็นท์ในโรงอาหารบริษัท ที.เค. การ์เม้นท์ จำกัดซอยพระรามที่ 2 ซอย 35",26,199,245,314,559
4590,"บางมด","เขตจอมทอง",103503,"เต็นท์ในโรงอาหารบริษัท ที.เค การ์เม้นท์ จำกัดซอยพระรามที่ 2 ซอย 35",27,198,231,285,516
4591,"บางมด","เขตจอมทอง",103503,"เต็นท์หน้าสมาคมประมงแห่งประเทศไทย ซอยพระรามที่ 2 ซอย 30",28,231,261,338,599
4592,"บางมด","เขตจอมทอง",103503,"เต็นท์หน้าสมาคมประมงแห่งประเทศไทย ซอยพระรามที่ 2 ซอย 30",29,248,257,339,596
4593,"บางมด","เขตจอมทอง",103503,"เต็นท์บริเวณบริษัทเอเชียกรุ๊ป (1999) ข้างที่จอดรถโรงพยาบาลบางมด",30,250,322,446,768
4594,"บางมด","เขตจอมทอง",103503,"เต็นท์บริเวณบริษัทเอเชียกรุ๊ป (1999) ข้างที่จอดรถโรงพยาบาลบางมด",31,459,339,502,841
4595,"บางมด","เขตจอมทอง",103503,"เต็นท์บริเวณบริษัทเอเชียกรุ๊ป (1999) ข้างที่จอดรถโรงพยาบาลบางมด",32,277,316,453,769
4596,"บางมด","เขตจอมทอง",103503,"เต็นท์บริเวณบริษัทเอเชียกรุ๊ป (1999) ข้างที่จอดรถโรงพยาบาลบางมด",33,251,316,383,699
4597,"บางมด","เขตจอมทอง",103503,"เต็นท์บริเวณลานกีฬา หมู่บ้านสินทวีวิลล่าซอยพระรามที่ 2 ซอย 43",34,304,383,311,694
4598,"บางมด","เขตจอมทอง",103503,"เต็นท์บริเวณลานกีฬา หมู่บ้านสินทวีวิลล่าซอยพระรามที่ 2 ซอย 43",35,286,320,431,751
4599,"บางมด","เขตจอมทอง",103503,"เต็นท์บริเวณลานกีฬา หมู่บ้านสินทวีวิลล่าซอยพระรามที่ 2 ซอย 43",36,298,387,451,838
4600,"บางมด","เขตจอมทอง",103503,"เต็นท์บริเวณลานกีฬา หมู่บ้านสินทวีวิลล่าซอยพระรามที่ 2 ซอย 43",37,290,394,427,821
4601,"บางมด","เขตจอมทอง",103503,"เต็นท์บริเวณลานกีฬา หมู่บ้านสินทวีวิลล่าซอยพระรามที่ 2 ซอย 43",38,300,354,460,814
4602,"บางมด","เขตจอมทอง",103503,"โรงเรียนจินดาศึกษา ซอยพระรามที่ 2 ซอย 40",39,251,290,384,674
4603,"บางมด","เขตจอมทอง",103503,"โรงเรียนจินดาศึกษา ซอยพระรามที่ 2 ซอย 40",40,224,264,334,598
4604,"บางมด","เขตจอมทอง",103503,"โรงเรียนจินดาศึกษา ซอยพระรามที่ 2 ซอย 40",41,240,302,342,644
4605,"บางมด","เขตจอมทอง",103503,"เต็นท์บริเวณศูนย์เยาวชนจอมทอง ซอยพระรามที่ 2 ซอย 40",42,358,379,514,893
4606,"บางมด","เขตจอมทอง",103503,"เต็นท์บริเวณศูนย์เยาวชนจอมทอง ซอยพระรามที่ 2 ซอย 40",43,389,475,437,912
4607,"บางมด","เขตจอมทอง",103503,"โรงเรียนวัดโพธิ์แก้ว",44,297,404,430,834
4608,"บางมด","เขตจอมทอง",103503,"โรงเรียนวัดโพธิ์แก้ว",45,180,356,400,756
4609,"จอมทอง","เขตจอมทอง",103504,"โรงเรียนเลิศพัฒนาศึกษา",1,200,351,359,710
4610,"จอมทอง","เขตจอมทอง",103504,"โรงเรียนเลิศพัฒนาศึกษา",2,175,333,372,705
4611,"จอมทอง","เขตจอมทอง",103504,"โรงเรียนเลิศพัฒนาศึกษา",3,211,351,359,710
4612,"จอมทอง","เขตจอมทอง",103504,"โรงเรียนเลิศพัฒนาศึกษา",4,198,319,324,643
4613,"จอมทอง","เขตจอมทอง",103504,"โรงเรียนเลิศพัฒนาศึกษา",5,210,330,356,686
4614,"จอมทอง","เขตจอมทอง",103504,"โรงเรียนเลิศพัฒนาศึกษา",6,213,317,333,650
4615,"จอมทอง","เขตจอมทอง",103504,"โรงเรียนเลิศพัฒนาศึกษา",7,230,295,320,615
4616,"จอมทอง","เขตจอมทอง",103504,"เต็นท์ริมถนนสุดซอยจอมทอง 3 (ภาณุมาภรณ์)",8,182,341,346,687
4617,"จอมทอง","เขตจอมทอง",103504,"เต็นท์ริมถนนสุดซอยจอมทอง 3 (ภาณุมาภรณ์)",9,175,339,371,710
4618,"จอมทอง","เขตจอมทอง",103504,"เต็นท์ริมถนนสุดซอยจอมทอง 3 (ภาณุมาภรณ์)",10,174,335,388,723
4619,"จอมทอง","เขตจอมทอง",103504,"เต็นท์ริมถนนสุดซอยจอมทอง 3 (ภาณุมาภรณ์)",11,190,294,340,634
4620,"จอมทอง","เขตจอมทอง",103504,"โรงจอดรถฝ่ายเก็บขนมูลฝอยทางน้ำ ถนนจอมทอง แยกดาวคะนอง",12,158,223,260,483
4621,"จอมทอง","เขตจอมทอง",103504,"เต็นท์บริเวณสถานีบริการน้ำมันเชลล์ สาขาบางปะแก้วถนนสุขสวัสดิ์",13,441,369,527,896
4622,"จอมทอง","เขตจอมทอง",103504,"เต็นท์บริเวณสถานีบริการน้ำมันเชลล์ สาขาบางปะแก้วถนนสุขสวัสดิ์",14,240,341,392,733
4623,"จอมทอง","เขตจอมทอง",103504,"เต็นท์บริเวณสถานีบริการน้ำมันเชลล์ สาขาบางปะแก้วถนนสุขสวัสดิ์",15,289,364,410,774
4624,"จอมทอง","เขตจอมทอง",103504,"เต็นท์บริเวณสถานีบริการน้ำมันเชลล์ สาขาบางปะแก้วถนนสุขสวัสดิ์",16,241,372,396,768
4625,"จอมทอง","เขตจอมทอง",103504,"เต็นท์บริเวณสถานีบริการน้ำมันเชลล์ สาขาบางปะแก้วถนนสุขสวัสดิ์",17,261,362,390,752
4626,"จอมทอง","เขตจอมทอง",103504,"เต็นท์บริเวณตลาดนัดข้างแอรี่อพาร์ทเม้นท์ ซอยสุขสวัสดิ์ 2",18,196,314,344,658
4627,"จอมทอง","เขตจอมทอง",103504,"เต็นท์บริเวณตลาดนัดข้างแอรี่อพาร์ทเม้นท์ ซอยสุขสวัสดิ์ 2",19,126,227,238,465
4628,"จอมทอง","เขตจอมทอง",103504,"โรงเรียนวัดนาคนิมิตร",20,201,327,366,693
4629,"จอมทอง","เขตจอมทอง",103504,"โรงเรียนวัดนาคนิมิตร",21,201,331,381,712
4630,"จอมทอง","เขตจอมทอง",103504,"โรงเรียนวัดนาคนิมิตร",22,208,316,379,695
4631,"จอมทอง","เขตจอมทอง",103504,"โรงเรียนวัดนาคนิมิตร",23,193,317,325,642
4632,"จอมทอง","เขตจอมทอง",103504,"เต็นท์ลานจอดรถมัสยิดนูรุ้ลยากีน ซอยสุขสวัสดิ์ 14",24,121,232,301,533
4633,"จอมทอง","เขตจอมทอง",103504,"เต็นท์ลานจอดรถมัสยิดนูรุ้ลยากีน ซอยสุขสวัสดิ์ 14",25,141,250,309,559
4634,"จอมทอง","เขตจอมทอง",103504,"เต็นท์บริเวณวัดบางขุนเทียนกลาง",26,229,372,378,750
4635,"จอมทอง","เขตจอมทอง",103504,"เต็นท์บริเวณวัดบางขุนเทียนกลาง",27,199,358,404,762
4636,"จอมทอง","เขตจอมทอง",103504,"เต็นท์บริเวณวัดบางขุนเทียนกลาง",28,345,406,527,933
4637,"จอมทอง","เขตจอมทอง",103504,"โรงเรียนวัดบางขุนเทียนนอก",29,207,328,408,736
4638,"จอมทอง","เขตจอมทอง",103504,"โรงเรียนวัดบางขุนเทียนนอก",30,236,328,383,711
4639,"จอมทอง","เขตจอมทอง",103504,"โรงเรียนวัดบางขุนเทียนนอก",31,234,329,354,683
4640,"จอมทอง","เขตจอมทอง",103504,"โรงเรียนวัดบางขุนเทียนนอก",32,269,336,381,717
4641,"จอมทอง","เขตจอมทอง",103504,"เต็นท์โรงจอดรถข้างบ้านเลขที่ 9/39 ซอยพระรามที่ 2 ซอย 30 แยก 7",33,156,251,296,547
4642,"จอมทอง","เขตจอมทอง",103504,"เต็นท์โรงจอดรถข้างบ้านเลขที่ 9/39 ซอยพระรามที่ 2 ซอย 30 แยก 7",34,160,261,281,542
4643,"จอมทอง","เขตจอมทอง",103504,"เต็นท์ที่ว่างตรงข้ามโยตาอาหารเจ ซอยพระรามที่ 2 ซอย 44",35,222,311,371,682
4644,"จอมทอง","เขตจอมทอง",103504,"เต็นท์ที่ว่างตรงข้ามโยตาอาหารเจ ซอยพระรามที่ 2 ซอย 44",36,172,348,400,748
4645,"จอมทอง","เขตจอมทอง",103504,"เต็นท์หน้าบ้านเลขที่ 115/1 ซอยพระรามที่ 2 ซอย 30 แยก 1",37,324,405,514,919
4646,"จอมทอง","เขตจอมทอง",103504,"เต็นท์หน้าบ้านเลขที่ 115/1 ซอยพระรามที่ 2 ซอย 30 แยก 1",38,305,404,461,865
4647,"สีกัน","เขตดอนเมือง",103602,"เต็นท์บริเวณศาลเจ้าพ่อสมบุญ (ตลาดฝั่งโขงดอนเมือง)",1,379,327,416,743
4648,"สีกัน","เขตดอนเมือง",103602,"เต็นท์บริเวณศาลเจ้าพ่อสมบุญ (ตลาดฝั่งโขงดอนเมือง)",2,231,324,390,714
4649,"สีกัน","เขตดอนเมือง",103602,"เต็นท์บริเวณศาลเจ้าพ่อสมบุญ (ตลาดฝั่งโขงดอนเมือง)",3,207,309,396,705
4650,"สีกัน","เขตดอนเมือง",103602,"ศาลาอเนกประสงค์หมู่บ้านสินวงศ์",4,179,211,255,466
4651,"สีกัน","เขตดอนเมือง",103602,"ศาลาอเนกประสงค์หมู่บ้านสินวงศ์",5,158,193,219,412
4652,"สีกัน","เขตดอนเมือง",103602,"ศาลาอเนกประสงค์หมู่บ้านสินวงศ์",6,188,247,291,538
4653,"สีกัน","เขตดอนเมือง",103602,"เต็นท์บริเวณหมู่บ้านปิ่นเจริญ 2",7,230,299,384,683
4654,"สีกัน","เขตดอนเมือง",103602,"เต็นท์บริเวณหมู่บ้านปิ่นเจริญ 2",8,214,319,391,710
4655,"สีกัน","เขตดอนเมือง",103602,"เต็นท์บริเวณหมู่บ้านปิ่นเจริญ 2",9,231,313,396,709
4656,"สีกัน","เขตดอนเมือง",103602,"เต็นท์บริเวณหมู่บ้านปิ่นเจริญ 2",10,206,334,374,708
4657,"สีกัน","เขตดอนเมือง",103602,"เต็นท์บริเวณหมู่บ้านปิ่นเจริญ 2",11,233,321,378,699
4658,"สีกัน","เขตดอนเมือง",103602,"เต็นท์บริเวณหมู่บ้านปิ่นเจริญ 2",12,227,332,392,724
4659,"สีกัน","เขตดอนเมือง",103602,"เต็นท์บริเวณหมู่บ้านปิ่นเจริญ 2",13,225,319,398,717
4660,"สีกัน","เขตดอนเมือง",103602,"เต็นท์บริเวณหมู่บ้านปิ่นเจริญ 2",14,214,337,377,714
4661,"สีกัน","เขตดอนเมือง",103602,"เต็นท์บริเวณค่ายลูกเสือกรุงเทพมหานคร (พิศลยบุตร) ถนนสรงประภา",15,201,230,273,503
4662,"สีกัน","เขตดอนเมือง",103602,"เต็นท์บริเวณค่ายลูกเสือกรุงเทพมหานคร (พิศลยบุตร) ถนนสรงประภา",16,181,277,331,608
4663,"สีกัน","เขตดอนเมือง",103602,"เต็นท์บริเวณค่ายลูกเสือกรุงเทพมหานคร (พิศลยบุตร) ถนนสรงประภา",17,218,291,310,601
4664,"สีกัน","เขตดอนเมือง",103602,"เต็นท์บริเวณค่ายลูกเสือกรุงเทพมหานคร (พิศลยบุตร) ถนนสรงประภา",18,225,280,357,637
4665,"สีกัน","เขตดอนเมือง",103602,"เต็นท์บริเวณค่ายลูกเสือกรุงเทพมหานคร (พิศลยบุตร) ถนนสรงประภา",19,224,278,293,571
4666,"สีกัน","เขตดอนเมือง",103602,"เต็นท์บริเวณศาลาอเนกประสงค์ชุมชนดอนเมืองวิลล่า",20,214,244,326,570
4667,"สีกัน","เขตดอนเมือง",103602,"เต็นท์บริเวณศาลาอเนกประสงค์ชุมชนดอนเมืองวิลล่า",21,199,243,321,564
4668,"สีกัน","เขตดอนเมือง",103602,"เต็นท์บริเวณหมู่บ้านสายทิพย์ ซอย 11",22,212,282,354,636
4669,"สีกัน","เขตดอนเมือง",103602,"เต็นท์บริเวณหมู่บ้านสายทิพย์ ซอย 11",23,236,289,340,629
4670,"สีกัน","เขตดอนเมือง",103602,"ศาลาอเนกประสงค์ชุมชนวังไพเวช",24,292,366,452,818
4671,"สีกัน","เขตดอนเมือง",103602,"ศาลาอเนกประสงค์ชุมชนวังไพเวช",25,267,308,427,735
4672,"สีกัน","เขตดอนเมือง",103602,"ศาลาอเนกประสงค์ชุมชนวังไพเวช",26,419,353,481,834
4673,"สีกัน","เขตดอนเมือง",103602,"ที่ทำการชุมชนหมู่บ้านแหลมทองนิเวศน์",27,223,263,315,578
4674,"สีกัน","เขตดอนเมือง",103602,"ศาลาที่ทำการชุมชนหมู่บ้านปิ่นเจริญ 3 (ข้างบ้านหนังสือ กทม.)",28,240,297,373,670
4675,"สีกัน","เขตดอนเมือง",103602,"ศาลาที่ทำการชุมชนหมู่บ้านปิ่นเจริญ 3 (ข้างบ้านหนังสือ กทม.)",29,232,299,380,679
4676,"สีกัน","เขตดอนเมือง",103602,"เต็นท์บริเวณลานกีฬาชุมชนหมู่บ้านปิ่นเจริญ 3",30,216,297,377,674
4677,"สีกัน","เขตดอนเมือง",103602,"เต็นท์บริเวณลานกีฬาชุมชนหมู่บ้านปิ่นเจริญ 3",31,222,294,375,669
4678,"สีกัน","เขตดอนเมือง",103602,"เต็นท์บริเวณลานกีฬาชุมชนหมู่บ้านปิ่นเจริญ 3",32,244,292,390,682
4679,"สีกัน","เขตดอนเมือง",103602,"เต็นท์บริเวณสนามฟุตบอลระหว่างอาคารสวัสดิการทหาร 12 - 13(ทุ่งสีกัน 1)",33,307,269,242,511
4680,"สีกัน","เขตดอนเมือง",103602,"เต็นท์บริเวณสนามฟุตบอลระหว่างอาคารสวัสดิการทหาร 12 - 13(ทุ่งสีกัน 1)",34,193,551,120,671
4681,"สีกัน","เขตดอนเมือง",103602,"เต็นท์บริเวณสนามฟุตบอลระหว่างอาคารสวัสดิการทหาร 12 - 13(ทุ่งสีกัน 1)",35,388,440,228,668
4682,"สีกัน","เขตดอนเมือง",103602,"เต็นท์บริเวณหน้าประตู 2 อาคารสวัสดิการทหาร (ทุ่งสีกัน 1)",36,419,377,276,653
4683,"สีกัน","เขตดอนเมือง",103602,"เต็นท์บริเวณหน้าประตู 2 อาคารสวัสดิการทหาร (ทุ่งสีกัน 1)",37,443,379,290,669
4684,"สีกัน","เขตดอนเมือง",103602,"เต็นท์บริเวณหน้าประตู 2 อาคารสวัสดิการทหาร (ทุ่งสีกัน 1)",38,519,399,291,690
4685,"สีกัน","เขตดอนเมือง",103602,"เต็นท์บริเวณลานอเนกประสงค์หน้าอาคารสวัสดิการ (ทุ่งสีกัน 2)",39,202,517,108,625
4686,"สีกัน","เขตดอนเมือง",103602,"เต็นท์บริเวณลานอเนกประสงค์หน้าอาคารสวัสดิการ (ทุ่งสีกัน 2)",40,374,360,267,627
4687,"สีกัน","เขตดอนเมือง",103602,"เต็นท์บริเวณลานอเนกประสงค์หน้าอาคารสวัสดิการ (ทุ่งสีกัน 2)",41,380,341,285,626
4688,"สีกัน","เขตดอนเมือง",103602,"เต็นท์บริเวณลานกีฬาหมู่บ้านปิ่นเจริญ 4",42,240,303,350,653
4689,"สีกัน","เขตดอนเมือง",103602,"เต็นท์บริเวณลานกีฬาหมู่บ้านปิ่นเจริญ 4",43,223,279,354,633
4690,"สีกัน","เขตดอนเมือง",103602,"เต็นท์บริเวณวัดคลองบ้านใหม่ (สันติบุญมาราม)",44,420,325,432,757
4691,"สีกัน","เขตดอนเมือง",103602,"เต็นท์บริเวณวัดคลองบ้านใหม่ (สันติบุญมาราม)",45,343,307,398,705
4692,"สีกัน","เขตดอนเมือง",103602,"เต็นท์บริเวณวัดคลองบ้านใหม่ (สันติบุญมาราม)",46,322,340,349,689
4693,"สีกัน","เขตดอนเมือง",103602,"เต็นท์บริเวณวัดคลองบ้านใหม่ (สันติบุญมาราม)",47,410,317,414,731
4694,"สีกัน","เขตดอนเมือง",103602,"เต็นท์บริเวณวัดคลองบ้านใหม่ (สันติบุญมาราม)",48,251,287,375,662
4695,"สีกัน","เขตดอนเมือง",103602,"เต็นท์บริเวณวัดคลองบ้านใหม่ (สันติบุญมาราม)",49,277,269,373,642
4696,"สีกัน","เขตดอนเมือง",103602,"ศาลาอเนกประสงค์บริเวณบ้านเอื้ออาทร (ถนนเทิดราชัน)",50,404,365,412,777
4697,"สีกัน","เขตดอนเมือง",103602,"เต็นท์บริเวณตรงข้ามสำนักงานนิติบุคคลบ้านเอื้ออาทร (ถนนเทิดราชัน)",51,366,319,443,762
4698,"สีกัน","เขตดอนเมือง",103602,"เต็นท์บริเวณหมู่บ้านอมรพันธ์ทาวน์โฮม",52,237,311,377,688
4699,"สีกัน","เขตดอนเมือง",103602,"เต็นท์บริเวณที่ทำการชุมชนหมู่บ้าน กรป.กลาง",53,264,280,351,631
4700,"สีกัน","เขตดอนเมือง",103602,"เต็นท์บริเวณที่ทำการชุมชนหมู่บ้าน กรป.กลาง",54,224,316,320,636
4701,"สีกัน","เขตดอนเมือง",103602,"เต็นท์บริเวณที่ทำการชุมชนหมู่บ้าน กรป.กลาง",55,202,294,333,627
4702,"สีกัน","เขตดอนเมือง",103602,"เต็นท์บริเวณที่ทำการชุมชนหมู่บ้าน กรป.กลาง",56,184,300,325,625
4703,"สีกัน","เขตดอนเมือง",103602,"เต็นท์บริเวณกองพันระวังป้องกัน สำนักงานปลัดกระทรวงกลาโหม",57,258,326,341,667
4704,"สีกัน","เขตดอนเมือง",103602,"เต็นท์บริเวณกองพันระวังป้องกัน สำนักงานปลัดกระทรวงกลาโหม",58,257,498,193,691
4705,"สีกัน","เขตดอนเมือง",103602,"เต็นท์บริเวณกองพันระวังป้องกัน สำนักงานปลัดกระทรวงกลาโหม",59,339,296,386,682
4706,"สีกัน","เขตดอนเมือง",103602,"เต็นท์บริเวณสำนักงานหมู่บ้านเดอะคอนเนค 7/1",60,259,254,322,576
4707,"สีกัน","เขตดอนเมือง",103602,"เต็นท์บริเวณสำนักงานหมู่บ้านเดอะคอนเนค 7/1",61,311,258,350,608
4708,"สีกัน","เขตดอนเมือง",103602,"เต็นท์บริเวณสำนักงานหมู่บ้านเดอะคอนเนค 7/1",62,250,273,316,589
4709,"สีกัน","เขตดอนเมือง",103602,"เต็นท์บริเวณสนามฟุตบอลโรงเรียนเจริญวิทยศึกษา (ถนนเดชะตุงคะ)",63,329,246,333,579
4710,"สีกัน","เขตดอนเมือง",103602,"เต็นท์บริเวณสนามฟุตบอลโรงเรียนเจริญวิทยศึกษา (ถนนเดชะตุงคะ)",64,138,250,226,476
4711,"สีกัน","เขตดอนเมือง",103602,"เต็นท์บริเวณสนามฟุตบอลโรงเรียนเจริญวิทยศึกษา (ถนนเดชะตุงคะ)",65,160,231,229,460
4712,"สีกัน","เขตดอนเมือง",103602,"เต็นท์บริเวณลานกิจกรรมโรงเรียนบำรุงรวิวรรณวิทยา",66,425,642,147,789
4713,"สีกัน","เขตดอนเมือง",103602,"เต็นท์บริเวณลานกิจกรรมโรงเรียนบำรุงรวิวรรณวิทยา",67,224,261,328,589
4714,"สีกัน","เขตดอนเมือง",103602,"เต็นท์บริเวณลานกิจกรรมโรงเรียนบำรุงรวิวรรณวิทยา",68,245,273,347,620
4715,"สีกัน","เขตดอนเมือง",103602,"เต็นท์บริเวณลานกิจกรรมโรงเรียนบำรุงรวิวรรณวิทยา",69,286,279,342,621
4716,"สีกัน","เขตดอนเมือง",103602,"เต็นท์บริเวณลานกิจกรรมโรงเรียนบำรุงรวิวรรณวิทยา",70,383,277,339,616
4717,"สีกัน","เขตดอนเมือง",103602,"อาคารบริการ 2 สโมสรทหารอากาศ ทุ่งสีกัน",71,1,827,0,827
4718,"สีกัน","เขตดอนเมือง",103602,"อาคารบริการ 2 สโมสรทหารอากาศ ทุ่งสีกัน",72,385,461,321,782
4719,"สีกัน","เขตดอนเมือง",103602,"เต็นท์บริเวณอาคารสนามแบดมินตัน กองทัพอากาศ แฟลตทุ่งสีกัน",73,421,463,299,762
4720,"สีกัน","เขตดอนเมือง",103602,"เต็นท์บริเวณอาคารสนามแบดมินตัน กองทัพอากาศ แฟลตทุ่งสีกัน",74,402,475,267,742
4721,"สีกัน","เขตดอนเมือง",103602,"โรงเรียนดอนเมืองทหารอากาศบำรุง",75,171,262,253,515
4722,"สีกัน","เขตดอนเมือง",103602,"โรงเรียนดอนเมืองทหารอากาศบำรุง",76,136,232,266,498
4723,"สีกัน","เขตดอนเมือง",103602,"เต็นท์บริเวณโรงเรียนเปรมประชา",77,196,270,332,602
4724,"สีกัน","เขตดอนเมือง",103602,"เต็นท์บริเวณโรงเรียนเปรมประชา",78,267,265,361,626
4725,"สีกัน","เขตดอนเมือง",103602,"เต็นท์บริเวณศูนย์ฝึกอบรมและพัฒนางานตำรวจตรวจคนเข้าเมือง(ซอยเชิดวุฒากาศ 17)",79,160,289,307,596
4726,"ดอนเมือง","เขตดอนเมือง",103604,"เต็นท์บริเวณคอนโดพาร์ควิว วิภาวดี",1,472,336,442,778
4727,"ดอนเมือง","เขตดอนเมือง",103604,"ใต้อาคารแฟลตการเคหะทุ่งสองห้อง (แฟลต 2)",2,251,360,407,767
4728,"ดอนเมือง","เขตดอนเมือง",103604,"ใต้อาคารแฟลตการเคหะทุ่งสองห้อง (แฟลต 2)",3,349,323,413,736
4729,"ดอนเมือง","เขตดอนเมือง",103604,"ใต้อาคารแฟลตการเคหะทุ่งสองห้อง (แฟลต 2)",4,316,357,398,755
4730,"ดอนเมือง","เขตดอนเมือง",103604,"ใต้อาคารบ้านพักพนักงานการท่าอากาศยาน",5,252,371,368,739
4731,"ดอนเมือง","เขตดอนเมือง",103604,"เต็นท์บริเวณลานกิจกรรมโรงเรียนวัดดอนเมือง",6,198,298,247,545
4732,"ดอนเมือง","เขตดอนเมือง",103604,"เต็นท์บริเวณลานกิจกรรมโรงเรียนวัดดอนเมือง",7,125,277,247,524
4733,"ดอนเมือง","เขตดอนเมือง",103604,"เต็นท์บริเวณลานจอดรถโรงเรียนธนินทรวิทยา",8,215,314,322,636
4734,"ดอนเมือง","เขตดอนเมือง",103604,"เต็นท์บริเวณลานจอดรถโรงเรียนธนินทรวิทยา",9,194,317,351,668
4735,"ดอนเมือง","เขตดอนเมือง",103604,"เต็นท์บริเวณลานจอดรถโรงเรียนธนินทรวิทยา",10,181,292,318,610
4736,"ดอนเมือง","เขตดอนเมือง",103604,"โดมลานกีฬาโรงเรียนธนินทรวิทยา",11,178,305,337,642
4737,"ดอนเมือง","เขตดอนเมือง",103604,"โดมลานกีฬาโรงเรียนธนินทรวิทยา",12,229,313,371,684
4738,"ดอนเมือง","เขตดอนเมือง",103604,"เต็นท์บริเวณลานกิจกรรมโรงเรียนสีกัน (วัฒนานันท์อุปถัมภ์)",13,244,291,330,621
4739,"ดอนเมือง","เขตดอนเมือง",103604,"เต็นท์บริเวณลานกิจกรรมโรงเรียนสีกัน (วัฒนานันท์อุปถัมภ์)",14,194,296,330,626
4740,"ดอนเมือง","เขตดอนเมือง",103604,"เต็นท์บริเวณลานกิจกรรมโรงเรียนสีกัน (วัฒนานันท์อุปถัมภ์)",15,192,269,338,607
4741,"ดอนเมือง","เขตดอนเมือง",103604,"เต็นท์บริเวณลานกิจกรรมโรงเรียนสีกัน (วัฒนานันท์อุปถัมภ์)",16,180,279,346,625
4742,"ดอนเมือง","เขตดอนเมือง",103604,"เต็นท์บริเวณลานกิจกรรมโรงเรียนดอนเมืองจาตุรจินดา",17,199,307,359,666
4743,"ดอนเมือง","เขตดอนเมือง",103604,"เต็นท์บริเวณลานกิจกรรมโรงเรียนดอนเมืองจาตุรจินดา",18,188,297,371,668
4744,"ดอนเมือง","เขตดอนเมือง",103604,"เต็นท์บริเวณลานกิจกรรมโรงเรียนดอนเมืองจาตุรจินดา",19,215,336,349,685
4745,"ดอนเมือง","เขตดอนเมือง",103604,"เต็นท์บริเวณลานกิจกรรมโรงเรียนดอนเมืองจาตุรจินดา",20,185,298,337,635
4746,"ดอนเมือง","เขตดอนเมือง",103604,"เต็นท์บริเวณลานกิจกรรมโรงเรียนดอนเมืองจาตุรจินดา",21,170,289,324,613
4747,"ดอนเมือง","เขตดอนเมือง",103604,"เต็นท์บริเวณวัดเทพนิมิตต์",22,361,300,388,688
4748,"ดอนเมือง","เขตดอนเมือง",103604,"เต็นท์บริเวณวัดเทพนิมิตต์",23,304,272,404,676
4749,"ดอนเมือง","เขตดอนเมือง",103604,"เต็นท์บริเวณวัดเทพนิมิตต์",24,250,274,369,643
4750,"ดอนเมือง","เขตดอนเมือง",103604,"เต็นท์บริเวณวัดเทพนิมิตต์",25,306,288,359,647
4751,"ดอนเมือง","เขตดอนเมือง",103604,"เต็นท์บริเวณวัดเทพนิมิตต์",26,374,266,403,669
4752,"ดอนเมือง","เขตดอนเมือง",103604,"เต็นท์บริเวณวัดเทพนิมิตต์",27,355,308,382,690
4753,"ดอนเมือง","เขตดอนเมือง",103604,"เต็นท์บริเวณวัดเทพนิมิตต์",28,272,301,368,669
4754,"ดอนเมือง","เขตดอนเมือง",103604,"เต็นท์บริเวณตลาดนัดข้างวัดเทพนิมิตต์",29,431,271,436,707
4755,"ดอนเมือง","เขตดอนเมือง",103604,"เต็นท์บริเวณตลาดนัดข้างวัดเทพนิมิตต์",30,256,327,381,708
4756,"ดอนเมือง","เขตดอนเมือง",103604,"เต็นท์บริเวณตลาดนัดข้างวัดเทพนิมิตต์",31,286,272,405,677
4757,"ดอนเมือง","เขตดอนเมือง",103604,"ศาลาบริเวณสนามเด็กเล่นหมู่บ้านรัตนาวลัย",32,275,301,381,682
4758,"ดอนเมือง","เขตดอนเมือง",103604,"เต็นท์บริเวณสนามเด็กเล่นหมู่บ้านรัตนาวลัย",33,281,292,380,672
4759,"ดอนเมือง","เขตดอนเมือง",103604,"เต็นท์บริเวณหน้าโรงเรียนนานาชาติฮาร์โรว์ (ประตู 1)",34,188,221,287,508
4760,"ดอนเมือง","เขตดอนเมือง",103604,"เต็นท์บริเวณหน้าโรงเรียนนานาชาติฮาร์โรว์ (ประตู 1)",35,122,209,221,430
4761,"ดอนเมือง","เขตดอนเมือง",103604,"เต็นท์บริเวณที่ว่างชุมชนโกสุมรวมใจ 3 ที่ว่างซอย 3 สี่แยกใกล้ร้านค้าคุณป๋า (ก๋วยเตี๋ยวไก่มะระ)",36,185,279,312,591
4762,"ดอนเมือง","เขตดอนเมือง",103604,"ศูนย์สุขภาพชุมชนโกสุมรวมใจ 3 (ซอย 3)",37,172,291,310,601
4763,"ดอนเมือง","เขตดอนเมือง",103604,"ศูนย์สุขภาพชุมชนโกสุมรวมใจ 3 (ซอย 3)",38,177,272,311,583
4764,"ดอนเมือง","เขตดอนเมือง",103604,"ศาลาอเนกประสงค์ชุมชนโกสุมรวมใจ 1 (ข้างบ้านผู้ใหญ่สมจิตร์ฯ)",39,167,229,273,502
4765,"ดอนเมือง","เขตดอนเมือง",103604,"ศาลาอเนกประสงค์ชุมชนโกสุมรวมใจ 1",40,159,239,275,514
4766,"ดอนเมือง","เขตดอนเมือง",103604,"เต็นท์บริเวณลานจอดรถบริษัทวงตะวัน จำกัด",41,179,203,252,455
4767,"ดอนเมือง","เขตดอนเมือง",103604,"เต็นท์บริเวณลานจอดรถตลาดนัดโกสุมรวมใจ (ซอยโกสุมรวมใจ 34)",42,290,313,420,733
4768,"ดอนเมือง","เขตดอนเมือง",103604,"เต็นท์บริเวณลานจอดรถตลาดนัดโกสุมรวมใจ (ซอยโกสุมรวมใจ 34)",43,232,323,433,756
4769,"ดอนเมือง","เขตดอนเมือง",103604,"เต็นท์บริเวณลานจอดรถตลาดนัดโกสุมรวมใจ (ซอยโกสุมรวมใจ 34)",44,260,340,399,739
4770,"ดอนเมือง","เขตดอนเมือง",103604,"เต็นท์บริเวณลานจอดรถตลาดนัดโกสุมรวมใจ (ซอยโกสุมรวมใจ 34)",45,333,335,404,739
4771,"ดอนเมือง","เขตดอนเมือง",103604,"เต็นท์บริเวณลานจอดรถตลาดนัดโกสุมรวมใจ (ซอยโกสุมรวมใจ 34)",46,341,305,448,753
4772,"ดอนเมือง","เขตดอนเมือง",103604,"เต็นท์บริเวณหน้าหมู่บ้านสี่ชัยวิลล่า",47,196,234,314,548
4773,"ดอนเมือง","เขตดอนเมือง",103604,"เต็นท์บริเวณหน้าหมู่บ้านสี่ชัยวิลล่า",48,223,257,306,563
4774,"ดอนเมือง","เขตดอนเมือง",103604,"เต็นท์บริเวณโรงเรียนวัดเวฬุวนาราม (มัธยม)",49,345,353,420,773
4775,"ดอนเมือง","เขตดอนเมือง",103604,"เต็นท์บริเวณโรงเรียนวัดเวฬุวนาราม (มัธยม)",50,233,303,372,675
4776,"ดอนเมือง","เขตดอนเมือง",103604,"เต็นท์บริเวณโรงเรียนวัดเวฬุวนาราม (มัธยม)",51,238,332,407,739
4777,"ดอนเมือง","เขตดอนเมือง",103604,"เต็นท์บริเวณโรงเรียนวัดเวฬุวนาราม (ประถม)",52,208,341,384,725
4778,"ดอนเมือง","เขตดอนเมือง",103604,"เต็นท์บริเวณโรงเรียนวัดเวฬุวนาราม (ประถม)",53,272,323,398,721
4779,"ดอนเมือง","เขตดอนเมือง",103604,"เต็นท์บริเวณโรงเรียนวัดเวฬุวนาราม (ประถม)",54,317,317,409,726
4780,"ดอนเมือง","เขตดอนเมือง",103604,"เต็นท์บริเวณโรงเรียนวัดเวฬุวนาราม (ประถม)",55,470,283,440,723
4781,"ดอนเมือง","เขตดอนเมือง",103604,"เต็นท์บริเวณลานจอดรถหน้าสถานีดับเพลิงและกู้ภัยดอนเมือง",56,270,351,389,740
4782,"ดอนเมือง","เขตดอนเมือง",103604,"เต็นท์บริเวณลานจอดรถหน้าสถานีดับเพลิงและกู้ภัยดอนเมือง",57,279,375,384,759
4783,"ดอนเมือง","เขตดอนเมือง",103604,"เต็นท์บริเวณลานจอดรถหน้าสถานีดับเพลิงและกู้ภัยดอนเมือง",58,292,354,427,781
4784,"ดอนเมือง","เขตดอนเมือง",103604,"เต็นท์บริเวณสนามเด็กเล่นชุมชนบูรพา 18",59,175,242,253,495
4785,"ดอนเมือง","เขตดอนเมือง",103604,"เต็นท์บริเวณสนามเด็กเล่นชุมชนบูรพา 18",60,185,231,253,484
4786,"ดอนเมือง","เขตดอนเมือง",103604,"โรงอาหารโรงเรียนอนุบาลวัดไผ่เขียว สาขาบูรพา 16 (ซอยวัดเวฬุวนาราม 15)",61,256,317,364,681
4787,"ดอนเมือง","เขตดอนเมือง",103604,"โรงเรียนอนุบาลวัดไผ่เขียว สาขาบูรพา 16 (ซอยวัดเวฬุวนาราม 15)",62,248,305,387,692
4788,"ดอนเมือง","เขตดอนเมือง",103604,"เต็นท์บริเวณโรงเรียนอนุบาลวัดไผ่เขียว สาขาบูรพา 16 (ซอยวัดเวฬุวนาราม 15)",63,263,317,388,705
4789,"ดอนเมือง","เขตดอนเมือง",103604,"เต็นท์บริเวณโรงเรียนอนุบาลวัดไผ่เขียว สาขาบูรพา 16 (ซอยวัดเวฬุวนาราม  15)",64,247,296,376,672
4790,"ดอนเมือง","เขตดอนเมือง",103604,"เต็นท์บริเวณโรงเรียนอนุบาลวัดไผ่เขียว สาขาบูรพา 16 (ซอยวัดเวฬุวนาราม 15)",65,324,305,402,707
4791,"ดอนเมือง","เขตดอนเมือง",103604,"เต็นท์บริเวณโรงเรียนปรีดาวิทยา (ชุมชนบูรพา 12)",66,266,324,428,752
4792,"ดอนเมือง","เขตดอนเมือง",103604,"เต็นท์บริเวณโรงเรียนปรีดาวิทยา (ชุมชนบูรพา 12)",67,275,352,427,779
4793,"ดอนเมือง","เขตดอนเมือง",103604,"เต็นท์บริเวณโรงเรียนปรีดาวิทยา (ชุมชนบูรพา 12)",68,291,359,447,806
4794,"ดอนเมือง","เขตดอนเมือง",103604,"เต็นทบริเวณสวนรมณีย์ ทุ่งสีกัน",69,222,293,352,645
4795,"ดอนเมือง","เขตดอนเมือง",103604,"เต็นทบริเวณสวนรมณีย์ ทุ่งสีกัน",70,285,297,379,676
4796,"ดอนเมือง","เขตดอนเมือง",103604,"เต็นทบริเวณสวนรมณีย์ ทุ่งสีกัน",71,258,314,366,680
4797,"ดอนเมือง","เขตดอนเมือง",103604,"เต็นทบริเวณสวนรมณีย์ ทุ่งสีกัน",72,225,283,365,648
4798,"ดอนเมือง","เขตดอนเมือง",103604,"เต็นทบริเวณสวนรมณีย์ ทุ่งสีกัน",73,351,328,381,709
4799,"ดอนเมือง","เขตดอนเมือง",103604,"เต็นท์บริเวณหน้าหมู่บ้านศรีกาญจน์",74,292,356,437,793
4800,"ดอนเมือง","เขตดอนเมือง",103604,"เต็นท์บริเวณโรงเรียนสอนขับรถ ที.เอส.ซี. ตลาดโอโซนวัน",75,382,264,342,606
4801,"ดอนเมือง","เขตดอนเมือง",103604,"เต็นท์บริเวณบริเวณโรงเรียนสอนขับรถ ที.เอส.ซี. ตลาดโอโซนวัน",76,450,283,361,644
4802,"ดอนเมือง","เขตดอนเมือง",103604,"เต็นท์บริเวณสนามเด็กเล่นหมู่บ้านบุญอนันต์(ด้านหลังหมู่บ้านบุญอนันต์)",77,256,272,343,615
4803,"ดอนเมือง","เขตดอนเมือง",103604,"เต็นบริเวณลานกิจกรรมโรงเรียนประชาอุทิศ",78,204,293,335,628
4804,"ดอนเมือง","เขตดอนเมือง",103604,"เต็นบริเวณลานกิจกรรมโรงเรียนประชาอุทิศ",79,323,307,389,696
4805,"ดอนเมือง","เขตดอนเมือง",103604,"เต็นบริเวณลานกิจกรรมโรงเรียนประชาอุทิศ",80,262,289,359,648
4806,"ดอนเมือง","เขตดอนเมือง",103604,"เต็นบริเวณลานกิจกรรมโรงเรียนประชาอุทิศ",81,200,282,338,620
4807,"ดอนเมือง","เขตดอนเมือง",103604,"เต็นบริเวณลานกิจกรรมโรงเรียนประชาอุทิศ",82,234,308,350,658
4808,"ดอนเมือง","เขตดอนเมือง",103604,"เต็นบริเวณลานกิจกรรมโรงเรียนประชาอุทิศ",83,220,280,356,636
4809,"ดอนเมือง","เขตดอนเมือง",103604,"เต็นบริเวณลานกิจกรรมโรงเรียนประชาอุทิศ",84,306,293,366,659
4810,"ดอนเมือง","เขตดอนเมือง",103604,"เต็นบริเวณลานกิจกรรมโรงเรียนประชาอุทิศ",85,391,324,387,711
4811,"ดอนเมือง","เขตดอนเมือง",103604,"เต็นท์บริเวณลานกีฬาหมู่บ้านศิริสุข",86,286,289,405,694
4812,"ดอนเมือง","เขตดอนเมือง",103604,"เต็นท์บริเวณลานกีฬาหมู่บ้านศิริสุข",87,326,318,389,707
4813,"ดอนเมือง","เขตดอนเมือง",103604,"เต็นท์บริเวณลานกีฬาหมู่บ้านศิริสุข",88,258,283,363,646
4814,"ดอนเมือง","เขตดอนเมือง",103604,"เต็นท์บริเวณลานกีฬาหมู่บ้านศิริสุข",89,347,302,363,665
4815,"ดอนเมือง","เขตดอนเมือง",103604,"เต็นท์บริเวณลานกีฬาหมู่บ้านศิริสุข",90,345,312,389,701
4816,"ดอนเมือง","เขตดอนเมือง",103604,"เต็นท์บริเวณลานกีฬาหมู่บ้านศิริสุข",91,351,298,352,650
4817,"ดอนเมือง","เขตดอนเมือง",103604,"เต็นท์บริเวณลานกีฬาหมู่บ้านศิริสุข",92,239,333,353,686
4818,"ดอนเมือง","เขตดอนเมือง",103604,"เต็นท์บริเวณลานกีฬาหมู่บ้านศิริสุข",93,238,312,354,666
4819,"ดอนเมือง","เขตดอนเมือง",103604,"เต็นท์บริเวณลานกีฬาหมู่บ้านศิริสุข",94,242,278,370,648
4820,"ดอนเมือง","เขตดอนเมือง",103604,"เต็นท์บริเวณลานกีฬาหมู่บ้านศิริสุข",95,250,314,359,673
4821,"สนามบิน","เขตดอนเมือง",103605,"เต็นท์บริเวณตลาดเสริมเพิ่มพูน",1,138,201,213,414
4822,"สนามบิน","เขตดอนเมือง",103605,"เต็นท์บริเวณตลาดเสริมเพิ่มพูน",2,160,192,240,432
4823,"สนามบิน","เขตดอนเมือง",103605,"เต็นท์บริเวณหมู่บ้านธนินทร (บ้านหนังสือ)",3,273,281,381,662
4824,"สนามบิน","เขตดอนเมือง",103605,"เต็นท์บริเวณหมู่บ้านธนินทร (บ้านหนังสือ)",4,237,270,413,683
4825,"สนามบิน","เขตดอนเมือง",103605,"เต็นท์บริเวณหมู่บ้านธนินทร (บ้านหนังสือ)",5,279,298,391,689
4826,"สนามบิน","เขตดอนเมือง",103605,"เต็นท์บริเวณหมู่บ้านอยู่เจริญ",6,258,270,334,604
4827,"สนามบิน","เขตดอนเมือง",103605,"เต็นท์บริเวณหมู่บ้านอยู่เจริญ",7,244,239,343,582
4828,"สนามบิน","เขตดอนเมือง",103605,"เต็นท์บริเวณหมู่บ้านอยู่เจริญ",8,265,287,351,638
4829,"สนามบิน","เขตดอนเมือง",103605,"เต็นท์บริเวณหน้าหมู่บ้านเดอะคอนเนค 3",9,189,209,247,456
4830,"สนามบิน","เขตดอนเมือง",103605,"เต็นท์บริเวณหน้าหมู่บ้านเดอะคอนเนค 3",10,291,227,310,537
4831,"สนามบิน","เขตดอนเมือง",103605,"เต็นท์บริเวณที่ทำการชุมชนหมู่บ้านพิพรพงษ์ 1 (ซอย 6)",11,177,261,295,556
4832,"สนามบิน","เขตดอนเมือง",103605,"เต็นท์บริเวณที่ทำการชุมชนหมู่บ้านพิพรพงษ์ 1 (ซอย 6)",12,206,220,276,496
4833,"สนามบิน","เขตดอนเมือง",103605,"เต็นท์บริเวณสนามยิ่งโอฬาร (หมู่บ้านยิ่งโอฬาร)",13,276,298,332,630
4834,"สนามบิน","เขตดอนเมือง",103605,"เต็นท์โรงเรียนพหลโยธิน",14,242,264,324,588
4835,"สนามบิน","เขตดอนเมือง",103605,"เต็นท์บริเวณลานอเนกประสงค์หมู่บ้านวังทอง",15,308,295,406,701
4836,"สนามบิน","เขตดอนเมือง",103605,"เต็นท์บริเวณลานอเนกประสงค์หมู่บ้านวังทอง",16,252,306,374,680
4837,"สนามบิน","เขตดอนเมือง",103605,"เต็นท์บริเวณที่ทำการชุมชนหมู่บ้านพิพรพงษ์ 2 (ซอย 3)",17,363,381,458,839
4838,"สนามบิน","เขตดอนเมือง",103605,"เต็นท์บริเวณที่ทำการชุมชนหมู่บ้านศุภลักษณ์ (ซอย 8)",18,280,285,392,677
4839,"สนามบิน","เขตดอนเมือง",103605,"เต็นท์บริเวณหมู่บ้านบัณฑิตโฮม",19,284,265,343,608
4840,"สนามบิน","เขตดอนเมือง",103605,"เต็นท์บริเวณหน้าโรงอาหารกรมขนส่งทหารอากาศ",20,144,221,243,464
4841,"สนามบิน","เขตดอนเมือง",103605,"เต็นท์บริเวณหน้าโรงอาหารกรมขนส่งทหารอากาศ",21,159,238,259,497
4842,"สนามบิน","เขตดอนเมือง",103605,"เต็นท์บริเวณลานขนถ่ายวัสดุ แผนกรถกิจการพิเศษ กรมขนส่งทหารอากาศ",22,3,706,0,706
4843,"สนามบิน","เขตดอนเมือง",103605,"เต็นท์บริเวณลานขนถ่ายวัสดุ แผนกรถกิจการพิเศษกรมขนส่งทหารอากาศ",23,239,458,169,627
4844,"สนามบิน","เขตดอนเมือง",103605,"เต็นท์บริเวณลานขนถ่ายวัสดุ แผนกรถกิจการพิเศษกรมขนส่งทหารอากาศ",24,201,427,166,593
4845,"สนามบิน","เขตดอนเมือง",103605,"เต็นท์บริเวณลานขนถ่ายวัสดุ แผนกรถกิจการพิเศษกรมขนส่งทหารอากาศ",25,1,1086,0,1086
4846,"สนามบิน","เขตดอนเมือง",103605,"เต็นท์บริเวณลานขนถ่ายวัสดุ แผนกรถกิจการพิเศษกรมขนส่งทหารอากาศ",26,1,714,0,714
4847,"สนามบิน","เขตดอนเมือง",103605,"เต็นท์บริเวณลานขนถ่ายวัสดุ แผนกรถกิจการพิเศษกรมขนส่งทหารอากาศ",27,1,696,0,696
4848,"สนามบิน","เขตดอนเมือง",103605,"เต็นท์บริเวณชุมสายโทรศัพท์ดอนเมือง (บมจ.ที โอ ที)",28,265,279,344,623
4849,"สนามบิน","เขตดอนเมือง",103605,"เต็นท์บริเวณชุมสายโทรศัพท์ดอนเมือง (บมจ.ที โอ ที)",29,430,339,420,759
4850,"สนามบิน","เขตดอนเมือง",103605,"เต็นท์บริเวณชุมสายโทรศัพท์ดอนเมือง (บมจ.ที โอ ที)",30,364,351,431,782
4851,"ทุ่งพญาไท","เขตราชเทวี",103701,"เต็นท์บริเวณสวนพระราม 6 ปากซอยสวนเงิน",1,132,287,491,778
4852,"ทุ่งพญาไท","เขตราชเทวี",103701,"เต็นท์บนทางเท้าซอยเสนารักษ์ (ราชวิถี 15)",2,4,364,269,633
4853,"ทุ่งพญาไท","เขตราชเทวี",103701,"เต็นท์บนทางเท้าซอยเสนารักษ์ (ราชวิถี 15)",3,163,465,159,624
4854,"ทุ่งพญาไท","เขตราชเทวี",103701,"เต็นท์บนทางเท้าซอยเสนารักษ์ (ราชวิถี 15)",4,4,60,585,645
4855,"ทุ่งพญาไท","เขตราชเทวี",103701,"เต็นท์บนทางเท้าซอยเสนารักษ์ (ราชวิถี 15)",5,299,278,318,596
4856,"ทุ่งพญาไท","เขตราชเทวี",103701,"เต็นท์บนทางเท้าซอยเสนารักษ์ (ราชวิถี 15)",6,329,319,344,663
4857,"ทุ่งพญาไท","เขตราชเทวี",103701,"เต็นท์บนทางเท้าซอยเสนารักษ์ (ราชวิถี 15)",7,259,307,290,597
4858,"ทุ่งพญาไท","เขตราชเทวี",103701,"วัดอภัยทายาราม",8,133,233,281,514
4859,"ทุ่งพญาไท","เขตราชเทวี",103701,"อาคารหอพักแพทย์พยาบาล (ตึกใหม่) โรงพยาบาลราชวิถี",9,2,33,398,431
4860,"ทุ่งพญาไท","เขตราชเทวี",103701,"อาคารหอพักแพทย์พยาบาล (ตึกใหม่) โรงพยาบาลราชวิถี",10,249,280,206,486
4861,"ทุ่งพญาไท","เขตราชเทวี",103701,"โรงเรียนพญาไท",11,223,278,230,508
4862,"ทุ่งพญาไท","เขตราชเทวี",103701,"โรงเรียนพญาไท",12,168,262,237,499
4863,"ทุ่งพญาไท","เขตราชเทวี",103701,"โรงเรียนพญาไท",13,288,192,270,462
4864,"ทุ่งพญาไท","เขตราชเทวี",103701,"เต็นท์หน้าอาคารฝ่ายการคลัง สำนักป้องกันและบรรเทาสาธารณภัย",14,235,430,195,625
4865,"ทุ่งพญาไท","เขตราชเทวี",103701,"เต็นท์หน้าอาคารฝ่ายการคลัง สำนักป้องกันและบรรเทาสาธารณภัย",15,317,357,239,596
4866,"ทุ่งพญาไท","เขตราชเทวี",103701,"เต็นท์หน้าอาคารฝ่ายการคลัง สำนักป้องกันและบรรเทาสาธารณภัย",16,365,336,269,605
4867,"ทุ่งพญาไท","เขตราชเทวี",103701,"โรงจอดรถอาคารฝ่ายการคลัง สำนักป้องกันและบรรเทาสาธารณภัย",17,335,314,297,611
4868,"ทุ่งพญาไท","เขตราชเทวี",103701,"เต็นท์ในลานกีฬาปากซอยมั่นสิน 3",18,132,232,253,485
4869,"ทุ่งพญาไท","เขตราชเทวี",103701,"เต็นท์ในลานกีฬาปากซอยมั่นสิน 3",19,162,240,261,501
4870,"ทุ่งพญาไท","เขตราชเทวี",103701,"เต็นท์บริเวณลานจอดรถสำนักงานนโยบายและแผนการขนส่งและจราจร",20,126,291,324,615
4871,"ทุ่งพญาไท","เขตราชเทวี",103701,"เต็นท์ในสนามเด็กเล่นบ้านพักรถไฟจิตรลดา",21,112,262,234,496
4872,"ทุ่งพญาไท","เขตราชเทวี",103701,"ด้านหน้าอาคารบริษัทเอ็กมี่ จำกัด",22,178,255,325,580
4873,"ทุ่งพญาไท","เขตราชเทวี",103701,"เต็นท์บริเวณบริษัทเอ็กมี่ จำกัด",23,220,279,384,663
4874,"ทุ่งพญาไท","เขตราชเทวี",103701,"เต็นท์บริเวณบริษัทเอ็กมี่ จำกัด",24,224,281,369,650
4875,"ทุ่งพญาไท","เขตราชเทวี",103701,"เต็นท์บริเวณบริษัทเอ็กมี่ จำกัด",25,153,297,338,635
4876,"ทุ่งพญาไท","เขตราชเทวี",103701,"โรงอาหารโรงเรียนสันติราษฎร์วิทยาลัย",26,225,250,265,515
4877,"ทุ่งพญาไท","เขตราชเทวี",103701,"โรงอาหารโรงเรียนสันติราษฎร์วิทยาลัย",27,216,194,288,482
4878,"ทุ่งพญาไท","เขตราชเทวี",103701,"โรงอาหารโรงเรียนสันติราษฎร์วิทยาลัย",28,192,200,264,464
4879,"ถนนพญาไท","เขตราชเทวี",103702,"เต็นท์บริเวณเกาะพญาไท",1,397,307,384,691
4880,"ถนนพญาไท","เขตราชเทวี",103702,"เต็นท์บนทางเท้าหน้าประตูโรงเรียนศรีอยุธยา ในพระอุปถัมภ์ฯ  (ประตูด้านถนนรางน้ำ)",2,258,301,396,697
4881,"ถนนพญาไท","เขตราชเทวี",103702,"เต็นท์บริเวณโรงเรียนศรีอยุธยา ในพระอุปถัมภ์ฯ(ประตูด้านถนนศรีอยุธยา)",3,368,265,371,636
4882,"ถนนพญาไท","เขตราชเทวี",103702,"เต็นท์บริเวณโรงเรียนศรีอยุธยา ในพระอุปถัมภ์ฯ (ประตูด้านถนนศรีอยุธยา)",4,377,248,349,597
4883,"ถนนพญาไท","เขตราชเทวี",103702,"เต็นท์บริเวณโรงเรียนศรีอยุธยา ในพระอุปถัมภ์ฯ(ประตูด้านถนนศรีอยุธยา)",5,398,279,340,619
4884,"ถนนพญาไท","เขตราชเทวี",103702,"อาคารวิทยาลัยเทคโนโลยีสยามธุรกิจในพระอุปถัมภ์ฯ",6,205,184,254,438
4885,"ถนนพญาไท","เขตราชเทวี",103702,"อาคารวิทยาลัยเทคโนโลยีสยามธุรกิจในพระอุปถัมภ์ฯ",7,134,194,224,418
4886,"ถนนพญาไท","เขตราชเทวี",103702,"เต็นท์บริเวณลานจอดรถ กรมปศุสัตว์",8,377,286,424,710
4887,"ถนนพญาไท","เขตราชเทวี",103702,"เต็นท์บริเวณลานจอดรถ กรมปศุสัตว์",9,493,275,454,729
4888,"ถนนพญาไท","เขตราชเทวี",103702,"ลานจอดรถ โรงเรียนเสริมสวยเกศสยาม (เดิม)",10,475,325,432,757
4889,"ถนนพญาไท","เขตราชเทวี",103702,"ลานจอดรถ โรงเรียนเสริมสวยเกศสยาม (เดิม)",11,319,344,384,728
4890,"ถนนพญาไท","เขตราชเทวี",103702,"อาคารจุลดิศ 1 ชั้นล่าง",12,239,256,290,546
4891,"ถนนพญาไท","เขตราชเทวี",103702,"อาคารจุลดิศ 1 ชั้นล่าง",13,273,239,308,547
4892,"ถนนเพชรบุรี","เขตราชเทวี",103703,"โรงเรียนสมาคมสตรีไทย",1,138,176,232,408
4893,"ถนนเพชรบุรี","เขตราชเทวี",103703,"โรงเรียนสมาคมสตรีไทย",2,86,199,207,406
4894,"ถนนเพชรบุรี","เขตราชเทวี",103703,"ศาลาวรลักษณาวดี วัดพระยายัง",3,171,226,308,534
4895,"ถนนเพชรบุรี","เขตราชเทวี",103703,"ศาลาวรลักษณาวดี วัดพระยายัง",4,190,224,290,514
4896,"ถนนเพชรบุรี","เขตราชเทวี",103703,"ศาลาวรลักษณาวดี วัดพระยายัง",5,168,253,292,545
4897,"ถนนเพชรบุรี","เขตราชเทวี",103703,"โรงเรียนกิ่งเพชร",6,184,322,333,655
4898,"ถนนเพชรบุรี","เขตราชเทวี",103703,"โรงเรียนกิ่งเพชร",7,151,318,337,655
4899,"ถนนเพชรบุรี","เขตราชเทวี",103703,"โรงเรียนกิ่งเพชร",8,160,294,353,647
4900,"ถนนเพชรบุรี","เขตราชเทวี",103703,"โรงเรียนกิ่งเพชร",9,160,327,382,709
4901,"ถนนเพชรบุรี","เขตราชเทวี",103703,"โรงเรียนกิ่งเพชร",10,181,343,333,676
4902,"ถนนเพชรบุรี","เขตราชเทวี",103703,"โรงเรียนกิ่งเพชร",11,393,268,365,633
4903,"ถนนเพชรบุรี","เขตราชเทวี",103703,"โรงเรียนกิ่งเพชร",12,193,296,362,658
4904,"ถนนเพชรบุรี","เขตราชเทวี",103703,"เต็นท์บริเวณโรงเรียนสัมมาชีวศิลป",13,222,279,353,632
4905,"ถนนเพชรบุรี","เขตราชเทวี",103703,"เต็นท์บริเวณโรงเรียนสัมมาชีวศิลป",14,203,295,353,648
4906,"ถนนเพชรบุรี","เขตราชเทวี",103703,"โรงอาหารโรงเรียนสัมมาชีวศิลป",15,143,267,301,568
4907,"ถนนเพชรบุรี","เขตราชเทวี",103703,"โรงอาหารโรงเรียนสัมมาชีวศิลป",16,279,228,325,553
4908,"ถนนเพชรบุรี","เขตราชเทวี",103703,"โรงอาหารโรงเรียนสัมมาชีวศิลป",17,231,232,298,530
4909,"ถนนเพชรบุรี","เขตราชเทวี",103703,"เต็นท์บนทางเท้าหน้าบันไดสถานีรถไฟฟ้า (ราชเทวี)",18,138,145,187,332
4910,"ถนนเพชรบุรี","เขตราชเทวี",103703,"เต็นท์บริเวณลานจอดรถเล้งนาฬิกา",19,428,226,335,561
4911,"ถนนเพชรบุรี","เขตราชเทวี",103703,"เต็นท์บริเวณลานจอดรถเล้งนาฬิกา",20,341,230,326,556
4912,"ถนนเพชรบุรี","เขตราชเทวี",103703,"เต็นท์บริเวณลานจอดรถเล้งนาฬิกา",21,278,246,305,551
4913,"มักกะสัน","เขตราชเทวี",103704,"โรงเรียนวัดทัศนารุณสุนทริการาม",1,286,278,316,594
4914,"มักกะสัน","เขตราชเทวี",103704,"โรงเรียนวัดทัศนารุณสุนทริการาม",2,173,266,308,574
4915,"มักกะสัน","เขตราชเทวี",103704,"เต็นท์ในสวนรมย์ราชเทวี",3,301,284,340,624
4916,"มักกะสัน","เขตราชเทวี",103704,"เต็นท์ในสวนรมย์ราชเทวี",4,203,296,340,636
4917,"มักกะสัน","เขตราชเทวี",103704,"เต็นท์ในสวนรมย์ราชเทวี",5,148,256,251,507
4918,"มักกะสัน","เขตราชเทวี",103704,"เต็นท์ในสวนรมย์ราชเทวี",6,145,221,281,502
4919,"มักกะสัน","เขตราชเทวี",103704,"เต็นท์บริเวณลานจอดรถ บริษัท บางกอกไตรวิชั่น จำกัด (คลีโอ)",7,164,293,323,616
4920,"มักกะสัน","เขตราชเทวี",103704,"เต็นท์บริเวณลานจอดรถ บริษัท บางกอกไตรวิชั่น จำกัด (คลีโอ)",8,552,324,369,693
4921,"มักกะสัน","เขตราชเทวี",103704,"เต็นท์บริเวณลานจอดรถ บริษัท บางกอกไตรวิชั่น จำกัด (คลีโอ)",9,274,291,352,643
4922,"มักกะสัน","เขตราชเทวี",103704,"บริเวณชั้นล่างอาคารลานจอดรถธนาคารไทยพาณิชย์(สำนักงานชิดลม)",10,189,166,214,380
4923,"มักกะสัน","เขตราชเทวี",103704,"เต็นท์บริเวณลานจอดรถตลาดธรรมโรจน์",11,170,207,306,513
4924,"มักกะสัน","เขตราชเทวี",103704,"เต็นท์บริเวณลานจอดรถตลาดธรรมโรจน์",12,158,233,270,503
4925,"มักกะสัน","เขตราชเทวี",103704,"เต็นท์บริเวณลานจอดรถตลาดธรรมโรจน์",13,193,234,278,512
4926,"มักกะสัน","เขตราชเทวี",103704,"โรงเรียนวัดดิสหงสาราม",14,160,255,276,531
4927,"มักกะสัน","เขตราชเทวี",103704,"โรงเรียนวัดดิสหงสาราม",15,289,263,275,538
4928,"มักกะสัน","เขตราชเทวี",103704,"โรงเรียนวัดดิสหงสาราม",16,127,270,277,547
4929,"มักกะสัน","เขตราชเทวี",103704,"โรงเรียนมักกะสันพิทยา",17,222,295,126,421
4930,"มักกะสัน","เขตราชเทวี",103704,"โรงเรียนมักกะสันพิทยา",18,260,327,165,492
4931,"มักกะสัน","เขตราชเทวี",103704,"โถงชั้นล่างอาคารมารี โรงเรียนเซนต์ดอมินิก",19,384,314,395,709
4932,"มักกะสัน","เขตราชเทวี",103704,"โถงชั้นล่างอาคารมารี โรงเรียนเซนต์ดอมินิก",20,563,302,412,714
4933,"มักกะสัน","เขตราชเทวี",103704,"เต็นท์ในลานกีฬา โรงพยาบาลบุรฉัตรไชยากร (โรงพยาบาลรถไฟ)",21,239,304,279,583
4934,"มักกะสัน","เขตราชเทวี",103704,"เต็นท์ในลานกีฬา โรงพยาบาลบุรฉัตรไชยากร (โรงพยาบาลรถไฟ)",22,238,296,288,584
4935,"มักกะสัน","เขตราชเทวี",103704,"เต็นท์บนทางเท้าปากซอยเพชรบุรี 29 (ตลาดนีออน)",23,169,214,239,453
4936,"ลาดพร้าว","เขตลาดพร้าว",103801,"โรงเรียนคลองทรงกระเทียม (ซอยนาคนิวาส 2)",1,226,324,346,670
4937,"ลาดพร้าว","เขตลาดพร้าว",103801,"โรงเรียนคลองทรงกระเทียม (ซอยนาคนิวาส 2)",2,243,303,369,672
4938,"ลาดพร้าว","เขตลาดพร้าว",103801,"โรงเรียนคลองทรงกระเทียม (ซอยนาคนิวาส 2)",3,259,281,390,671
4939,"ลาดพร้าว","เขตลาดพร้าว",103801,"เต็นท์ปากซอยสังคมสงเคราะห์ 20",4,231,325,409,734
4940,"ลาดพร้าว","เขตลาดพร้าว",103801,"เต็นท์ปากซอยสังคมสงเคราะห์ 20",5,215,308,380,688
4941,"ลาดพร้าว","เขตลาดพร้าว",103801,"โรงเรียนฤทธิไกร (ซอยลาดพร้าววังหิน 1)",6,297,252,349,601
4942,"ลาดพร้าว","เขตลาดพร้าว",103801,"โรงเรียนฤทธิไกร (ซอยลาดพร้าววังหิน 1)",7,205,279,322,601
4943,"ลาดพร้าว","เขตลาดพร้าว",103801,"โรงเรียนฤทธิไกร (ซอยลาดพร้าววังหิน 1)",8,184,270,337,607
4944,"ลาดพร้าว","เขตลาดพร้าว",103801,"โรงเรียนฤทธิไกร (ซอยลาดพร้าววังหิน 1)",9,203,269,334,603
4945,"ลาดพร้าว","เขตลาดพร้าว",103801,"เต็นท์บริเวณวัดลาดพร้าว (ซอยลาดพร้าววังหิน 23)",10,257,312,345,657
4946,"ลาดพร้าว","เขตลาดพร้าว",103801,"เต็นท์บริเวณวัดลาดพร้าว (ซอยลาดพร้าววังหิน 23)",11,411,283,392,675
4947,"ลาดพร้าว","เขตลาดพร้าว",103801,"เต็นท์บริเวณวัดลาดพร้าว (ซอยลาดพร้าววังหิน 23)",12,249,276,351,627
4948,"ลาดพร้าว","เขตลาดพร้าว",103801,"เต็นท์บริเวณวัดลาดพร้าว (ซอยลาดพร้าววังหิน 23)",13,440,262,355,617
4949,"ลาดพร้าว","เขตลาดพร้าว",103801,"เต็นท์บริเวณวัดลาดพร้าว (ซอยลาดพร้าววังหิน 23)",14,237,273,364,637
4950,"ลาดพร้าว","เขตลาดพร้าว",103801,"ศูนย์รับฝากไปรษณีย์จำนวนมาก (ตรงข้ามซอยลาดพร้าววังหิน 51)",15,279,337,415,752
4951,"ลาดพร้าว","เขตลาดพร้าว",103801,"ศูนย์รับฝากไปรษณีย์จำนวนมาก (ตรงข้ามซอยลาดพร้าววังหิน 51)",16,259,325,440,765
4952,"ลาดพร้าว","เขตลาดพร้าว",103801,"เต็นท์บริเวณวัดสิริกมลาวาส (ถนนลาดพร้าววังหิน)",17,299,304,386,690
4953,"ลาดพร้าว","เขตลาดพร้าว",103801,"เต็นท์บริเวณวัดสิริกมลาวาส (ถนนลาดพร้าววังหิน)",18,262,289,387,676
4954,"ลาดพร้าว","เขตลาดพร้าว",103801,"เต็นท์บริเวณวัดสิริกมลาวาส (ถนนลาดพร้าววังหิน)",19,276,299,383,682
4955,"ลาดพร้าว","เขตลาดพร้าว",103801,"เต็นท์บริเวณวัดสิริกมลาวาส (ถนนลาดพร้าววังหิน)",20,232,330,371,701
4956,"ลาดพร้าว","เขตลาดพร้าว",103801,"เต็นท์บริเวณวัดสิริกมลาวาส (ถนนลาดพร้าววังหิน)",21,306,292,393,685
4957,"ลาดพร้าว","เขตลาดพร้าว",103801,"โรงเรียนเทพวิทยา (ถนนเสนานิคม 1)",22,198,239,332,571
4958,"ลาดพร้าว","เขตลาดพร้าว",103801,"โรงเรียนเทพวิทยา (ถนนเสนานิคม 1)",23,251,248,339,587
4959,"ลาดพร้าว","เขตลาดพร้าว",103801,"โรงเรียนเทพวิทยา (ถนนเสนานิคม 1)",24,223,268,312,580
4960,"ลาดพร้าว","เขตลาดพร้าว",103801,"โรงเรียนเทพวิทยา (ถนนเสนานิคม 1)",25,317,332,298,630
4961,"ลาดพร้าว","เขตลาดพร้าว",103801,"เต็นท์ลานกีฬาหมู่บ้าน ช.อมรพันธุ์ 9 (ซอยเสนานิคม 1 ซอย 40)",26,245,257,391,648
4962,"ลาดพร้าว","เขตลาดพร้าว",103801,"เต็นท์ลานกีฬาหมู่บ้าน ช.อมรพันธุ์ 9 (ซอยเสนานิคม 1 ซอย 40)",27,241,270,365,635
4963,"ลาดพร้าว","เขตลาดพร้าว",103801,"เต็นท์ลานกีฬาหมู่บ้าน ช.อมรพันธุ์ 9 (ซอยเสนานิคม 1 ซอย 40)",28,224,253,357,610
4964,"ลาดพร้าว","เขตลาดพร้าว",103801,"เต็นท์ลานกีฬาหมู่บ้าน ช.อมรพันธุ์ 9 (ซอยเสนานิคม 1 ซอย 40)",29,242,272,368,640
4965,"ลาดพร้าว","เขตลาดพร้าว",103801,"เต็นท์ลานกีฬาหมู่บ้าน ช.อมรพันธุ์ 9 (ซอยเสนานิคม 1 ซอย 40)",30,229,281,371,652
4966,"ลาดพร้าว","เขตลาดพร้าว",103801,"เต็นท์ลานกีฬาหมู่บ้าน ช.อมรพันธุ์ 9 (ซอยเสนานิคม 1 ซอย 40)",31,246,275,380,655
4967,"ลาดพร้าว","เขตลาดพร้าว",103801,"เต็นท์บริเวณหมู่บ้านเสนานิเวศน์ โครงการ 1(ซอยเสนานิเวศน์ 112)",32,190,231,295,526
4968,"ลาดพร้าว","เขตลาดพร้าว",103801,"เต็นท์บริเวณหมู่บ้านเสนานิเวศน์ โครงการ 1(ซอยเสนานิเวศน์ 112)",33,175,212,318,530
4969,"ลาดพร้าว","เขตลาดพร้าว",103801,"เต็นท์บริเวณหมู่บ้านเสนานิเวศน์ โครงการ 1(ซอยเสนานิเวศน์ 112)",34,163,233,294,527
4970,"ลาดพร้าว","เขตลาดพร้าว",103801,"เต็นท์ลานกีฬาในหมู่บ้านเอื้อประชา (ซอยโชคชัย 4 ซอย 14)",35,247,252,358,610
4971,"ลาดพร้าว","เขตลาดพร้าว",103801,"เต็นท์หน้าหมู่บ้านโอษธีศ รุ่น 3 (ซอยโชคชัย 4 ซอย 18)",36,336,280,389,669
4972,"ลาดพร้าว","เขตลาดพร้าว",103801,"เต็นท์หน้าหมู่บ้านโอษธีศ รุ่น 3 (ซอยโชคชัย 4 ซอย 18)",37,237,300,366,666
4973,"ลาดพร้าว","เขตลาดพร้าว",103801,"ที่จอดรถกองบังคับการปฏิบัติการพิเศษ (กองปราบปราม 2 ถนนโชคชัย 4)",38,303,256,364,620
4974,"ลาดพร้าว","เขตลาดพร้าว",103801,"ที่จอดรถกองบังคับการปฏิบัติการพิเศษ (กองปราบปราม 2 ถนนโชคชัย 4)",39,224,262,369,631
4975,"ลาดพร้าว","เขตลาดพร้าว",103801,"ที่จอดรถกองบังคับการปฏิบัติการพิเศษ (กองปราบปราม 2 ถนนโชคชัย 4)",40,221,262,344,606
4976,"ลาดพร้าว","เขตลาดพร้าว",103801,"ที่จอดรถกองบังคับการปฏิบัติการพิเศษ (กองปราบปราม 2 ถนนโชคชัย 4)",41,250,293,336,629
4977,"ลาดพร้าว","เขตลาดพร้าว",103801,"ที่จอดรถกองบังคับการปฏิบัติการพิเศษ (กองปราบปราม 2 ถนนโชคชัย 4)",42,264,274,352,626
4978,"ลาดพร้าว","เขตลาดพร้าว",103801,"ที่จอดรถกองบังคับการปฏิบัติการพิเศษ (กองปราบปราม 2 ถนนโชคชัย 4)",43,280,349,282,631
4979,"ลาดพร้าว","เขตลาดพร้าว",103801,"เต็นท์บริเวณบริษัทพิคโก้ ฟาร์มา จำกัด (ซอยโชคชัย 4 ซอย 31/1)",44,258,307,425,732
4980,"ลาดพร้าว","เขตลาดพร้าว",103801,"เต็นท์หน้าโรงเจตำหนักพระแม่กวนอิม โชคชัย 4(ซอยโชคชัย 4 ซอย 39)",45,258,286,390,676
4981,"ลาดพร้าว","เขตลาดพร้าว",103801,"เต็นท์หน้าโรงเจตำหนักพระแม่กวนอิม โชคชัย 4(ซอยโชคชัย 4 ซอย 39)",46,340,305,360,665
4982,"ลาดพร้าว","เขตลาดพร้าว",103801,"เต็นท์หน้าโรงเจตำหนักพระแม่กวนอิม โชคชัย 4(ซอยโชคชัย 4 ซอย 39)",47,349,305,403,708
4983,"ลาดพร้าว","เขตลาดพร้าว",103801,"เต็นท์หน้าโรงเจตำหนักพระแม่กวนอิม โชคชัย 4(ซอยโชคชัย 4 ซอย 39)",48,255,282,389,671
4984,"ลาดพร้าว","เขตลาดพร้าว",103801,"เต็นท์หน้าโรงเจตำหนักพระแม่กวนอิม โชคชัย 4(ซอยโชคชัย 4 ซอย 39)",49,262,277,396,673
4985,"ลาดพร้าว","เขตลาดพร้าว",103801,"เต็นท์บริเวณร้านล้างรถ 365 คาร์แคร์ (ซอยโชคชัย 4 ซอย 50)",50,268,315,404,719
4986,"ลาดพร้าว","เขตลาดพร้าว",103801,"ลานอเนกประสงค์ชุมชนสังสิทธิ์ (ซอยโชคชัย 4 ซอย 50)",51,311,297,411,708
4987,"ลาดพร้าว","เขตลาดพร้าว",103801,"ลานอเนกประสงค์ชุมชนสังสิทธิ์ (ซอยโชคชัย 4 ซอย 50)",52,221,290,386,676
4988,"ลาดพร้าว","เขตลาดพร้าว",103801,"เต็นท์บริเวณปากซอยหมู่บ้าน ต.รวมโชค (ซอยโชคชัย 4 ซอย 54)",53,307,365,478,843
4989,"ลาดพร้าว","เขตลาดพร้าว",103801,"เต็นท์บริเวณปากซอยหมู่บ้าน ต.รวมโชค (ซอยโชคชัย 4 ซอย 54)",54,279,355,471,826
4990,"ลาดพร้าว","เขตลาดพร้าว",103801,"เต็นท์บริเวณหมู่บ้้าน ต.รวมโชค (ซอยโชคชัย 4 ซอย 54 แยก 4)",55,230,273,346,619
4991,"ลาดพร้าว","เขตลาดพร้าว",103801,"เต็นท์บริเวณหมู่บ้้าน ต.รวมโชค (ซอยโชคชัย 4 ซอย 54 แยก 4)",56,212,271,330,601
4992,"ลาดพร้าว","เขตลาดพร้าว",103801,"เต็นท์บริเวณหมู่บ้้าน ต.รวมโชค (ซอยโชคชัย 4 ซอย 54 แยก 4)",57,206,271,354,625
4993,"ลาดพร้าว","เขตลาดพร้าว",103801,"เต็นท์บริเวณหมู่บ้านโชคอนันต์ 2 (ซอยโชคชัย 4 ซอย 55 แยก 4)",58,280,346,443,789
4994,"ลาดพร้าว","เขตลาดพร้าว",103801,"ที่จอดรถธนาคารไทยพาณิชย์ สาขาโชคชัย 4(ปากซอยโชคชัย 4 ซอย 69)",59,300,312,429,741
4995,"ลาดพร้าว","เขตลาดพร้าว",103801,"ที่จอดรถธนาคารไทยพาณิชย์ สาขาโชคชัย 4(ปากซอยโชคชัย 4 ซอย 69)",60,312,311,420,731
4996,"ลาดพร้าว","เขตลาดพร้าว",103801,"ที่จอดรถธนาคารไทยพาณิชย์ สาขาโชคชัย 4(ปากซอยโชคชัย 4 ซอย 69)",61,275,348,399,747
4997,"ลาดพร้าว","เขตลาดพร้าว",103801,"เต็นท์บริเวณสุดถนนโชคชัย 4 (ใกล้ซอยโชคชัย 4 ซอย 84)",62,182,202,276,478
4998,"ลาดพร้าว","เขตลาดพร้าว",103801,"เต็นท์บริเวณสุดถนนโชคชัย 4 (ใกล้ซอยโชคชัย 4 ซอย 84)",63,215,205,287,492
4999,"ลาดพร้าว","เขตลาดพร้าว",103801,"เต็นท์ลานสอนขับรถยนต์ข้างสำนักงานเขตลาดพร้าว (ถนนนาคนิวาส)",64,305,369,405,774
5000,"ลาดพร้าว","เขตลาดพร้าว",103801,"เต็นท์ลานสอนขับรถยนต์ข้างสำนักงานเขตลาดพร้าว (ถนนนาคนิวาส)",65,296,342,403,745
5001,"ลาดพร้าว","เขตลาดพร้าว",103801,"เต็นท์ลานสอนขับรถยนต์ข้างสำนักงานเขตลาดพร้าว (ถนนนาคนิวาส)",66,232,354,390,744
5002,"ลาดพร้าว","เขตลาดพร้าว",103801,"เต็นท์ลานสอนขับรถยนต์ข้างสำนักงานเขตลาดพร้าว (ถนนนาคนิวาส)",67,161,351,394,745
5003,"ลาดพร้าว","เขตลาดพร้าว",103801,"เต็นท์ลานสอนขับรถยนต์ข้างสำนักงานเขตลาดพร้าว (ถนนนาคนิวาส)",68,256,325,396,721
5004,"ลาดพร้าว","เขตลาดพร้าว",103801,"เต็นท์ลานสอนขับรถยนต์ข้างสำนักงานเขตลาดพร้าว (ถนนนาคนิวาส)",69,286,338,405,743
5005,"ลาดพร้าว","เขตลาดพร้าว",103801,"สถานคุ้มครองและพัฒนาอาชีพบ้านเกร็ดตระการ กรุงเทพมหานคร (ซอยประดิษฐ์มนูธรรม 19)",70,321,282,355,637
5006,"ลาดพร้าว","เขตลาดพร้าว",103801,"เต็นท์บริเวณหลังตลาดนกแก้วน้อย (ซอยนาคนิวาส 33)",71,200,315,335,650
5007,"ลาดพร้าว","เขตลาดพร้าว",103801,"เต็นท์บริเวณหลังตลาดนกแก้วน้อย (ซอยนาคนิวาส 33)",72,187,310,328,638
5008,"ลาดพร้าว","เขตลาดพร้าว",103801,"เต็นท์บริเวณหลังตลาดนกแก้วน้อย (ซอยนาคนิวาส 33)",73,244,277,362,639
5009,"ลาดพร้าว","เขตลาดพร้าว",103801,"เต็นท์บริเวณหลังตลาดนกแก้วน้อย (ซอยนาคนิวาส 33)",74,251,279,374,653
5010,"ลาดพร้าว","เขตลาดพร้าว",103801,"เต็นท์บริเวณสนามเด็กเล่น ตรงข้ามซอยนาคนิวาส 37 แยก 1-8",75,223,284,322,606
5011,"ลาดพร้าว","เขตลาดพร้าว",103801,"เต็นท์บริเวณลานคอนโดดุลิยาเพลส (ซอยนาคนิวาส 37)",76,353,300,367,667
5012,"ลาดพร้าว","เขตลาดพร้าว",103801,"เต็นท์ลานกีฬาหมู่บ้านลาดพร้าววิลเลจ (ซอยนาคนิวาส 42 แยก 1)",77,160,233,241,474
5013,"ลาดพร้าว","เขตลาดพร้าว",103801,"เต็นท์ลานกีฬาหมู่บ้านลาดพร้าววิลเลจ (ซอยนาคนิวาส 42 แยก 1)",78,161,219,254,473
5014,"ลาดพร้าว","เขตลาดพร้าว",103801,"เต็นท์บริเวณหลังตลาดสี่แยกโรงไม้ (ซอยนาคนิวาส 48)",79,483,326,405,731
5015,"ลาดพร้าว","เขตลาดพร้าว",103801,"เต็นท์บริเวณหลังตลาดสี่แยกโรงไม้ (ซอยนาคนิวาส 48)",80,272,325,398,723
5016,"ลาดพร้าว","เขตลาดพร้าว",103801,"เต็นท์บริเวณหลังตลาดสี่แยกโรงไม้ (ซอยนาคนิวาส 48)",81,290,297,406,703
5017,"ลาดพร้าว","เขตลาดพร้าว",103801,"เต็นท์บริเวณหลังตลาดสี่แยกโรงไม้ (ซอยนาคนิวาส 48)",82,288,323,392,715
5018,"ลาดพร้าว","เขตลาดพร้าว",103801,"เต็นท์บริเวณหลังตลาดสี่แยกโรงไม้ (ซอยนาคนิวาส 48)",83,280,312,390,702
5019,"ลาดพร้าว","เขตลาดพร้าว",103801,"โรงเรียนเพชรถนอม (ซอยสุคนธสวัสดิ์ 10)",84,214,300,333,633
5020,"ลาดพร้าว","เขตลาดพร้าว",103801,"โรงเรียนเพชรถนอม (ซอยสุคนธสวัสดิ์ 10)",85,321,263,370,633
5021,"ลาดพร้าว","เขตลาดพร้าว",103801,"โรงเรียนเพชรถนอม (ซอยสุคนธสวัสดิ์ 10)",86,264,279,381,660
5022,"ลาดพร้าว","เขตลาดพร้าว",103801,"โรงเรียนเพชรถนอม (ซอยสุคนธสวัสดิ์ 10)",87,300,311,346,657
5023,"ลาดพร้าว","เขตลาดพร้าว",103801,"เต็นท์ในหมู่บ้านเลิศอุบล 4 รุ่น 1(ซอยนาคนิวาส 48 แยก 14-13-7)",88,219,285,340,625
5024,"ลาดพร้าว","เขตลาดพร้าว",103801,"เต็นท์ในหมู่บ้านเลิศอุบล 4 รุ่น 1(ซอยนาคนิวาส 48 แยก 14-13-7)",89,216,271,328,599
5025,"ลาดพร้าว","เขตลาดพร้าว",103801,"เต็นท์บริเวณลานจอดรถเกียรติธาดา เฮ้าส์ แอนด์ รีสอร์ท (ถนนสุคนธสวัสดิ์)",90,232,299,378,677
5026,"ลาดพร้าว","เขตลาดพร้าว",103801,"เต็นท์บริเวณลานจอดรถเกียรติธาดา เฮ้าส์ แอนด์ รีสอร์ท (ถนนสุคนธสวัสดิ์)",91,323,324,360,684
5027,"ลาดพร้าว","เขตลาดพร้าว",103801,"เต็นท์บริเวณลานจอดรถเกียรติธาดา เฮ้าส์ แอนด์ รีสอร์ท (ถนนสุคนธสวัสดิ์)",92,253,316,379,695
5028,"ลาดพร้าว","เขตลาดพร้าว",103801,"เต็นท์บริเวณลานจอดรถเกียรติธาดา เฮ้าส์ แอนด์ รีสอร์ท (ถนนสุคนธสวัสดิ์)",93,271,329,370,699
5029,"ลาดพร้าว","เขตลาดพร้าว",103801,"อาคารเฉลิมพระเกียรติฯ โรงเรียนสตรีวิทยา 2ฯ (ซอยสุคนธสวัสดิ์ 3)",94,229,351,385,736
5030,"ลาดพร้าว","เขตลาดพร้าว",103801,"อาคารเฉลิมพระเกียรติฯ โรงเรียนสตรีวิทยา 2ฯ (ซอยสุคนธสวัสดิ์ 3)",95,311,347,426,773
5031,"ลาดพร้าว","เขตลาดพร้าว",103801,"อาคารเฉลิมพระเกียรติฯ โรงเรียนสตรีวิทยา 2ฯ (ซอยสุคนธสวัสดิ์ 3)",96,248,294,376,670
5032,"ลาดพร้าว","เขตลาดพร้าว",103801,"อาคารเฉลิมพระเกียรติฯ โรงเรียนสตรีวิทยา 2ฯ (ซอยสุคนธสวัสดิ์ 3)",97,225,293,359,652
5033,"ลาดพร้าว","เขตลาดพร้าว",103801,"อาคารเฉลิมพระเกียรติฯ โรงเรียนสตรีวิทยา 2ฯ (ซอยสุคนธสวัสดิ์ 3)",98,249,319,336,655
5034,"ลาดพร้าว","เขตลาดพร้าว",103801,"อาคารเฉลิมพระเกียรติฯ โรงเรียนสตรีวิทยา 2ฯ (ซอยสุคนธสวัสดิ์ 3)",99,286,290,383,673
5035,"ลาดพร้าว","เขตลาดพร้าว",103801,"อาคารเฉลิมพระเกียรติฯ โรงเรียนสตรีวิทยา 2ฯ (ซอยสุคนธสวัสดิ์ 3)",100,338,338,403,741
5036,"ลาดพร้าว","เขตลาดพร้าว",103801,"อาคารเฉลิมพระเกียรติฯ โรงเรียนสตรีวิทยา 2ฯ (ซอยสุคนธสวัสดิ์ 3)",101,304,299,392,691
5037,"ลาดพร้าว","เขตลาดพร้าว",103801,"เต็นท์ลานจอดรถสโมสรหมู่บ้านอารียา (ซอยประเสริฐมนูกิจ 29 แยก 2)",102,407,350,472,822
5038,"ลาดพร้าว","เขตลาดพร้าว",103801,"เต็นท์ลานจอดรถสโมสรหมู่บ้านอารียา (ซอยประเสริฐมนูกิจ 29 แยก 2)",103,390,371,434,805
5039,"ลาดพร้าว","เขตลาดพร้าว",103801,"เต็นท์ลานกีฬาหมู่บ้านเฟรนชิฟ (ซอยประเสริฐมนูกิจ 29 แยก 2)",104,203,238,283,521
5040,"ลาดพร้าว","เขตลาดพร้าว",103801,"เต็นท์ลานกีฬาหมู่บ้านเฟรนชิฟ (ซอยประเสริฐมนูกิจ 29 แยก 2)",105,188,258,294,552
5041,"ลาดพร้าว","เขตลาดพร้าว",103801,"เต็นท์ลานจอดรถโรงเรียนโชคชัย (ถนนสุคนธสวัสดิ์)",106,276,318,368,686
5042,"ลาดพร้าว","เขตลาดพร้าว",103801,"เต็นท์ลานจอดรถโรงเรียนโชคชัย (ถนนสุคนธสวัสดิ์)",107,398,338,408,746
5043,"ลาดพร้าว","เขตลาดพร้าว",103801,"เต็นท์ลานจอดรถโรงเรียนโชคชัย (ถนนสุคนธสวัสดิ์)",108,358,269,396,665
5044,"ลาดพร้าว","เขตลาดพร้าว",103801,"เต็นท์ลานจอดรถโรงเรียนโชคชัย (ถนนสุคนธสวัสดิ์)",109,351,232,365,597
5045,"ลาดพร้าว","เขตลาดพร้าว",103801,"โรงเรียนลอยสายอนุสรณ์ (ซอยอยู่เย็น 1)",110,118,178,215,393
5046,"จรเข้บัว","เขตลาดพร้าว",103802,"เต็นท์ลานกีฬาสโมสรเสนานิเวศน์ โครงการ 1 (ซอยเสนานิเวศน์ 110)",1,253,308,411,719
5047,"จรเข้บัว","เขตลาดพร้าว",103802,"เต็นท์ลานกีฬาสโมสรเสนานิเวศน์ โครงการ 1 (ซอยเสนานิเวศน์ 110)",2,254,293,387,680
5048,"จรเข้บัว","เขตลาดพร้าว",103802,"เต็นท์ลานกีฬาสโมสรเสนานิเวศน์ โครงการ 1 (ซอยเสนานิเวศน์ 110)",3,234,312,376,688
5049,"จรเข้บัว","เขตลาดพร้าว",103802,"เต็นท์บริเวณหลังตลาดเสนา  (ซอยเสนานิเวศน์ 104)",4,269,292,371,663
5050,"จรเข้บัว","เขตลาดพร้าว",103802,"เต็นท์บริเวณหลังตลาดเสนา  (ซอยเสนานิเวศน์ 104)",5,260,264,386,650
5051,"จรเข้บัว","เขตลาดพร้าว",103802,"เต็นท์บริเวณหลังตลาดเสนา  (ซอยเสนานิเวศน์ 104)",6,298,265,386,651
5052,"จรเข้บัว","เขตลาดพร้าว",103802,"เต็นท์บริเวณหลังตลาดเสนา  (ซอยเสนานิเวศน์ 104)",7,222,277,369,646
5053,"จรเข้บัว","เขตลาดพร้าว",103802,"เต็นท์สนามเด็กเล่นหมู่บ้านจิรัฐติกร รุ่น 7 (ซอยประเสริฐมนูกิจ 14 แยก 13)",8,202,219,332,551
5054,"จรเข้บัว","เขตลาดพร้าว",103802,"โรงเรียนกัลยวิทย์ (ปากซอยลาดปลาเค้า 23)",9,183,233,280,513
5055,"จรเข้บัว","เขตลาดพร้าว",103802,"โรงเรียนกัลยวิทย์ (ปากซอยลาดปลาเค้า 23)",10,173,220,275,495
5056,"จรเข้บัว","เขตลาดพร้าว",103802,"เต็นท์บริเวณอู่ออโต้เทคนิคเซอร์วิส (ระหว่างซอยลาดปลาเค้า 10 - 12)",11,277,282,344,626
5057,"จรเข้บัว","เขตลาดพร้าว",103802,"เต็นท์บริเวณอู่ออโต้เทคนิคเซอร์วิส (ระหว่างซอยลาดปลาเค้า 10 - 12)",12,219,293,334,627
5058,"จรเข้บัว","เขตลาดพร้าว",103802,"เต็นท์บริเวณอู่ออโต้เทคนิคเซอร์วิส (ระหว่างซอยลาดปลาเค้า 10 - 12)",13,239,262,354,616
5059,"จรเข้บัว","เขตลาดพร้าว",103802,"เต็นท์ลานกีฬาหมู่บ้านราณี 2 (ซอยลาดปลาเค้า 42)",14,320,334,426,760
5060,"จรเข้บัว","เขตลาดพร้าว",103802,"เต็นท์ลานกีฬาหมู่บ้านราณี 2 (ซอยลาดปลาเค้า 42)",15,247,311,418,729
5061,"จรเข้บัว","เขตลาดพร้าว",103802,"เต็นท์ลานกีฬาหมู่บ้านราณี 2 (ซอยลาดปลาเค้า 42)",16,289,305,416,721
5062,"จรเข้บัว","เขตลาดพร้าว",103802,"โรงเรียนวัดลาดปลาเค้า (ถนนลาดปลาเค้า)",17,263,305,352,657
5063,"จรเข้บัว","เขตลาดพร้าว",103802,"โรงเรียนวัดลาดปลาเค้า (ถนนลาดปลาเค้า)",18,211,287,373,660
5064,"จรเข้บัว","เขตลาดพร้าว",103802,"โรงเรียนวัดลาดปลาเค้า (ถนนลาดปลาเค้า)",19,305,295,374,669
5065,"จรเข้บัว","เขตลาดพร้าว",103802,"โรงเรียนวัดลาดปลาเค้า (ถนนลาดปลาเค้า)",20,199,308,360,668
5066,"จรเข้บัว","เขตลาดพร้าว",103802,"โรงเรียนวัดลาดปลาเค้า (ถนนลาดปลาเค้า)",21,383,295,380,675
5067,"จรเข้บัว","เขตลาดพร้าว",103802,"โรงเรียนวัดลาดปลาเค้า (ถนนลาดปลาเค้า)",22,400,286,389,675
5068,"จรเข้บัว","เขตลาดพร้าว",103802,"โรงเรียนวัดลาดปลาเค้า (ถนนลาดปลาเค้า)",23,398,299,392,691
5069,"จรเข้บัว","เขตลาดพร้าว",103802,"เต็นท์บริเวณที่ทำการชุมชนหมู่บ้านเสนานิเวศน์ โครงการ 2 (ซอยประเสริฐมนูกิจ 27)",24,241,280,371,651
5070,"จรเข้บัว","เขตลาดพร้าว",103802,"เต็นท์บริเวณที่ทำการชุมชนหมู่บ้านเสนานิเวศน์ โครงการ 2 (ซอยประเสริฐมนูกิจ 27)",25,234,310,337,647
5071,"จรเข้บัว","เขตลาดพร้าว",103802,"เต็นท์บริเวณที่ทำการชุมชนหมู่บ้านเสนานิเวศน์ โครงการ 2 (ซอยประเสริฐมนูกิจ 27)",26,237,276,376,652
5072,"จรเข้บัว","เขตลาดพร้าว",103802,"เต็นท์บริเวณที่ทำการชุมชนหมู่บ้านเสนานิเวศน์ โครงการ 2 (ซอยประเสริฐมนูกิจ 27)",27,247,301,350,651
5073,"จรเข้บัว","เขตลาดพร้าว",103802,"เต็นท์บริเวณปั๊มน้ำมัน พีที (ซอยประเสริฐมนูกิจ 29)",28,291,314,379,693
5074,"จรเข้บัว","เขตลาดพร้าว",103802,"เต็นท์บริเวณปั๊มน้ำมัน พีที (ซอยประเสริฐมนูกิจ 29)",29,335,281,405,686
5075,"จรเข้บัว","เขตลาดพร้าว",103802,"เต็นท์บริเวณปั๊มน้ำมัน พีที (ซอยประเสริฐมนูกิจ 29)",30,340,285,408,693
5076,"จรเข้บัว","เขตลาดพร้าว",103802,"เต็นท์บริเวณปั๊มน้ำมัน พีที (ซอยประเสริฐมนูกิจ 29)",31,276,311,382,693
5077,"จรเข้บัว","เขตลาดพร้าว",103802,"ศูนย์พัฒนาเด็กเล็กก่อนวัยเรียน ชุมชนหมู่บ้านเนียมกล่ำสามัคคี (ซอยประเสริฐมนูกิจ 29 แยก 8)",32,272,358,464,822
5078,"จรเข้บัว","เขตลาดพร้าว",103802,"ศูนย์พัฒนาเด็กเล็กก่อนวัยเรียน ชุมชนหมู่บ้านเนียมกล่ำสามัคคี (ซอยประเสริฐมนูกิจ 29 แยก 8)",33,250,372,444,816
5079,"คลองเตยเหนือ","เขตวัฒนา",103901,"ใต้อาคารด้านหน้าธนาคารกรุงไทย สำนักงานใหญ่ระหว่างสุขุมวิท 1-3",1,260,231,315,546
5080,"คลองเตยเหนือ","เขตวัฒนา",103901,"ใต้อาคารด้านหน้าธนาคารกรุงไทย สำนักงานใหญ่ระหว่างสุขุมวิท 1-3",2,189,303,343,646
5081,"คลองเตยเหนือ","เขตวัฒนา",103901,"เต็นท์บริเวณด้านหน้าโรงเรียนสาธิต มศว.ประสานมิตร (ฝ่ายมัธยม)",3,261,278,331,609
5082,"คลองเตยเหนือ","เขตวัฒนา",103901,"เต็นท์บริเวณด้านหน้าโรงเรียนสาธิต มศว.ประสานมิตร (ฝ่ายมัธยม)",4,330,236,363,599
5083,"คลองเตยเหนือ","เขตวัฒนา",103901,"เต็นท์บริเวณด้านหน้าโรงเรียนสาธิต มศว.ประสานมิตร (ฝ่ายมัธยม)",5,437,257,374,631
5084,"คลองเตยเหนือ","เขตวัฒนา",103901,"โรงเรียนวัฒนาวิทยาลัย",6,355,307,386,693
5085,"คลองเตยเหนือ","เขตวัฒนา",103901,"เต็นท์บริเวณด้านหน้าโรงเรียนสาธิต มศว.ประสานมิตร (ฝ่ายมัธยม)",7,553,347,430,777
5086,"คลองเตยเหนือ","เขตวัฒนา",103901,"เต็นท์บริเวณด้านหน้าโรงเรียนสาธิต มศว.ประสานมิตร (ฝ่ายมัธยม)",8,609,346,498,844
5087,"คลองเตยเหนือ","เขตวัฒนา",103901,"เต็นท์บริเวณด้านหน้าโรงเรียนสาธิต มศว.ประสานมิตร (ฝ่ายมัธยม)",9,385,362,436,798
5088,"คลองเตยเหนือ","เขตวัฒนา",103901,"โรงเรียนสวัสดีวิทยา",10,346,255,406,661
5089,"คลองตันเหนือ","เขตวัฒนา",103902,"โรงเรียนสวัสดีวิทยา",1,260,231,338,569
5090,"คลองตันเหนือ","เขตวัฒนา",103902,"โรงเรียนสวัสดีวิทยา",2,270,241,371,612
5091,"คลองตันเหนือ","เขตวัฒนา",103902,"โรงเรียนสวัสดีวิทยา",3,343,297,405,702
5092,"คลองตันเหนือ","เขตวัฒนา",103902,"ใต้อาคารจอดรถโรงเรียนนานาชาติบางกอกเพรพ สุขุมวิท 53",4,277,273,304,577
5093,"คลองตันเหนือ","เขตวัฒนา",103902,"ใต้อาคารจอดรถโรงเรียนนานาชาติบางกอกเพรพ สุขุมวิท 53",5,307,244,343,587
5094,"คลองตันเหนือ","เขตวัฒนา",103902,"เต็นท์บริเวณที่จอดรถธนาคารออมสินภาค 2 ปากซอยสุขุมวิท 39",6,424,288,415,703
5095,"คลองตันเหนือ","เขตวัฒนา",103902,"เต็นท์บริเวณที่จอดรถธนาคารออมสินภาค 2 ปากซอยสุขุมวิท 39",7,460,293,458,751
5096,"คลองตันเหนือ","เขตวัฒนา",103902,"เต็นท์บริเวณที่จอดรถธนาคารออมสินภาค 2 ปากซอยสุขุมวิท 39",8,336,279,376,655
5097,"คลองตันเหนือ","เขตวัฒนา",103902,"เต็นท์บริเวณที่จอดรถธนาคารออมสินภาค 2 ปากซอยสุขุมวิท 39",9,312,307,415,722
5098,"คลองตันเหนือ","เขตวัฒนา",103902,"เต็นท์บริเวณที่จอดรถธนาคารออมสินภาค 2 ปากซอยสุขุมวิท 39",10,308,300,378,678
5099,"คลองตันเหนือ","เขตวัฒนา",103902,"เต็นท์ลานจอดรถปลายซอยทองหล่อ 11(ที่จอดรถโรงพยาบาลสมิติเวชเดิม)",11,286,208,337,545
5100,"คลองตันเหนือ","เขตวัฒนา",103902,"เต็นท์ลานจอดรถปลายซอยทองหล่อ 11(ที่จอดรถโรงพยาบาลสมิติเวชเดิม)",12,195,218,290,508
5101,"คลองตันเหนือ","เขตวัฒนา",103902,"เต็นท์ลานจอดรถปลายซอยทองหล่อ 11(ที่จอดรถโรงพยาบาลสมิติเวชเดิม)",13,210,226,330,556
5102,"คลองตันเหนือ","เขตวัฒนา",103902,"โรงเรียนมิฟต้าฮุ้ลอุลูมิดดีนียะห์ (สุดซอยพร้อมพรรค)",14,186,200,232,432
5103,"คลองตันเหนือ","เขตวัฒนา",103902,"โรงเรียนมิฟต้าฮุ้ลอุลูมิดดีนียะห์ (สุดซอยพร้อมพรรค)",15,181,243,287,530
5104,"คลองตันเหนือ","เขตวัฒนา",103902,"โรงเรียนสุเหร่าบ้านดอน",16,143,298,295,593
5105,"คลองตันเหนือ","เขตวัฒนา",103902,"โรงเรียนสุเหร่าบ้านดอน",17,115,299,300,599
5106,"คลองตันเหนือ","เขตวัฒนา",103902,"โรงเรียนสุเหร่่าบ้านดอน",18,152,330,319,649
5107,"คลองตันเหนือ","เขตวัฒนา",103902,"เต็นท์บริเวณโรงเรียนเจริญวุฒิวิทยา ซอยสุขุมวิท 55(ทองหล่อ 2)",19,435,284,429,713
5108,"คลองตันเหนือ","เขตวัฒนา",103902,"เต็นท์บริเวณโรงเรียนเจริญวุฒิวิทยา ซอยสุขุมวิท 55(ทองหล่อ 2)",20,337,289,382,671
5109,"คลองตันเหนือ","เขตวัฒนา",103902,"เต็นท์บริเวณโรงเรียนเจริญวุฒิวิทยา ซอยสุขุมวิท 55(ทองหล่อ 2)",21,433,279,408,687
5110,"คลองตันเหนือ","เขตวัฒนา",103902,"เต็นท์บริเวณโรงเรียนเจริญวุฒิวิทยา ซอยสุขุมวิท 55(ทองหล่อ 2)",22,373,344,400,744
5111,"คลองตันเหนือ","เขตวัฒนา",103902,"เต็นท์บริเวณแฟลตตำรวจทองหล่อ",23,193,210,255,465
5112,"คลองตันเหนือ","เขตวัฒนา",103902,"เต็นท์บริเวณแฟลตตำรวจทองหล่อ",24,242,298,237,535
5113,"คลองตันเหนือ","เขตวัฒนา",103902,"เต็นท์บริเวณแฟลตตำรวจทองหล่อ",25,512,321,435,756
5114,"คลองตันเหนือ","เขตวัฒนา",103902,"โรงเรียนแจ่มจันทร์",26,210,252,303,555
5115,"คลองตันเหนือ","เขตวัฒนา",103902,"โรงเรียนแจ่มจันทร์",27,216,231,297,528
5116,"คลองตันเหนือ","เขตวัฒนา",103902,"โรงอาหารโรงพิมพ์สำนักงานสลากกินแบ่งรัฐบาล",28,340,299,366,665
5117,"คลองตันเหนือ","เขตวัฒนา",103902,"โรงอาหารโรงพิมพ์สำนักงานสลากกินแบ่งรัฐบาล",29,360,245,394,639
5118,"คลองตันเหนือ","เขตวัฒนา",103902,"เต็นท์ลานจอดรถโรงพิมพ์สำนักงานสลากกินแบ่งรัฐบาล",30,258,289,331,620
5119,"คลองตันเหนือ","เขตวัฒนา",103902,"เต็นท์ลานจอดรถโรงพิมพ์สำนักงานสลากกินแบ่งรัฐบาล",31,301,272,377,649
5120,"คลองตันเหนือ","เขตวัฒนา",103902,"เต็นท์บริเวณโรงเรียนวัดภาษี",32,273,305,344,649
5121,"คลองตันเหนือ","เขตวัฒนา",103902,"เต็นท์บริเวณโรงเรียนวัดภาษี",33,295,329,361,690
5122,"คลองตันเหนือ","เขตวัฒนา",103902,"โรงเรียนวิจิตรวิทยา",34,150,254,302,556
5123,"คลองตันเหนือ","เขตวัฒนา",103902,"โรงเรียนวิจิตรวิทยา",35,175,311,333,644
5124,"คลองตันเหนือ","เขตวัฒนา",103902,"โรงเรียนวิจิตรวิทยา",36,156,289,314,603
5125,"คลองตันเหนือ","เขตวัฒนา",103902,"โรงเรียนวิจิตรวิทยา",37,188,280,324,604
5126,"คลองตันเหนือ","เขตวัฒนา",103902,"โรงเรียนวิจิตรวิทยา",38,243,341,401,742
5127,"คลองตันเหนือ","เขตวัฒนา",103902,"โรงเรียนวิจิตรวิทยา",39,244,337,397,734
5128,"คลองตันเหนือ","เขตวัฒนา",103902,"เต็นท์บริเวณ บริษัท เยาวราช จำกัด ซอยปรีดีพนมยงค์ 45",40,144,285,311,596
5129,"คลองตันเหนือ","เขตวัฒนา",103902,"วิทยาลัยเทคโนโลยีพิชญเกษม",41,136,253,263,516
5130,"คลองตันเหนือ","เขตวัฒนา",103902,"วิทยาลัยเทคโนโลยีพิชญเกษม",42,193,358,393,751
5131,"คลองตันเหนือ","เขตวัฒนา",103902,"วิทยาลัยเทคโนโลยีพิชญเกษม",43,209,264,305,569
5132,"คลองตันเหนือ","เขตวัฒนา",103902,"วิทยาลัยเทคโนโลยีพิชญเกษม",44,185,263,309,572
5133,"คลองตันเหนือ","เขตวัฒนา",103902,"วิทยาลัยเทคโนโลยีพิชญเกษม",45,163,237,275,512
5134,"คลองตันเหนือ","เขตวัฒนา",103902,"เต็นท์บริเวณโรงเรียนสุเหร่าสามอิน",46,168,217,235,452
5135,"คลองตันเหนือ","เขตวัฒนา",103902,"เต็นท์บริเวณโรงเรียนสุเหร่าสามอิน",47,147,162,239,401
5136,"คลองตันเหนือ","เขตวัฒนา",103902,"เต็นท์บริเวณโรงเรียนสุเหร่าสามอิน",48,130,212,244,456
5137,"คลองตันเหนือ","เขตวัฒนา",103902,"โรงเรียนพระหฤทัยพัฒนเวศม์",49,237,304,383,687
5138,"คลองตันเหนือ","เขตวัฒนา",103902,"โรงเรียนพระหฤทัยพัฒนเวศม์",50,216,298,369,667
5139,"พระโขนงเหนือ","เขตวัฒนา",103903,"โรงเรียนมัธยมวัดธาตุทอง",1,519,297,440,737
5140,"พระโขนงเหนือ","เขตวัฒนา",103903,"โรงเรียนมัธยมวัดธาตุทอง",2,345,281,426,707
5141,"พระโขนงเหนือ","เขตวัฒนา",103903,"โรงเรียนมัธยมวัดธาตุทอง",3,283,299,439,738
5142,"พระโขนงเหนือ","เขตวัฒนา",103903,"โรงเรียนมัธยมวัดธาตุทอง",4,259,294,382,676
5143,"พระโขนงเหนือ","เขตวัฒนา",103903,"เต็นท์บริเวณลานจอดรถวัดธาตุทอง",5,226,261,390,651
5144,"พระโขนงเหนือ","เขตวัฒนา",103903,"เต็นท์บริเวณลานจอดรถวัดธาตุทอง",6,263,246,370,616
5145,"พระโขนงเหนือ","เขตวัฒนา",103903,"เต็นท์บริเวณลานจอดรถวัดธาตุทอง",7,339,253,429,682
5146,"พระโขนงเหนือ","เขตวัฒนา",103903,"โรงเรียนอนุบาลพิบูลย์เวศม์",8,259,282,363,645
5147,"พระโขนงเหนือ","เขตวัฒนา",103903,"โรงเรียนอนุบาลพิบูลย์เวศม์",9,193,257,327,584
5148,"พระโขนงเหนือ","เขตวัฒนา",103903,"โรงเรียนอนุบาลพิบูลย์เวศม์",10,218,266,361,627
5149,"พระโขนงเหนือ","เขตวัฒนา",103903,"โรงเรียนอนุบาลพิบูลย์เวศม์",11,281,275,337,612
5150,"พระโขนงเหนือ","เขตวัฒนา",103903,"โรงเรียนอิสลามบำรุงศาสน์",12,124,279,299,578
5151,"พระโขนงเหนือ","เขตวัฒนา",103903,"โรงเรียนอิสลามบำรุงศาสน์",13,250,290,330,620
5152,"พระโขนงเหนือ","เขตวัฒนา",103903,"บริเวณมัสยิดบัดรุ้ลมุมีนีน (ศาลาลอย) ซอยมีสุวรรณ 3",14,248,222,343,565
5153,"พระโขนงเหนือ","เขตวัฒนา",103903,"บริเวณมัสยิดบัดรุ้ลมุมีนีน (ศาลาลอย) ซอยมีสุวรรณ 3",15,181,226,290,516
5154,"พระโขนงเหนือ","เขตวัฒนา",103903,"บริเวณมัสยิดบัดรุ้ลมุมีนีน (ศาลาลอย) ซอยมีสุวรรณ 3",16,186,196,287,483
5155,"พระโขนงเหนือ","เขตวัฒนา",103903,"บริเวณมัสยิดบัดรุ้ลมุมีนีน (ศาลาลอย) ซอยมีสุวรรณ 3",17,150,255,280,535
5156,"พระโขนงเหนือ","เขตวัฒนา",103903,"โรงเรียนสุเหร่าบางมะเขือ",18,189,263,276,539
5157,"พระโขนงเหนือ","เขตวัฒนา",103903,"โรงเรียนสุเหร่าบางมะเขือ",19,231,265,347,612
5158,"พระโขนงเหนือ","เขตวัฒนา",103903,"เต็นท์บริเวณใต้ทางด่วน (ลานกีฬาแสงทิพย์) ถนนสุขุมวิท 71",20,201,274,346,620
5159,"พระโขนงเหนือ","เขตวัฒนา",103903,"เต็นท์บริเวณใต้ทางด่วน (ลานกีฬาแสงทิพย์) ถนนสุขุมวิท 71",21,204,295,359,654
5160,"พระโขนงเหนือ","เขตวัฒนา",103903,"เต็นท์บริเวณใต้ทางด่วน (ลานกีฬาแสงทิพย์) ถนนสุขุมวิท 71",22,561,283,426,709
5161,"พระโขนงเหนือ","เขตวัฒนา",103903,"เต็นท์บริเวณมัสยิดบางมะเขือ",23,129,212,230,442
5162,"พระโขนงเหนือ","เขตวัฒนา",103903,"เต็นท์บริเวณมัสยิดบางมะเขือ",24,190,228,276,504
5163,"พระโขนงเหนือ","เขตวัฒนา",103903,"เต็นท์บริเวณที่ว่างปากซอยพัฒนเวศม์ 3",25,183,241,317,558
5164,"พระโขนงเหนือ","เขตวัฒนา",103903,"เต็นท์บริเวณที่ว่างปากซอยพัฒนเวศม์ 3",26,190,251,310,561
5165,"พระโขนงเหนือ","เขตวัฒนา",103903,"โรงเรียนแสงหิรัญ",27,528,353,466,819
5166,"พระโขนงเหนือ","เขตวัฒนา",103903,"วิทยาลัยอาชีวศึกษาเทคนิคบริหารธุรกิจกรุงเทพ",28,282,254,346,600
5167,"พระโขนงเหนือ","เขตวัฒนา",103903,"วิทยาลัยอาชีวศึกษาเทคนิคบริหารธุรกิจกรุงเทพ",29,482,246,392,638
5168,"พระโขนงเหนือ","เขตวัฒนา",103903,"วิทยาลัยอาชีวศึกษาเทคนิคบริหารธุรกิจกรุงเทพ",30,369,298,421,719
5169,"บางแค","เขตบางแค",104001,"เต็นท์หน้าหมู่บ้านโมเดิร์น ทาวน์ ซอยกาญจนาภิเษก 0010",1,296,294,382,676
5170,"บางแค","เขตบางแค",104001,"เต็นท์หน้าหมู่บ้านโมเดิร์น ทาวน์ ซอยกาญจนาภิเษก 0010",2,324,318,445,763
5171,"บางแค","เขตบางแค",104001,"เต็นท์หน้าหมู่บ้านโมเดิร์น ทาวน์ ซอยกาญจนาภิเษก 0010",3,336,315,425,740
5172,"บางแค","เขตบางแค",104001,"ร้านครัวปักษ์ใต้เมืองสงขลา ถนนกัลปพฤกษ์",4,374,386,479,865
5173,"บางแค","เขตบางแค",104001,"ร้านครัวปักษ์ใต้เมืองสงขลา ถนนกัลปพฤกษ์",5,436,390,491,881
5174,"บางแค","เขตบางแค",104001,"ร้านครัวปักษ์ใต้เมืองสงขลา ถนนกัลปพฤกษ์",6,509,396,503,899
5175,"บางแค","เขตบางแค",104001,"เต็นท์ลานจอดรถร้านกรีนเฮ้าส์ ถนนกาญจนาภิเษก",7,325,368,430,798
5176,"บางแค","เขตบางแค",104001,"โรงเรียนพิชญ์ชนก",8,193,283,354,637
5177,"บางแค","เขตบางแค",104001,"โรงเรียนพิชญ์ชนก",9,183,325,331,656
5178,"บางแค","เขตบางแค",104001,"โรงเรียนพิชญ์ชนก",10,158,310,337,647
5179,"บางแค","เขตบางแค",104001,"โรงเรียนพิชญ์ชนก",11,179,342,361,703
5180,"บางแค","เขตบางแค",104001,"โรงเรียนพิชญ์ชนก",12,194,289,338,627
5181,"บางแค","เขตบางแค",104001,"เต็นท์ภายในโรงเรียนพิชญ์ชนก",13,241,398,415,813
5182,"บางแค","เขตบางแค",104001,"เต็นท์ภายในโรงเรียนพิชญ์ชนก",14,312,349,404,753
5183,"บางแค","เขตบางแค",104001,"เต็นท์ภายในโรงเรียนพิชญ์ชนก",15,224,383,411,794
5184,"บางแค","เขตบางแค",104001,"เต็นท์ภายในโรงเรียนพิชญ์ชนก",16,311,361,422,783
5185,"บางแค","เขตบางแค",104001,"โรงเรียนคลองหนองใหญ่",17,283,370,402,772
5186,"บางแค","เขตบางแค",104001,"โรงเรียนคลองหนองใหญ่",18,252,293,363,656
5187,"บางแค","เขตบางแค",104001,"โรงเรียนคลองหนองใหญ่",19,234,317,336,653
5188,"บางแค","เขตบางแค",104001,"โรงเรียนคลองหนองใหญ่",20,219,306,337,643
5189,"บางแค","เขตบางแค",104001,"โรงเรียนคลองหนองใหญ่",21,253,343,403,746
5190,"บางแค","เขตบางแค",104001,"โรงเรียนคลองหนองใหญ่",22,284,361,415,776
5191,"บางแค","เขตบางแค",104001,"โรงเรียนคลองหนองใหญ่",23,420,353,399,752
5192,"บางแค","เขตบางแค",104001,"โรงเรียนคลองหนองใหญ่",24,432,317,445,762
5193,"บางแค","เขตบางแค",104001,"โรงเรียนคลองหนองใหญ่",25,502,338,482,820
5194,"บางแค","เขตบางแค",104001,"เต็นท์ที่ว่างภายในหมู่บ้านมั่งมีซิตี้",26,199,309,358,667
5195,"บางแค","เขตบางแค",104001,"เต็นท์ที่ว่างภายในหมู่บ้านมั่งมีซิตี้",27,260,360,578,938
5196,"บางแค","เขตบางแค",104001,"เต็นท์ที่ว่างภายในหมู่บ้านมั่งมีซิตี้",28,227,351,419,770
5197,"บางแค","เขตบางแค",104001,"อาคารโรงเรียนประทุมอนุสรณ์",29,267,355,455,810
5198,"บางแค","เขตบางแค",104001,"อาคารโรงเรียนประทุมอนุสรณ์",30,281,340,440,780
5199,"บางแค","เขตบางแค",104001,"อาคารโรงเรียนประทุมอนุสรณ์",31,205,371,411,782
5200,"บางแค","เขตบางแค",104001,"โรงอาหารโรงเรียนประทุมอนุสรณ์",32,174,333,364,697
5201,"บางแค","เขตบางแค",104001,"โรงอาหารโรงเรียนประทุมอนุสรณ์",33,259,350,429,779
5202,"บางแค","เขตบางแค",104001,"โรงอาหารโรงเรียนประทุมอนุสรณ์",34,490,323,461,784
5203,"บางแค","เขตบางแค",104001,"เต็นท์ลานจอดรถศูนย์การค้าตลาดบางแค",35,242,255,311,566
5204,"บางแค","เขตบางแค",104001,"เต็นท์ลานจอดรถศูนย์การค้าตลาดบางแค",36,234,351,413,764
5205,"บางแค","เขตบางแค",104001,"เต็นท์ลานจอดรถ 2 ตลาดวันเดอร์",37,266,398,482,880
5206,"บางแค","เขตบางแค",104001,"เต็นท์ลานจอดรถ 2 ตลาดวันเดอร์",38,454,342,490,832
5207,"บางแค","เขตบางแค",104001,"เต็นท์สถานีดับเพลิงและกู้ภัยบางแค",39,285,327,409,736
5208,"บางแค","เขตบางแค",104001,"เต็นท์สถานีดับเพลิงและกู้ภัยบางแค",40,224,286,358,644
5209,"บางแค","เขตบางแค",104001,"เต็นท์สถานีดับเพลิงและกู้ภัยบางแค",41,178,275,322,597
5210,"บางแค","เขตบางแค",104001,"เต็นท์หน้าซีเจ ซุปเปอร์มาเก็็ต สาขาเพชรเกษม 41",42,282,275,260,535
5211,"บางแค","เขตบางแค",104001,"เต็นท์หน้าซีเจ ซุปเปอร์มาเก็็ต สาขาเพชรเกษม 41",43,220,159,188,347
5212,"บางแคเหนือ","เขตบางแค",104002,"เต็นท์ลานจอดรถตลาดหมู่บ้านเศรษฐกิจ",1,198,231,312,543
5213,"บางแคเหนือ","เขตบางแค",104002,"เต็นท์ลานจอดรถตลาดหมู่บ้านเศรษฐกิจ",2,174,240,297,537
5214,"บางแคเหนือ","เขตบางแค",104002,"เต็นท์ลานจอดรถตลาดหมู่บ้านเศรษฐกิจ",3,210,265,303,568
5215,"บางแคเหนือ","เขตบางแค",104002,"เต็นท์ลานจอดรถตลาดหมู่บ้านเศรษฐกิจ",4,242,276,342,618
5216,"บางแคเหนือ","เขตบางแค",104002,"เต็นท์ลานจอดรถบริษัทพิบูลย์ชัย น้ำพริกเผาไทยแม่ประนอม จำกัด สาขาหมู่บ้านเศรษฐกิจ",5,253,348,440,788
5217,"บางแคเหนือ","เขตบางแค",104002,"เต็นท์ลานจอดรถบริษัทพิบูลย์ชัย น้ำพริกเผาไทยแม่ประนอม จำกัด สาขาหมู่บ้านเศรษฐกิจ",6,286,317,396,713
5218,"บางแคเหนือ","เขตบางแค",104002,"ศาลาประชาคมอู่ทอง",7,327,422,491,913
5219,"บางแคเหนือ","เขตบางแค",104002,"ศาลาประชาคมอู่ทอง",8,351,432,528,960
5220,"บางแคเหนือ","เขตบางแค",104002,"เต็นท์ลานจอดรถศาลาประชาคมอู่ทอง",9,482,458,629,1087
5221,"บางแคเหนือ","เขตบางแค",104002,"เต็นท์ลานจอดรถศาลาประชาคมอู่ทอง",10,337,440,533,973
5222,"บางแคเหนือ","เขตบางแค",104002,"เต็นท์ลานจอดรถศาลาประชาคมอู่ทอง",11,333,424,497,921
5223,"บางแคเหนือ","เขตบางแค",104002,"โรงเรียนหมู่บ้านเศรษฐกิจ",12,224,292,352,644
5224,"บางแคเหนือ","เขตบางแค",104002,"โรงเรียนหมู่บ้านเศรษฐกิจ",13,173,325,337,662
5225,"บางแคเหนือ","เขตบางแค",104002,"โรงเรียนหมู่บ้านเศรษฐกิจ",14,232,304,429,733
5226,"บางแคเหนือ","เขตบางแค",104002,"โรงเรียนหมู่บ้านเศรษฐกิจ",15,246,332,402,734
5227,"บางแคเหนือ","เขตบางแค",104002,"โรงเรียนหมู่บ้านเศรษฐกิจ",16,255,350,397,747
5228,"บางแคเหนือ","เขตบางแค",104002,"เต็นท์ลานจอดรถร้านเอกภาพ (ปากซอยหมู่บ้านเศรษฐกิจ 33)",17,235,359,414,773
5229,"บางแคเหนือ","เขตบางแค",104002,"เต็นท์ลานจอดรถร้านเอกภาพ (ปากซอยหมู่บ้านเศรษฐกิจ 33)",18,249,324,374,698
5230,"บางแคเหนือ","เขตบางแค",104002,"เต็นท์ลานจอดรถร้านเอกภาพ (ปากซอยหมู่บ้านเศรษฐกิจ 33)",19,173,249,317,566
5231,"บางแคเหนือ","เขตบางแค",104002,"เต็นท์วงเวียนหมู่บ้านเศรษฐกิจ ผัง ข",20,171,232,311,543
5232,"บางแคเหนือ","เขตบางแค",104002,"เต็นท์วงเวียนหมู่บ้านเศรษฐกิจ ผัง ข",21,281,369,484,853
5233,"บางแคเหนือ","เขตบางแค",104002,"เต็นท์วงเวียนหมู่บ้านเศรษฐกิจ ผัง ข",22,218,324,404,728
5234,"บางแคเหนือ","เขตบางแค",104002,"เต็นท์วงเวียนหมู่บ้านเศรษฐกิจ ผัง ข",23,239,400,441,841
5235,"บางแคเหนือ","เขตบางแค",104002,"เต็นท์ภายในที่ทำการไปรษณีย์ภาษีเจริญ",24,249,333,432,765
5236,"บางแคเหนือ","เขตบางแค",104002,"เต็นท์ภายในที่ทำการไปรษณีย์ภาษีเจริญ",25,582,330,467,797
5237,"บางแคเหนือ","เขตบางแค",104002,"เต็นท์ภายในหมู่บ้านวีรวัฒน์ ซอยเพชรเกษม 94",26,230,261,351,612
5238,"บางแคเหนือ","เขตบางแค",104002,"เต็นท์ภายในหมู่บ้านวีรวัฒน์ ซอยเพชรเกษม 94",27,227,269,348,617
5239,"บางแคเหนือ","เขตบางแค",104002,"เต็นท์หน้าสโมสร หมู่บ้านเพชรเกษม 3",28,276,325,460,785
5240,"บางแคเหนือ","เขตบางแค",104002,"เต็นท์หน้าสโมสร หมู่บ้านเพชรเกษม 3",29,289,327,434,761
5241,"บางแคเหนือ","เขตบางแค",104002,"เต็นท์หน้าสโมสร หมู่บ้านเพชรเกษม 3",30,286,343,435,778
5242,"บางแคเหนือ","เขตบางแค",104002,"อู่ธนิตยนต์ ซอยเพชรเกษม 92/2",31,184,245,275,520
5243,"บางแคเหนือ","เขตบางแค",104002,"อู่ธนิตยนต์ ซอยเพชรเกษม 92/2",32,180,220,260,480
5244,"บางแคเหนือ","เขตบางแค",104002,"อู่ธนิตยนต์ ซอยเพชรเกษม 92/2",33,167,232,288,520
5245,"บางแคเหนือ","เขตบางแค",104002,"เต็นท์หน้าหมู่บ้านเพชรเกษม 2 ด้านถนนพุทธมณฑลสาย 2 ซอย 1",34,233,258,351,609
5246,"บางแคเหนือ","เขตบางแค",104002,"เต็นท์หน้าหมู่บ้านเพชรเกษม 2 ด้านถนนพุทธมณฑลสาย 2 ซอย 1",35,250,289,347,636
5247,"บางแคเหนือ","เขตบางแค",104002,"เต็นท์หน้าหมู่บ้านเพชรเกษม 2 ด้านถนนพุทธมณฑลสาย 2 ซอย 1",36,199,261,303,564
5248,"บางแคเหนือ","เขตบางแค",104002,"เต็นท์เยื้องสถานีบริการน้ำมันเซลล์ ถนนพุทธมณฑลสาย 2",37,225,295,362,657
5249,"บางแคเหนือ","เขตบางแค",104002,"เต็นท์เยื้องสถานีบริการน้ำมันเซลล์ ถนนพุทธมณฑลสาย 2",38,531,332,535,867
5250,"บางแคเหนือ","เขตบางแค",104002,"เต็นท์เยื้องสถานีบริการน้ำมันเซลล์ ถนนพุทธมณฑลสาย 2",39,218,267,313,580
5251,"บางแคเหนือ","เขตบางแค",104002,"เต็นท์ลานกีฬาหมู่บ้านชมเดือน",40,215,308,349,657
5252,"บางแคเหนือ","เขตบางแค",104002,"เต็นท์ลานกีฬาหมู่บ้านชมเดือน",41,236,310,363,673
5253,"บางแคเหนือ","เขตบางแค",104002,"เต็นท์ลานกีฬาหมู่บ้านชมเดือน",42,227,300,347,647
5254,"บางแคเหนือ","เขตบางแค",104002,"เต็นท์ลานกีฬาหมู่บ้านชมเดือน",43,274,358,451,809
5255,"บางแคเหนือ","เขตบางแค",104002,"ศาลาศาลปู่บุญ หมู่บ้านเทพนคร",44,208,260,321,581
5256,"บางแคเหนือ","เขตบางแค",104002,"เต็นท์ที่ว่างใกล้ศาลปู่บุญ หมู่บ้านเทพนคร",45,201,331,337,668
5257,"บางแคเหนือ","เขตบางแค",104002,"เต็นท์ศูนย์บริการสาธารณสุข 40 สาขา แย้ม เหย็น หนู เสเกกุลซอยเพชรเกษม 88",46,154,245,303,548
5258,"บางแคเหนือ","เขตบางแค",104002,"เต็นท์ศูนย์บริการสาธารณสุข 40สาขา แย้ม เหย็น หนู เสเกกุลซอยเพชรเกษม 88",47,226,263,353,616
5259,"บางแคเหนือ","เขตบางแค",104002,"เต็นท์ศูนย์ก่อสร้างและบูรณะถนน 1",48,217,319,361,680
5260,"บางแคเหนือ","เขตบางแค",104002,"เต็นท์ศูนย์ก่อสร้างและบูรณะถนน 1",49,196,276,346,622
5261,"บางแคเหนือ","เขตบางแค",104002,"ลานจอดรถอาคารกลุ่มงานวิเคราะห์และวิจัย 4 ซอยเพชรเกษม 90",50,242,253,339,592
5262,"บางแคเหนือ","เขตบางแค",104002,"ลานจอดรถอาคารกลุ่มงานวิเคราะห์และวิจัย 4 ซอยเพชรเกษม 90",51,211,259,325,584
5263,"บางแคเหนือ","เขตบางแค",104002,"เต็นท์ลานจอดรถหลังเดอะมอลล์บางแค ถนนกาญจนาภิเษก",52,288,305,404,709
5264,"บางแคเหนือ","เขตบางแค",104002,"เต็นท์ลานจอดรถหลังเดอะมอลล์บางแค ถนนกาญจนาภิเษก",53,388,353,458,811
5265,"บางแคเหนือ","เขตบางแค",104002,"โรงเรียนบางแคเหนือ",54,332,402,501,903
5266,"บางแคเหนือ","เขตบางแค",104002,"โรงเรียนบางแคเหนือ",55,344,418,505,923
5267,"บางแคเหนือ","เขตบางแค",104002,"เต็นท์ภายในโรงเรียนภาษานุสรณ์บางแค",56,231,351,405,756
5268,"บางแคเหนือ","เขตบางแค",104002,"เต็นท์ภายในโรงเรียนภาษานุสรณ์บางแค",57,203,387,468,855
5269,"บางแคเหนือ","เขตบางแค",104002,"เต็นท์ภายในโรงเรียนภาษานุสรณ์บางแค",58,206,347,370,717
5270,"บางแคเหนือ","เขตบางแค",104002,"เต็นท์ภายในโรงเรียนภาษานุสรณ์บางแค",59,361,355,451,806
5271,"บางแคเหนือ","เขตบางแค",104002,"เต็นท์ภายในโรงเรียนภาษานุสรณ์บางแค",60,252,342,415,757
5272,"บางแคเหนือ","เขตบางแค",104002,"เต็นท์ภายในโรงเรียนภาษานุสรณ์บางแค",61,267,296,344,640
5273,"บางแคเหนือ","เขตบางแค",104002,"เต็นท์ลานจอดรถห้างเทสโก้ โลตัส สาขาบางแค",62,264,317,408,725
5274,"บางแคเหนือ","เขตบางแค",104002,"เต็นท์ลานจอดรถห้างเทสโก้ โลตัส สาขาบางแค",63,194,241,343,584
5275,"บางแคเหนือ","เขตบางแค",104002,"เต็นท์ลานจอดรถห้างเทสโก้ โลตัส สาขาบางแค",64,257,339,421,760
5276,"บางแคเหนือ","เขตบางแค",104002,"เต็นท์ลานจอดรถห้างเทสโก้ โลตัส สาขาบางแค",65,287,339,391,730
5277,"บางแคเหนือ","เขตบางแค",104002,"โรงเรียนราชวินิตประถมบางแค",66,182,266,318,584
5278,"บางแคเหนือ","เขตบางแค",104002,"โรงเรียนราชวินิตประถมบางแค",67,181,269,324,593
5279,"บางแคเหนือ","เขตบางแค",104002,"โรงเรียนราชวินิตประถมบางแค",68,189,320,368,688
5280,"บางแคเหนือ","เขตบางแค",104002,"อู่ธนัท 2021 ริมคลองบางแวก",69,195,287,337,624
5281,"บางไผ่","เขตบางแค",104003,"เต็นท์ร้านทรัพย์ปกรณ์ค้าไม้ ปากซอยบางแวก 138 (ทองพูน1)",1,191,321,324,645
5282,"บางไผ่","เขตบางแค",104003,"เต็นท์ร้านทรัพย์ปกรณ์ค้าไม้ ปากซอยบางแวก 138 (ทองพูน1)",2,155,250,280,530
5283,"บางไผ่","เขตบางแค",104003,"เต็นท์ร้านทรัพย์ปกรณ์ค้าไม้ ปากซอยบางแวก 138 (ทองพูน1)",3,235,298,357,655
5284,"บางไผ่","เขตบางแค",104003,"เต็นท์ร้านทรัพย์ปกรณ์ค้าไม้ ปากซอยบางแวก 138 (ทองพูน1)",4,252,297,323,620
5285,"บางไผ่","เขตบางแค",104003,"เต็นท์ปากซอยพุทธมณฑลสาย 2 ซอย 12",5,178,280,318,598
5286,"บางไผ่","เขตบางแค",104003,"เต็นท์ทางเข้าชุมชนเลียบคลองบางแวก",6,209,267,300,567
5287,"บางไผ่","เขตบางแค",104003,"เต็นท์ทางเข้าหมู่บ้านธีราคร",7,147,172,219,391
5288,"บางไผ่","เขตบางแค",104003,"เต็นท์หน้าศูนย์บริการเบ็นซ์สาย2",8,271,269,369,638
5289,"บางไผ่","เขตบางแค",104003,"เต็นท์ลานจอดรถตลาดสี่แยกทศกัณฑ์",9,246,273,332,605
5290,"บางไผ่","เขตบางแค",104003,"เต็นท์ลานจอดรถตลาดสี่แยกทศกัณฑ์",10,256,272,331,603
5291,"บางไผ่","เขตบางแค",104003,"เต็นท์ลานจอดรถตลาดสี่แยกทศกัณฑ์",11,285,331,419,750
5292,"บางไผ่","เขตบางแค",104003,"เต็นท์ลานจอดรถตลาดสี่แยกทศกัณฑ์",12,229,347,380,727
5293,"บางไผ่","เขตบางแค",104003,"เต็นท์ลานจอดรถตลาดสี่แยกทศกัณฑ์",13,293,287,396,683
5294,"บางไผ่","เขตบางแค",104003,"เต็นท์ลานจอดรถตลาดสี่แยกทศกัณฑ์",14,241,301,396,697
5295,"บางไผ่","เขตบางแค",104003,"โรงเรียนบางเชือกหนัง",15,276,276,372,648
5296,"บางไผ่","เขตบางแค",104003,"โรงเรียนบางเชือกหนัง",16,185,286,310,596
5297,"บางไผ่","เขตบางแค",104003,"โรงเรียนบางเชือกหนัง",17,184,273,352,625
5298,"บางไผ่","เขตบางแค",104003,"โรงเรียนวัดศาลาแดง",18,191,267,360,627
5299,"บางไผ่","เขตบางแค",104003,"โรงเรียนวัดศาลาแดง",19,306,367,465,832
5300,"บางไผ่","เขตบางแค",104003,"เต็นท์เยื้องสถานีบริการน้ำมันพีที ถนนพุทธมณฑลสาย 3",20,243,319,335,654
5301,"บางไผ่","เขตบางแค",104003,"เต็นท์เยื้องสถานีบริการน้ำมันพีที ถนนพุทธมณฑลสาย 3",21,193,261,271,532
5302,"บางไผ่","เขตบางแค",104003,"เต็นท์เยื้องสถานีบริการน้ำมันพีที ถนนพุทธมณฑลสาย 3",22,164,281,310,591
5303,"บางไผ่","เขตบางแค",104003,"โรงเรียนวัดพรหมสุวรรณสามัคคี",23,145,287,315,602
5304,"บางไผ่","เขตบางแค",104003,"โรงเรียนวัดพรหมสุวรรณสามัคคี",24,153,278,315,593
5305,"บางไผ่","เขตบางแค",104003,"โรงเรียนวัดพรหมสุวรรณสามัคคี",25,187,288,401,689
5306,"บางไผ่","เขตบางแค",104003,"โรงเรียนวัดพรหมสุวรรณสามัคคี",26,199,333,344,677
5307,"บางไผ่","เขตบางแค",104003,"โรงเรียนวัดพรหมสุวรรณสามัคคี",27,187,333,341,674
5308,"บางไผ่","เขตบางแค",104003,"ศูนย์พัฒนาเด็กก่อนวัยเรียนวชิรราชวิทยาคม(วัดพรหมสุวรรณสามัคคี)",28,190,323,346,669
5309,"บางไผ่","เขตบางแค",104003,"ศูนย์พัฒนาเด็กก่อนวัยเรียนวชิรราชวิทยาคม(วัดพรหมสุวรรณสามัคคี)",29,170,314,340,654
5310,"บางไผ่","เขตบางแค",104003,"ศูนย์พัฒนาเด็กก่อนวัยเรียนวชิรราชวิทยาคม(วัดพรหมสุวรรณสามัคคี)",30,179,285,356,641
5311,"บางไผ่","เขตบางแค",104003,"ศูนย์พัฒนาเด็กก่อนวัยเรียนวชิรราชวิทยาคม(วัดพรหมสุวรรณสามัคคี)",31,171,325,351,676
5312,"บางไผ่","เขตบางแค",104003,"โรงเรียนอัสสัมชัญธนบุรี",32,200,300,380,680
5313,"บางไผ่","เขตบางแค",104003,"โรงเรียนอัสสัมชัญธนบุรี",33,204,311,352,663
5314,"บางไผ่","เขตบางแค",104003,"โรงเรียนอัสสัมชัญธนบุรี",34,169,288,325,613
5315,"บางไผ่","เขตบางแค",104003,"โรงเรียนอัสสัมชัญธนบุรี",35,196,312,350,662
5316,"บางไผ่","เขตบางแค",104003,"โรงเรียนอัสสัมชัญธนบุรี",36,230,312,379,691
5317,"บางไผ่","เขตบางแค",104003,"โรงเรียนอัสสัมชัญธนบุรี",37,232,287,375,662
5318,"บางไผ่","เขตบางแค",104003,"โรงเรียนวัดบุณยประดิษฐ์",38,197,368,422,790
5319,"บางไผ่","เขตบางแค",104003,"โรงเรียนวัดบุณยประดิษฐ์",39,289,425,458,883
5320,"บางไผ่","เขตบางแค",104003,"โรงเรียนวัดบุณยประดิษฐ์",40,239,403,424,827
5321,"บางไผ่","เขตบางแค",104003,"โรงเรียนวัดบุณยประดิษฐ์",41,315,404,449,853
5322,"บางไผ่","เขตบางแค",104003,"โรงเรียนวัดบุณยประดิษฐ์",42,294,398,478,876
5323,"บางไผ่","เขตบางแค",104003,"โรงเรียนวัดบุณยประดิษฐ์",43,205,335,390,725
5324,"บางไผ่","เขตบางแค",104003,"เต็นท์ อู่ ท.การช่าง ซอยอุดมทรัพย์",44,272,314,402,716
5325,"บางไผ่","เขตบางแค",104003,"เต็นท์ อู่ ท.การช่าง ซอยอุดมทรัพย์",45,220,276,316,592
5326,"บางไผ่","เขตบางแค",104003,"เต็นท์ อู่ ท.การช่าง ซอยอุดมทรัพย์",46,213,291,316,607
5327,"บางไผ่","เขตบางแค",104003,"เต็นท์ อู่ ท.การช่าง ซอยอุดมทรัพย์",47,308,323,378,701
5328,"บางไผ่","เขตบางแค",104003,"ศูนย์รวมรถยนต์ ดีดี ถนนกาญจนาภิเษก",48,376,416,554,970
5329,"บางไผ่","เขตบางแค",104003,"เต็นท์ลานจอดรถบ้านเลขที่ 167 (สวนอาหารครัวริมบึงเดิม)ถนนราชมนตรี",49,240,294,348,642
5330,"หลักสอง","เขตบางแค",104004,"เต็นท์หน้าหมู่บ้านสุขสันต์ 10",1,243,315,369,684
5331,"หลักสอง","เขตบางแค",104004,"เต็นท์หน้าหมู่บ้านสุขสันต์ 10",2,266,304,387,691
5332,"หลักสอง","เขตบางแค",104004,"เต็นท์หน้าหมู่บ้านสุขสันต์ 10",3,263,331,364,695
5333,"หลักสอง","เขตบางแค",104004,"เต็นท์หน้าหมู่บ้านสุขสันต์ 10",4,276,366,416,782
5334,"หลักสอง","เขตบางแค",104004,"เต็นท์ลานกีฬาหมู่บ้านสุขสันต์ 5",5,304,342,420,762
5335,"หลักสอง","เขตบางแค",104004,"เต็นท์ลานกีฬาหมู่บ้านสุขสันต์ 5",6,283,322,401,723
5336,"หลักสอง","เขตบางแค",104004,"เต็นท์ลานกีฬาหมู่บ้านสุขสันต์ 5",7,231,274,350,624
5337,"หลักสอง","เขตบางแค",104004,"เต็นท์ลานกีฬาหมู่บ้านสุขสันต์ 5",8,348,363,385,748
5338,"หลักสอง","เขตบางแค",104004,"เต็นท์ลานกีฬาหมู่บ้านสุขสันต์ 5",9,212,298,353,651
5339,"หลักสอง","เขตบางแค",104004,"เต็นท์หน้าบ้านเลขที่ 999 หมู่บ้านสุขสันต์ 6",10,257,318,378,696
5340,"หลักสอง","เขตบางแค",104004,"เต็นท์หน้าบ้านเลขที่ 999 หมู่บ้านสุขสันต์ 6",11,280,350,391,741
5341,"หลักสอง","เขตบางแค",104004,"เต็นท์หน้าบ้านเลขที่ 999 หมู่บ้านสุขสันต์ 6",12,302,338,411,749
5342,"หลักสอง","เขตบางแค",104004,"เต็นท์หน้าบ้านเลขที่ 999 หมู่บ้านสุขสันต์ 6",13,527,407,527,934
5343,"หลักสอง","เขตบางแค",104004,"โรงเรียนบางแค (เนื่องสังวาลย์อนุสรณ์)",14,185,233,270,503
5344,"หลักสอง","เขตบางแค",104004,"โรงเรียนบางแค (เนื่องสังวาลย์อนุสรณ์)",15,164,222,259,481
5345,"หลักสอง","เขตบางแค",104004,"โรงเรียนบางแค (เนื่องสังวาลย์อนุสรณ์)",16,159,225,292,517
5346,"หลักสอง","เขตบางแค",104004,"เต็นท์ข้างบ้านเลขทีั่ 155 หมู่บ้านเกษมสุข ซอยเพชรเกษม 53",17,263,322,401,723
5347,"หลักสอง","เขตบางแค",104004,"เต็นท์ข้างบ้านเลขทีั่ 155 หมู่บ้านเกษมสุข ซอยเพชรเกษม 53",18,323,279,413,692
5348,"หลักสอง","เขตบางแค",104004,"เต็นท์ข้างบ้านเลขทีั่ 155 หมู่บ้านเกษมสุข ซอยเพชรเกษม 53",19,231,297,404,701
5349,"หลักสอง","เขตบางแค",104004,"เต็นท์ภายในโรงเรียนอำนวยศิลป์ธนบุรี",20,248,292,384,676
5350,"หลักสอง","เขตบางแค",104004,"เต็นท์ภายในโรงเรียนอำนวยศิลป์ธนบุรี",21,296,334,380,714
5351,"หลักสอง","เขตบางแค",104004,"เต็นท์ภายในโรงเรียนอำนวยศิลป์ธนบุรี",22,310,319,440,759
5352,"หลักสอง","เขตบางแค",104004,"เต็นท์ภายในโรงเรียนอำนวยศิลป์ธนบุรี",23,296,352,416,768
5353,"หลักสอง","เขตบางแค",104004,"เต็นท์ภายในโรงเรียนอำนวยศิลป์ธนบุรี",24,323,377,437,814
5354,"หลักสอง","เขตบางแค",104004,"เต็นท์ศาลพ่อปู่ดำ หมู่บ้านสุขสำราญ ซอยเพชรเกษม 63",25,228,303,364,667
5355,"หลักสอง","เขตบางแค",104004,"เต็นท์ศาลพ่อปู่ดำ หมู่บ้านสุขสำราญ ซอยเพชรเกษม 63",26,222,279,374,653
5356,"หลักสอง","เขตบางแค",104004,"เต็นท์ศาลพ่อปู่ดำ หมู่บ้านสุขสำราญ ซอยเพชรเกษม 63",27,221,280,394,674
5357,"หลักสอง","เขตบางแค",104004,"เต็นท์ศูนย์บริการสาธารณสุข 40 สาขาวิจิตราอนามัย ซอยเพชรเกษม 63",28,275,426,474,900
5358,"หลักสอง","เขตบางแค",104004,"เต็นท์ศูนย์บริการสาธารณสุข 40 สาขาวิจิตราอนามัย ซอยเพชรเกษม 63",29,368,423,476,899
5359,"หลักสอง","เขตบางแค",104004,"เต็นท์ศูนย์บริการสาธารณสุข 40 สาขาวิจิตราอนามัย ซอยเพชรเกษม 63",30,313,391,485,876
5360,"หลักสอง","เขตบางแค",104004,"เต็นท์ลานจอดรถวัดม่วง",31,188,349,377,726
5361,"หลักสอง","เขตบางแค",104004,"เต็นท์ลานจอดรถวัดม่วง",32,269,369,407,776
5362,"หลักสอง","เขตบางแค",104004,"เต็นท์ลานจอดรถวัดม่วง",33,391,378,501,879
5363,"หลักสอง","เขตบางแค",104004,"เต็นท์ลานจอดรถวัดม่วง",34,327,333,453,786
5364,"หลักสอง","เขตบางแค",104004,"เต็นท์ลานจอดรถวัดม่วง",35,277,355,437,792
5365,"หลักสอง","เขตบางแค",104004,"โรงเรียนวัดม่วง",36,168,317,329,646
5366,"หลักสอง","เขตบางแค",104004,"โรงเรียนวัดม่วง",37,228,316,360,676
5367,"หลักสอง","เขตบางแค",104004,"โรงเรียนวัดม่วง",38,174,318,355,673
5368,"หลักสอง","เขตบางแค",104004,"โรงเรียนวัดม่วง",39,272,286,358,644
5369,"หลักสอง","เขตบางแค",104004,"โรงเรียนวัดม่วง",40,303,302,361,663
5370,"หลักสอง","เขตบางแค",104004,"โรงเรียนวัดม่วง",41,281,336,361,697
5371,"หลักสอง","เขตบางแค",104004,"โรงเรียนวัดม่วง",42,222,322,382,704
5372,"หลักสอง","เขตบางแค",104004,"เต็นท์หน้าหมู่บ้านหลักสองนิเวศน์",43,256,270,393,663
5373,"หลักสอง","เขตบางแค",104004,"เต็นท์หน้าหมู่บ้านหลักสองนิเวศน์",44,276,318,370,688
5374,"หลักสอง","เขตบางแค",104004,"โรงเรียนเพชรเกษม",45,170,294,344,638
5375,"หลักสอง","เขตบางแค",104004,"โรงเรียนเพชรเกษม",46,280,277,346,623
5376,"หลักสอง","เขตบางแค",104004,"เต็นท์หน้าหมู่บ้านแสงทองวิลล่า",47,158,176,232,408
5377,"หลักสอง","เขตบางแค",104004,"เต็นท์หน้าหมู่บ้านแสงทองวิลล่า",48,156,186,188,374
5378,"หลักสอง","เขตบางแค",104004,"เต็นท์ถนนเพชรเกษม ระหว่างซอยเพชรเกษม 67,67/1",49,320,381,450,831
5379,"หลักสอง","เขตบางแค",104004,"โรงเรียนวัดราษฎร์บำรุง",50,250,305,388,693
5380,"หลักสอง","เขตบางแค",104004,"โรงเรียนวัดราษฎร์บำรุง",51,234,315,394,709
5381,"หลักสอง","เขตบางแค",104004,"โรงเรียนวัดราษฎร์บำรุง",52,294,348,371,719
5382,"หลักสอง","เขตบางแค",104004,"โรงเรียนวัดราษฎร์บำรุง",53,307,297,395,692
5383,"หลักสอง","เขตบางแค",104004,"โรงเรียนวัดราษฎร์บำรุง",54,201,269,336,605
5384,"หลักสอง","เขตบางแค",104004,"โรงเรียนวัดราษฎร์บำรุง",55,224,291,353,644
5385,"หลักสอง","เขตบางแค",104004,"เต็นท์หน้าบริษัท ส.สรรพกิจค้าส่ง จำกัด ชุมชนบ้านขิง",56,146,256,309,565
5386,"หลักสอง","เขตบางแค",104004,"เต็นท์หน้าบริษัท ส.สรรพกิจค้าส่ง จำกัด ชุมชนบ้านขิง",57,125,298,289,587
5387,"หลักสอง","เขตบางแค",104004,"เต็นท์ลานจอดรถหน้าตลาดบางแคภิรมย์",58,272,376,438,814
5388,"หลักสอง","เขตบางแค",104004,"เต็นท์ลานจอดรถหน้าตลาดบางแคภิรมย์",59,268,364,463,827
5389,"หลักสอง","เขตบางแค",104004,"เต็นท์ บีบี3 เซ็นเตอร์พอยท์ ถนนบางบอน 3",60,221,271,334,605
5390,"หลักสอง","เขตบางแค",104004,"เต็นท์ บีบี3 เซ็นเตอร์พอยท์ ถนนบางบอน 3",61,228,259,326,585
5391,"หลักสอง","เขตบางแค",104004,"ชั้นล่างอาคารสงเคราะห์ข้าราชการและลูกจ้างของกรุงเทพมหานครบางบอน",62,272,357,380,737
5392,"หลักสอง","เขตบางแค",104004,"ชั้นล่างอาคารสงเคราะห์ข้าราชการและลูกจ้างของกรุงเทพมหานครบางบอน",63,249,265,375,640
5393,"หลักสอง","เขตบางแค",104004,"เต็นท์หน้าบ้านเลขที่ 129/421 ซอยบางบอน 3 ซอย 14ใกล้ศูนย์สร้างสุขทุกวัยบางแค (เรืองสอน)",64,164,206,256,462
5394,"หลักสอง","เขตบางแค",104004,"เต็นท์หน้าบ้านเลขที่ 129/421 ซอยบางบอน 3 ซอย 14ใกล้ศูนย์สร้างสุขทุกวัยบางแค (เรืองสอน)",65,172,204,255,459
5395,"ทุ่งสองห้อง","เขตหลักสี่",104101,"เต็นท์ถนนน่านเจ้าริมบึงสีกัน (หมู่บ้านเมืองทอง 1)",1,266,321,389,710
5396,"ทุ่งสองห้อง","เขตหลักสี่",104101,"เต็นท์ถนนน่านเจ้าริมบึงสีกัน (หมู่บ้านเมืองทอง 1)",2,234,312,368,680
5397,"ทุ่งสองห้อง","เขตหลักสี่",104101,"เต็นท์ถนนน่านเจ้าริมบึงสีกัน (หมู่บ้านเมืองทอง 1)",3,252,316,389,705
5398,"ทุ่งสองห้อง","เขตหลักสี่",104101,"เต็นท์ถนนน่านเจ้าริมบึงสีกัน (หมู่บ้านเมืองทอง 1)",4,328,321,409,730
5399,"ทุ่งสองห้อง","เขตหลักสี่",104101,"ศาลากาญจนาภิเษก ซอยชมรมเกษตรนิเวศน์",5,279,305,387,692
5400,"ทุ่งสองห้อง","เขตหลักสี่",104101,"ศาลากาญจนภิเษก ซอยชมรมเกษตรนิเวศน์",6,264,311,359,670
5401,"ทุ่งสองห้อง","เขตหลักสี่",104101,"ศาลากาญจนภิเษก ซอยชมรมเกษตรนิเวศน์",7,251,298,362,660
5402,"ทุ่งสองห้อง","เขตหลักสี่",104101,"ศาลากาญจนภิเษก ซอยชมรมเกษตรนิเวศน์",8,292,310,389,699
5403,"ทุ่งสองห้อง","เขตหลักสี่",104101,"ศาลากาญจนภิเษก ซอยชมรมเกษตรนิเวศน์",9,315,284,400,684
5404,"ทุ่งสองห้อง","เขตหลักสี่",104101,"เต็นท์สนามเด็กเล่นหมู่บ้านพงษ์เพชรแจ้งวัฒนะ 14",10,231,308,342,650
5405,"ทุ่งสองห้อง","เขตหลักสี่",104101,"เต็นท์สนามเด็กเล่นหมู่บ้านพงษ์เพชรแจ้งวัฒนะ 14",11,260,274,369,643
5406,"ทุ่งสองห้อง","เขตหลักสี่",104101,"เต็นท์สนามเด็กเล่นหมู่บ้านพงษ์เพชรแจ้งวัฒนะ 14",12,211,273,313,586
5407,"ทุ่งสองห้อง","เขตหลักสี่",104101,"เต็นท์หน้าอาคารสโมสรหมู่บ้านชวนชื่น",13,227,277,339,616
5408,"ทุ่งสองห้อง","เขตหลักสี่",104101,"เต็นท์หน้าอาคารสำนักงาน 2 ศูนย์กิจกรรมชุมชนชวนชื่นบางเขน",14,248,281,366,647
5409,"ทุ่งสองห้อง","เขตหลักสี่",104101,"เต็นท์หน้าอาคารศูนย์กิจกรรมชุมชนชวนชื่นบางเขน",15,254,273,340,613
5410,"ทุ่งสองห้อง","เขตหลักสี่",104101,"เต็นท์ลานจอดรถหมู่บ้านเคหะแจ้งวัฒนะ (อาคาร A)",16,292,345,389,734
5411,"ทุ่งสองห้อง","เขตหลักสี่",104101,"เต็นท์ลานจอดรถหมู่บ้านเคหะแจ้งวัฒนะ (อาคาร A)",17,355,319,379,698
5412,"ทุ่งสองห้อง","เขตหลักสี่",104101,"เต็นท์ลานจอดรถหมู่บ้านเคหะแจ้งวัฒนะ (อาคาร A)",18,359,291,414,705
5413,"ทุ่งสองห้อง","เขตหลักสี่",104101,"เต็นท์ลานจอดรถหมู่บ้านเคหะแจ้งวัฒนะ (อาคาร A)",19,390,309,459,768
5414,"ทุ่งสองห้อง","เขตหลักสี่",104101,"เต็นท์บริเวณซอยแจ้งวัฒนะ 10 แยก 1",20,186,326,307,633
5415,"ทุ่งสองห้อง","เขตหลักสี่",104101,"เต็นท์บริเวณซอยแจ้งวัฒนะ 10 แยก 1",21,202,357,190,547
5416,"ทุ่งสองห้อง","เขตหลักสี่",104101,"เต็นท์บริเวณซอยแจ้งวัฒนะ 10 แยก 1",22,322,371,337,708
5417,"ทุ่งสองห้อง","เขตหลักสี่",104101,"เต็นท์บริเวณซอยแจ้งวัฒนะ 10 แยก 1",23,274,319,423,742
5418,"ทุ่งสองห้อง","เขตหลักสี่",104101,"เต็นท์บริเวณซอยแจ้งวัฒนะ 10 แยก 1",24,350,299,433,732
5419,"ทุ่งสองห้อง","เขตหลักสี่",104101,"เต็นท์บริเวณซอยแจ้งวัฒนะ 10 แยก 1",25,251,325,413,738
5420,"ทุ่งสองห้อง","เขตหลักสี่",104101,"เต็นท์บริเวณซอยแจ้งวัฒนะ 10 แยก 1",26,314,276,377,653
5421,"ทุ่งสองห้อง","เขตหลักสี่",104101,"เต็นท์บริเวณซอยแจ้งวัฒนะ 10 แยก 1",27,289,333,406,739
5422,"ทุ่งสองห้อง","เขตหลักสี่",104101,"เต็นท์บริเวณซอยแจ้งวัฒนะ 10 แยก 1",28,265,347,419,766
5423,"ทุ่งสองห้อง","เขตหลักสี่",104101,"เต็นท์บริเวณซอยแจ้งวัฒนะ 10 แยก 1",29,241,291,387,678
5424,"ทุ่งสองห้อง","เขตหลักสี่",104101,"เต็นท์บริเวณซอยแจ้งวัฒนะ 10 แยก 1",30,233,310,378,688
5425,"ทุ่งสองห้อง","เขตหลักสี่",104101,"อาคารสงเคราะห์ข้าราชการกรุงเทพมหานคร หลักสี่",31,204,198,290,488
5426,"ทุ่งสองห้อง","เขตหลักสี่",104101,"อาคารสงเคราะห์ข้าราชการกรุงเทพมหานคร หลักสี่",32,206,327,212,539
5427,"ทุ่งสองห้อง","เขตหลักสี่",104101,"อาคารสงเคราะห์ข้าราชการกรุงเทพมหานคร หลักสี่",33,306,357,113,470
5428,"ทุ่งสองห้อง","เขตหลักสี่",104101,"อาคารสงเคราะห์ข้าราชการกรุงเทพมหานคร หลักสี่",34,271,349,153,502
5429,"ทุ่งสองห้อง","เขตหลักสี่",104101,"อาคารสงเคราะห์ข้าราชการกรุงเทพมหานคร หลักสี่",35,74,462,132,594
5430,"ทุ่งสองห้อง","เขตหลักสี่",104101,"โรงเรียนเคหะทุ่งสองห้องวิทยา 2 (โรงอาหาร)",36,228,322,354,676
5431,"ทุ่งสองห้อง","เขตหลักสี่",104101,"โรงเรียนเคหะทุ่งสองห้องวิทยา 2 (โรงอาหาร)",37,206,294,378,672
5432,"ทุ่งสองห้อง","เขตหลักสี่",104101,"โรงเรียนเคหะทุ่งสองห้องวิทยา 2 (อาคาร 3)",38,230,306,355,661
5433,"ทุ่งสองห้อง","เขตหลักสี่",104101,"โรงเรียนเคหะทุ่งสองห้องวิทยา 2 (อาคาร 3)",39,211,284,340,624
5434,"ทุ่งสองห้อง","เขตหลักสี่",104101,"เต็นท์ลานเอนกประสงค์โรงเรียนเคหะทุ่งสองห้องวิทยา 2",40,232,323,383,706
5435,"ทุ่งสองห้อง","เขตหลักสี่",104101,"เต็นท์ลานเอนกประสงค์โรงเรียนเคหะทุ่งสองห้องวิทยา 2",41,200,299,374,673
5436,"ทุ่งสองห้อง","เขตหลักสี่",104101,"โรงเรียนเคหะทุ่งสองห้องวิทยา 1 (โรงอาหาร)",42,218,273,331,604
5437,"ทุ่งสองห้อง","เขตหลักสี่",104101,"โรงเรียนเคหะทุ่งสองห้องวิทยา 1 (โรงอาหาร)",43,239,262,360,622
5438,"ทุ่งสองห้อง","เขตหลักสี่",104101,"โรงเรียนเคหะทุ่งสองห้องวิทยา 1 (โรงอาหาร)",44,233,293,361,654
5439,"ทุ่งสองห้อง","เขตหลักสี่",104101,"โรงเรียนเคหะทุ่งสองห้องวิทยา 1 (หน้าอาคาร 3)",45,216,294,355,649
5440,"ทุ่งสองห้อง","เขตหลักสี่",104101,"โรงเรียนเคหะทุ่งสองห้องวิทยา 1 (หน้าอาคาร 3)",46,227,272,328,600
5441,"ทุ่งสองห้อง","เขตหลักสี่",104101,"โรงเรียนเคหะทุ่งสองห้องวิทยา 1 (หน้าอาคาร 3)",47,348,294,401,695
5442,"ทุ่งสองห้อง","เขตหลักสี่",104101,"เต็นท์ลานจอดรถอาคารที่พักอาศัย บริษัท โทรคมนาคมแห่งชาติ",48,172,289,329,618
5443,"ทุ่งสองห้อง","เขตหลักสี่",104101,"เต็นท์ลานจอดรถอาคารที่พักอาศัย บริษัท โทรคมนาคมแห่งชาติ",49,315,331,217,548
5444,"ทุ่งสองห้อง","เขตหลักสี่",104101,"เต็นท์หน้าแฟลตการเคหะหลักสี่ อาคาร 11",50,356,277,368,645
5445,"ทุ่งสองห้อง","เขตหลักสี่",104101,"เต็นท์หน้าแฟลตการเคหะหลักสี่ อาคาร 12",51,346,251,371,622
5446,"ทุ่งสองห้อง","เขตหลักสี่",104101,"เต็นท์หน้าแฟลตการเคหะหลักสี่ อาคาร 13",52,379,273,375,648
5447,"ทุ่งสองห้อง","เขตหลักสี่",104101,"เต็นท์ที่จอดรถบริษัทยูซีไอ มีเดีย จำกัด(ทางเข้าหมู่บ้านเบเวอรี่ฮิลส์)",53,1,624,29,653
5448,"ทุ่งสองห้อง","เขตหลักสี่",104101,"เต็นท์ที่จอดรถบริษัทยูซีไอ มีเดีย จำกัด (ทางเข้าหมู่บ้านเบเวอรี่ฮิลส์)",54,297,284,200,484
5449,"ทุ่งสองห้อง","เขตหลักสี่",104101,"เต็นท์ที่จอดรถธนาคารกรุงไทย สาขาแจ้งวัฒนะ",55,207,232,295,527
5450,"ทุ่งสองห้อง","เขตหลักสี่",104101,"เต็นท์ที่จอดรถธนาคารกรุงไทย สาขาแจ้งวัฒนะ",56,132,233,191,424
5451,"ทุ่งสองห้อง","เขตหลักสี่",104101,"เต็นท์ที่จอดรถธนาคารกรุงไทย สาขาแจ้งวัฒนะ",57,198,193,276,469
5452,"ทุ่งสองห้อง","เขตหลักสี่",104101,"สโมสรกีฬาท้ายหมู่บ้าน กฟภ.นิเวศน์ 2",58,232,307,338,645
5453,"ทุ่งสองห้อง","เขตหลักสี่",104101,"สโมสรกีฬาท้ายหมู่บ้าน กฟภ.นิเวศน์ 2",59,243,286,371,657
5454,"ทุ่งสองห้อง","เขตหลักสี่",104101,"เต็นท์หมู่บ้านจัดสรรการรถไฟทุ่งสองห้อง (ซอย 4)",60,186,249,327,576
5455,"ทุ่งสองห้อง","เขตหลักสี่",104101,"เต็นท์หมู่บ้านจัดสรรการรถไฟทุ่งสองห้อง (ซอย 4)",61,162,287,312,599
5456,"ทุ่งสองห้อง","เขตหลักสี่",104101,"เต็นท์หมู่บ้านจัดสรรการรถไฟทุ่งสองห้อง (ซอย 4)",62,187,264,326,590
5457,"ทุ่งสองห้อง","เขตหลักสี่",104101,"เต็นท์หมู่บ้านจัดสรรการรถไฟทุ่งสองห้อง (ซอย 4)",63,238,291,353,644
5458,"ทุ่งสองห้อง","เขตหลักสี่",104101,"เต็นท์ทางเข้าหมู่บ้านเจริญทรัพย์ ซอยวิภาวดี 25 (แยก 1)",64,259,357,395,752
5459,"ทุ่งสองห้อง","เขตหลักสี่",104101,"เต็นท์ทางเข้าหมู่บ้านเจริญทรัพย์ ซอยวิภาวดี 25 (แยก 1)",65,213,374,404,778
5460,"ทุ่งสองห้อง","เขตหลักสี่",104101,"ใต้ถุนแฟลตตำรวจส่วนกลางทุ่งสองห้อง (อาคาร 7)",66,267,271,265,536
5461,"ทุ่งสองห้อง","เขตหลักสี่",104101,"ใต้ถุนแฟลตตำรวจส่วนกลางทุ่งสองห้อง (อาคาร 7)",67,238,296,372,668
5462,"ทุ่งสองห้อง","เขตหลักสี่",104101,"โรงเรียนชาลีสมุทร",68,334,349,503,852
5463,"ทุ่งสองห้อง","เขตหลักสี่",104101,"โรงเรียนชาลีสมุทร",69,661,361,502,863
5464,"ทุ่งสองห้อง","เขตหลักสี่",104101,"โรงเรียนชาลีสมุทร",70,301,346,499,845
5465,"ทุ่งสองห้อง","เขตหลักสี่",104101,"โรงเรียนชาลีสมุทร",71,294,390,458,848
5466,"ทุ่งสองห้อง","เขตหลักสี่",104101,"ที่จอดรถแฟลตพงษ์เพชรไฮแอท ซอยงามวงศ์วาน 30",72,238,280,377,657
5467,"ทุ่งสองห้อง","เขตหลักสี่",104101,"ที่จอดรถแฟลตพงษ์เพชรไฮแอท ซอยงามวงศ์วาน 30",73,234,294,378,672
5468,"ทุ่งสองห้อง","เขตหลักสี่",104101,"ที่จอดรถแฟลตพงษ์เพชรไฮแอท ซอยงามวงศ์วาน 30",74,283,329,418,747
5469,"ทุ่งสองห้อง","เขตหลักสี่",104101,"โรงเรียนราชวินิตบางเขน",75,244,324,379,703
5470,"ทุ่งสองห้อง","เขตหลักสี่",104101,"โรงเรียนราชวินิตบางเขน",76,268,307,391,698
5471,"ทุ่งสองห้อง","เขตหลักสี่",104101,"โรงเรียนราชวินิตบางเขน",77,344,314,411,725
5472,"ทุ่งสองห้อง","เขตหลักสี่",104101,"โรงเรียนราชวินิตบางเขน",78,265,292,339,631
5473,"ทุ่งสองห้อง","เขตหลักสี่",104101,"โรงเรียนราชวินิตบางเขน",79,311,324,410,734
5474,"ทุ่งสองห้อง","เขตหลักสี่",104101,"โรงเรียนราชวินิตบางเขน",80,290,339,411,750
5475,"ทุ่งสองห้อง","เขตหลักสี่",104101,"โรงเรียนราชวินิตบางเขน",81,282,361,437,798
5476,"ทุ่งสองห้อง","เขตหลักสี่",104101,"โรงเรียนราชวินิตบางเขน",82,384,375,408,783
5477,"ทุ่งสองห้อง","เขตหลักสี่",104101,"โรงเรียนราชวินิตบางเขน",83,305,324,422,746
5478,"ทุ่งสองห้อง","เขตหลักสี่",104101,"โรงเรียนราชวินิตบางเขน",84,265,353,425,778
5479,"ทุ่งสองห้อง","เขตหลักสี่",104101,"โรงเรียนการเคหะท่าทราย (ห้องประชุมอาคาร 5)",85,263,298,412,710
5480,"ทุ่งสองห้อง","เขตหลักสี่",104101,"โรงเรียนการเคหะท่าทราย (ห้องประชุมอาคาร 5)",86,337,327,410,737
5481,"ทุ่งสองห้อง","เขตหลักสี่",104101,"โรงเรียนการเคหะท่าทราย (ห้องประชุมอาคาร 1)",87,240,251,385,636
5482,"ทุ่งสองห้อง","เขตหลักสี่",104101,"โรงเรียนการเคหะท่าทราย (ห้องประชุมอาคาร 1)",88,228,304,394,698
5483,"ทุ่งสองห้อง","เขตหลักสี่",104101,"เต็นท์ในโรงอาหารโรงเรียนการเคหะท่าทราย",89,243,289,386,675
5484,"ทุ่งสองห้อง","เขตหลักสี่",104101,"เต็นท์ในโรงอาหารโรงเรียนการเคหะท่าทราย",90,242,283,384,667
5485,"ทุ่งสองห้อง","เขตหลักสี่",104101,"เต็นท์ในโรงอาหารโรงเรียนการเคหะท่าทราย",91,212,269,346,615
5486,"ตลาดบางเขน","เขตหลักสี่",104102,"โรงเรียนบางเขน (ห้องประชุม อาคาร 3)",1,148,227,153,380
5487,"ตลาดบางเขน","เขตหลักสี่",104102,"โรงเรียนบางเขน (ห้องประชุม อาคาร 3)",2,116,220,239,459
5488,"ตลาดบางเขน","เขตหลักสี่",104102,"โรงเรียนบางเขน (ห้องประชุม อาคาร 3)",3,168,297,335,632
5489,"ตลาดบางเขน","เขตหลักสี่",104102,"เต็นท์ในร้านบีบีจักรยาน ซอยวิภาวดีรังสิต 60 แยก 1",4,305,349,475,824
5490,"ตลาดบางเขน","เขตหลักสี่",104102,"เต็นท์ในร้านบีบีจักรยาน ซอยวิภาวดีรังสิต 60 แยก 1",5,397,390,483,873
5491,"ตลาดบางเขน","เขตหลักสี่",104102,"ใต้ถุนแฟลตการเคหะบางบัว (แฟลต 3)",6,281,386,421,807
5492,"ตลาดบางเขน","เขตหลักสี่",104102,"ใต้ถุนแฟลตการเคหะบางบัว (แฟลต 3)",7,283,315,403,718
5493,"ตลาดบางเขน","เขตหลักสี่",104102,"ใต้ถุนแฟลตการเคหะบางบัว (แฟลต 3)",8,295,319,419,738
5494,"ตลาดบางเขน","เขตหลักสี่",104102,"ใต้ถุนแฟลตการเคหะบางบัว (แฟลต 3)",9,305,333,455,788
5495,"ตลาดบางเขน","เขตหลักสี่",104102,"เต็นท์ในสถานพักฟื้นคนชราบางเขน",10,256,298,376,674
5496,"ตลาดบางเขน","เขตหลักสี่",104102,"เต็นท์ในสถานพักฟื้นคนชราบางเขน",11,224,292,323,615
5497,"ตลาดบางเขน","เขตหลักสี่",104102,"เต็นท์ในสถานพักฟื้นคนชราบางเขน",12,340,350,426,776
5498,"ตลาดบางเขน","เขตหลักสี่",104102,"เต็นท์ในสถานพักฟื้นคนชราบางเขน",13,306,308,411,719
5499,"ตลาดบางเขน","เขตหลักสี่",104102,"เต็นท์ในสถานพักฟื้นคนชราบางเขน",14,360,341,452,793
5500,"ตลาดบางเขน","เขตหลักสี่",104102,"เต็นท์ในสถานพักฟื้นคนชราบางเขน",15,275,386,321,707
5501,"ตลาดบางเขน","เขตหลักสี่",104102,"เต็นท์ในสถานพักฟื้นคนชราบางเขน",16,286,324,354,678
5502,"ตลาดบางเขน","เขตหลักสี่",104102,"เต็นท์ในสถานพักฟื้นคนชราบางเขน",17,189,313,335,648
5503,"ตลาดบางเขน","เขตหลักสี่",104102,"เต็นท์ในสถานพักฟื้นคนชราบางเขน",18,227,343,393,736
5504,"ตลาดบางเขน","เขตหลักสี่",104102,"ใต้ถุนแฟลตการเคหะบางบัว (แฟลต 13)",19,225,325,386,711
5505,"ตลาดบางเขน","เขตหลักสี่",104102,"ใต้ถุนแฟลตการเคหะบางบัว (แฟลต 13)",20,346,312,375,687
5506,"ตลาดบางเขน","เขตหลักสี่",104102,"ใต้ถุนแฟลตการเคหะบางบัว (แฟลต 13)",21,353,302,408,710
5507,"ตลาดบางเขน","เขตหลักสี่",104102,"ใต้ถุนแฟลตการเคหะบางบัว (แฟลต 13)",22,303,276,430,706
5508,"ตลาดบางเขน","เขตหลักสี่",104102,"เต็นท์ในโรงเรียนวัดหลักสี่",23,312,355,431,786
5509,"ตลาดบางเขน","เขตหลักสี่",104102,"เต็นท์ในโรงเรียนวัดหลักสี่",24,268,373,417,790
5510,"ตลาดบางเขน","เขตหลักสี่",104102,"เต็นท์ในโรงเรียนวัดหลักสี่",25,344,373,421,794
5511,"ตลาดบางเขน","เขตหลักสี่",104102,"เต็นท์ในโรงเรียนวัดหลักสี่",26,295,375,429,804
5512,"ตลาดบางเขน","เขตหลักสี่",104102,"เต็นท์ในโรงเรียนวัดหลักสี่",27,521,323,473,796
5513,"ตลาดบางเขน","เขตหลักสี่",104102,"เต็นท์ในโรงเรียนวัดหลักสี่",28,309,347,446,793
5514,"ตลาดบางเขน","เขตหลักสี่",104102,"เต็นท์ในโรงเรียนวัดหลักสี่",29,422,339,455,794
5515,"ตลาดบางเขน","เขตหลักสี่",104102,"เต็นท์ในโรงเรียนวัดหลักสี่",30,414,318,482,800
5516,"ตลาดบางเขน","เขตหลักสี่",104102,"เต็นท์ในโรงเรียนวัดหลักสี่",31,714,335,489,824
5517,"สายไหม","เขตสายไหม",104201,"ลานอเนกประสงค์โรงเรียนวัดหนองใหญ่",1,338,386,407,793
5518,"สายไหม","เขตสายไหม",104201,"ลานอเนกประสงค์โรงเรียนวัดหนองใหญ่",2,421,334,441,775
5519,"สายไหม","เขตสายไหม",104201,"ลานอเนกประสงค์โรงเรียนวัดหนองใหญ่",3,369,378,429,807
5520,"สายไหม","เขตสายไหม",104201,"ลานอเนกประสงค์โรงเรียนวัดหนองใหญ่",4,373,303,463,766
5521,"สายไหม","เขตสายไหม",104201,"ลานอเนกประสงค์โรงเรียนวัดหนองใหญ่",5,361,333,477,810
5522,"สายไหม","เขตสายไหม",104201,"ลานอเนกประสงค์โรงเรียนวัดหนองใหญ่",6,337,400,514,914
5523,"สายไหม","เขตสายไหม",104201,"ลานอเนกประสงค์โรงเรียนวัดหนองใหญ่",7,307,352,416,768
5524,"สายไหม","เขตสายไหม",104201,"โรงเรียนวัดหนองใหญ่ห้องเรียนอาคาร 3 ชั้น 1",8,311,331,459,790
5525,"สายไหม","เขตสายไหม",104201,"โรงเรียนวัดหนองใหญ่ห้องเรียนอาคาร 3 ชั้น 1",9,328,364,437,801
5526,"สายไหม","เขตสายไหม",104201,"โรงอาหารโรงเรียนวัดหนองใหญ่",10,271,327,432,759
5527,"สายไหม","เขตสายไหม",104201,"โรงอาหารโรงเรียนวัดหนองใหญ่",11,377,378,503,881
5528,"สายไหม","เขตสายไหม",104201,"เต็นท์ในบริเวณลานกีฬาหมู่บ้านอัมรินทร์นิเวศน์ 3 ผัง 2",12,191,289,319,608
5529,"สายไหม","เขตสายไหม",104201,"เต็นท์ในบริเวณลานกีฬาหมู่บ้านอัมรินทร์นิเวศน์ 3 ผัง 2",13,227,292,311,603
5530,"สายไหม","เขตสายไหม",104201,"เต็นท์บริเวณตลาดสายไหม 43",14,258,273,367,640
5531,"สายไหม","เขตสายไหม",104201,"เต็นท์บริเวณตลาดสายไหม 43",15,336,309,440,749
5532,"สายไหม","เขตสายไหม",104201,"เต็นท์บริเวณตลาดสายไหม 43",16,403,371,439,810
5533,"สายไหม","เขตสายไหม",104201,"เต็นท์บริเวณหมู่บ้านซิลค์วิลเลจ",17,205,227,298,525
5534,"สายไหม","เขตสายไหม",104201,"เต็นท์บริเวณหมู่บ้านซิลค์วิลเลจ",18,215,226,303,529
5535,"สายไหม","เขตสายไหม",104201,"เต็นท์บริเวณหมู่บ้านพฤกษาไพร์ม",19,373,336,418,754
5536,"สายไหม","เขตสายไหม",104201,"เต็นท์บริเวณหน้าหมู่บ้านรัชธานี 6",20,300,335,411,746
5537,"สายไหม","เขตสายไหม",104201,"เต็นท์บริเวณหน้าหมู่บ้านรัชธานี 6",21,256,294,379,673
5538,"สายไหม","เขตสายไหม",104201,"เต็นท์บริเวณหน้าหมู่บ้านรัชธานี 6",22,307,344,455,799
5539,"สายไหม","เขตสายไหม",104201,"เต็นท์ในบริเวณสนามเด็กเล่นหมู่บ้านทัพฟ้า",23,176,251,271,522
5540,"สายไหม","เขตสายไหม",104201,"เต็นท์ในบริเวณสนามเด็กเล่นหมู่บ้านทัพฟ้า",24,186,226,309,535
5541,"สายไหม","เขตสายไหม",104201,"เต็นท์บริเวณสวนหย่อมท้ายซอยสายไหม 34 (พัธนชัย)",25,189,217,254,471
5542,"สายไหม","เขตสายไหม",104201,"เต็นท์บริเวณสวนหย่อมท้ายซอยสายไหม 34 (พัธนชัย)",26,182,234,245,479
5543,"สายไหม","เขตสายไหม",104201,"เต็นท์บริเวณปากซอยหมู่บ้านอัมรินทร์นิเวศน์  3 ผัง 3",27,204,222,270,492
5544,"สายไหม","เขตสายไหม",104201,"เต็นท์บริเวณปากซอยหมู่บ้านอัมรินทร์นิเวศน์  3 ผัง 3",28,217,260,316,576
5545,"สายไหม","เขตสายไหม",104201,"ลานอเนกประสงค์โรงเรียนประชานุกูล",29,252,337,378,715
5546,"สายไหม","เขตสายไหม",104201,"ลานอเนกประสงค์โรงเรียนประชานุกูล",30,267,335,364,699
5547,"สายไหม","เขตสายไหม",104201,"ลานอเนกประสงค์โรงเรียนประชานุกูล",31,276,342,422,764
5548,"สายไหม","เขตสายไหม",104201,"ลานอเนกประสงค์โรงเรียนประชานุกูล",32,218,272,309,581
5549,"สายไหม","เขตสายไหม",104201,"ลานอเนกประสงค์โรงเรียนสายไหม",33,295,390,433,823
5550,"สายไหม","เขตสายไหม",104201,"ลานอเนกประสงค์โรงเรียนสายไหม",34,352,367,462,829
5551,"สายไหม","เขตสายไหม",104201,"ลานอเนกประสงค์โรงเรียนสายไหม",35,498,419,515,934
5552,"สายไหม","เขตสายไหม",104201,"ลานอเนกประสงค์โรงเรียนสายไหม",36,449,390,521,911
5553,"สายไหม","เขตสายไหม",104201,"ลานอเนกประสงค์โรงเรียนสายไหม",37,376,399,497,896
5554,"สายไหม","เขตสายไหม",104201,"ลานอเนกประสงค์โรงเรียนสายไหม",38,328,312,431,743
5555,"สายไหม","เขตสายไหม",104201,"ลานอเนกประสงค์หมู่บ้านกรุงทองธานี (ซอยสายไหม 33)",39,324,344,411,755
5556,"สายไหม","เขตสายไหม",104201,"ลานอเนกประสงค์หมู่บ้านกรุงทองธานี (ซอยสายไหม 33)",40,318,339,425,764
5557,"สายไหม","เขตสายไหม",104201,"ศาลาวัดเจริญธรรมาราม (วัดศูนย์)",41,234,333,333,666
5558,"สายไหม","เขตสายไหม",104201,"เต็นท์ในบริเวณลานกีฬาหมู่บ้านอัมรินทร์นิเวศน์ 3 ผัง 1",42,226,299,351,650
5559,"สายไหม","เขตสายไหม",104201,"เต็นท์ในบริเวณลานกีฬาหมู่บ้านอัมรินทร์นิเวศน์ 3 ผัง 1",43,269,312,383,695
5560,"สายไหม","เขตสายไหม",104201,"เต็นท์ในบริเวณหมู่บ้านอัมรินทร์นิเวศน์ 3 ผัง 4",44,231,259,331,590
5561,"สายไหม","เขตสายไหม",104201,"เต็นท์ในบริเวณหมู่บ้านอัมรินทร์นิเวศน์ 3 ผัง 4",45,216,259,329,588
5562,"สายไหม","เขตสายไหม",104201,"เต็นท์ในบริเวณหมู่บ้านอัมรินทร์นิเวศน์ 3 ผัง 4",46,234,268,320,588
5563,"สายไหม","เขตสายไหม",104201,"เต็นท์ในบริเวณหมู่บ้านอัมรินทร์นิเวศน์ 3 ผัง 4",47,257,272,333,605
5564,"สายไหม","เขตสายไหม",104201,"เต็นท์บริเวณหน้าหมู่บ้านรัชธานี 7",48,375,422,471,893
5565,"สายไหม","เขตสายไหม",104201,"เต็นท์บริเวณหน้าหมู่บ้านรัชธานี 7",49,285,383,463,846
5566,"สายไหม","เขตสายไหม",104201,"เต็นท์บริเวณหน้าหมู่บ้านรัชธานี 7",50,368,379,455,834
5567,"สายไหม","เขตสายไหม",104201,"เต็นท์บริเวณหน้าหมู่บ้านรัชธานี 7",51,378,377,521,898
5568,"สายไหม","เขตสายไหม",104201,"เต็นท์บริเวณหน้าหมู่บ้านรัชธานี 7",52,271,355,424,779
5569,"สายไหม","เขตสายไหม",104201,"เต็นท์ในบริเวณโครงการบ้านเอื้ออาทรสายไหม (อาคาร 27)",53,299,292,355,647
5570,"สายไหม","เขตสายไหม",104201,"เต็นท์ในบริเวณโครงการบ้านเอื้ออาทรสายไหม (อาคาร 27)",54,376,356,444,800
5571,"สายไหม","เขตสายไหม",104201,"เต็นท์ในบริเวณโครงการบ้านเอื้ออาทรสายไหม (อาคาร 27)",55,335,318,413,731
5572,"สายไหม","เขตสายไหม",104201,"เต็นท์ในบริเวณโครงการบ้านเอื้ออาทรสายไหม (อาคาร 27)",56,319,299,386,685
5573,"สายไหม","เขตสายไหม",104201,"เต็นท์ในบริเวณโครงการบ้านเอื้ออาทรสายไหม (อาคาร 27)",57,343,277,394,671
5574,"สายไหม","เขตสายไหม",104201,"เต็นท์ในบริเวณตลาดประตูกรุงเทพ (กม.25)",58,290,339,422,761
5575,"สายไหม","เขตสายไหม",104201,"เต็นท์ในบริเวณตลาดประตูกรุงเทพ (กม.25)",59,265,298,375,673
5576,"สายไหม","เขตสายไหม",104201,"เต็นท์ในบริเวณตลาดประตูกรุงเทพ (กม.25)",60,266,327,446,773
5577,"สายไหม","เขตสายไหม",104201,"เต็นท์ในบริเวณตลาดประตูกรุงเทพ (กม.25)",61,268,326,427,753
5578,"สายไหม","เขตสายไหม",104201,"เต็นท์บริเวณหน้าร้านแหนมดอนเมือง",62,344,359,469,828
5579,"สายไหม","เขตสายไหม",104201,"เต็นท์บริเวณหน้าร้านแหนมดอนเมือง",63,273,335,383,718
5580,"สายไหม","เขตสายไหม",104201,"เต็นท์บริเวณหน้าร้านแหนมดอนเมือง",64,271,344,453,797
5581,"สายไหม","เขตสายไหม",104201,"เต็นท์บริเวณหน้าร้านแหนมดอนเมือง",65,260,329,407,736
5582,"สายไหม","เขตสายไหม",104201,"ลานอเนกประสงค์โรงเรียนซอยแอนเนกซ์",66,265,336,409,745
5583,"สายไหม","เขตสายไหม",104201,"ลานอเนกประสงค์โรงเรียนซอยแอนเนกซ์",67,267,314,402,716
5584,"สายไหม","เขตสายไหม",104201,"ลานอเนกประสงค์โรงเรียนซอยแอนเนกซ์",68,233,309,396,705
5585,"สายไหม","เขตสายไหม",104201,"ลานอเนกประสงค์โรงเรียนซอยแอนเนกซ์",69,257,325,429,754
5586,"สายไหม","เขตสายไหม",104201,"ลานอเนกประสงค์โรงเรียนซอยแอนเนกซ์",70,248,318,407,725
5587,"สายไหม","เขตสายไหม",104201,"เต็นท์ในบริเวณลานอเนกประสงค์หมู่บ้านนภาวัลย์",71,382,407,502,909
5588,"สายไหม","เขตสายไหม",104201,"เต็นท์ในบริเวณลานอเนกประสงค์หมู่บ้านนภาวัลย์",72,358,430,485,915
5589,"สายไหม","เขตสายไหม",104201,"เต็นท์บริเวณหน้าหมู่บ้านนภาวัลย์",73,178,294,316,610
5590,"สายไหม","เขตสายไหม",104201,"เต็นท์บริเวณหน้าหมู่บ้านนภาวัลย์",74,213,282,345,627
5591,"สายไหม","เขตสายไหม",104201,"เต็นท์ในบริเวณลานอเนกประสงค์หมู่บ้านชลลดา",75,285,332,454,786
5592,"สายไหม","เขตสายไหม",104201,"เต็นท์ในบริเวณลานอเนกประสงค์หมู่บ้านชลลดา",76,313,329,427,756
5593,"สายไหม","เขตสายไหม",104201,"เต็นท์ในบริเวณหมู่บ้านชัยพัฒน์",77,197,227,261,488
5594,"สายไหม","เขตสายไหม",104201,"เต็นท์ในบริเวณหมู่บ้านชัยพัฒน์",78,200,231,266,497
5595,"สายไหม","เขตสายไหม",104201,"เต็นท์ในบริเวณหมู่บ้านบุศรินทร์",79,274,349,406,755
5596,"สายไหม","เขตสายไหม",104201,"เต็นท์ในบริเวณหมู่บ้านบุศรินทร์",80,352,321,390,711
5597,"สายไหม","เขตสายไหม",104201,"เต็นท์ในบริเวณหมู่บ้านบุศรินทร์",81,263,324,410,734
5598,"สายไหม","เขตสายไหม",104201,"เต็นท์ในบริเวณหมู่บ้านบุศรินทร์",82,363,315,404,719
5599,"สายไหม","เขตสายไหม",104201,"เต็นท์ในบริเวณหมู่บ้านลีลาวดี (หมู่บ้านซื่อตรงเดิม)",83,375,375,468,843
5600,"สายไหม","เขตสายไหม",104201,"เต็นท์ในบริเวณหมู่บ้านลีลาวดี (หมู่บ้านซื่อตรงเดิม)",84,304,353,396,749
5601,"สายไหม","เขตสายไหม",104201,"เต็นท์ในบริเวณหมู่บ้านลีลาวดี (หมู่บ้านซื่อตรงเดิม)",85,325,391,481,872
5602,"สายไหม","เขตสายไหม",104201,"เต็นท์ในบริเวณหมู่บ้านลีลาวดี (หมู่บ้านซื่อตรงเดิม)",86,277,320,427,747
5603,"ออเงิน","เขตสายไหม",104202,"เต็นท์ในบริเวณสนามกีฬาหมู่บ้านณัฐกานต์",1,211,221,273,494
5604,"ออเงิน","เขตสายไหม",104202,"เต็นท์ในบริเวณสนามกีฬาหมู่บ้านณัฐกานต์",2,263,223,264,487
5605,"ออเงิน","เขตสายไหม",104202,"เต็นท์ในบริเวณสนามฟุตบอลเคหะออเงิน",3,327,431,470,901
5606,"ออเงิน","เขตสายไหม",104202,"เต็นท์ในบริเวณสนามฟุตบอลเคหะออเงิน",4,332,401,430,831
5607,"ออเงิน","เขตสายไหม",104202,"เต็นท์ในบริเวณสนามฟุตบอลเคหะออเงิน",5,377,392,490,882
5608,"ออเงิน","เขตสายไหม",104202,"เต็นท์ในบริเวณสนามฟุตบอลเคหะออเงิน",6,412,393,496,889
5609,"ออเงิน","เขตสายไหม",104202,"เต็นท์ในบริเวณสนามฟุตบอลเคหะออเงิน",7,451,442,451,893
5610,"ออเงิน","เขตสายไหม",104202,"เต็นท์ในบริเวณสนามฟุตบอลเคหะออเงิน",8,456,402,487,889
5611,"ออเงิน","เขตสายไหม",104202,"เต็นท์ในบริเวณสนามฟุตบอลเคหะออเงิน",9,409,412,470,882
5612,"ออเงิน","เขตสายไหม",104202,"เต็นท์ในบริเวณสนามฟุตบอลเคหะออเงิน",10,402,406,473,879
5613,"ออเงิน","เขตสายไหม",104202,"เต็นท์ในบริเวณสนามฟุตบอลเคหะออเงิน",11,395,416,474,890
5614,"ออเงิน","เขตสายไหม",104202,"เต็นท์ในบริเวณสนามฟุตบอลเคหะออเงิน",12,416,446,493,939
5615,"ออเงิน","เขตสายไหม",104202,"เต็นท์ในบริเวณสนามฟุตบอลเคหะออเงิน",13,356,405,472,877
5616,"ออเงิน","เขตสายไหม",104202,"เต็นท์ในบริเวณสนามฟุตบอลเคหะออเงิน",14,470,390,508,898
5617,"ออเงิน","เขตสายไหม",104202,"เต็นท์ในบริเวณสนามฟุตบอลเคหะออเงิน",15,457,390,463,853
5618,"ออเงิน","เขตสายไหม",104202,"เต็นท์ในบริเวณสนามฟุตบอลเคหะออเงิน",16,433,378,529,907
5619,"ออเงิน","เขตสายไหม",104202,"เต็นท์ในบริเวณสนามฟุตบอลเคหะออเงิน",17,437,357,493,850
5620,"ออเงิน","เขตสายไหม",104202,"ลานอเนกประสงค์โรงเรียนออเงิน",18,420,351,451,802
5621,"ออเงิน","เขตสายไหม",104202,"ลานอเนกประสงค์โรงเรียนออเงิน",19,451,383,457,840
5622,"ออเงิน","เขตสายไหม",104202,"ลานอเนกประสงค์โรงเรียนออเงิน",20,440,406,493,899
5623,"ออเงิน","เขตสายไหม",104202,"ลานอเนกประสงค์โรงเรียนออเงิน",21,427,342,462,804
5624,"ออเงิน","เขตสายไหม",104202,"ลานอเนกประสงค์โรงเรียนออเงิน",22,325,372,430,802
5625,"ออเงิน","เขตสายไหม",104202,"ลานอเนกประสงค์โรงเรียนออเงิน",23,289,356,388,744
5626,"ออเงิน","เขตสายไหม",104202,"เต็นท์ในบริเวณหมู่บ้านอัมพรเพลส 1",24,153,203,252,455
5627,"ออเงิน","เขตสายไหม",104202,"ลานอเนกประสงค์หมู่บ้านอัมพรเพลส 2",25,260,297,345,642
5628,"ออเงิน","เขตสายไหม",104202,"อาคารตลาดโครงการเคหะพรพระร่วงประสิทธิ์",26,293,290,302,592
5629,"ออเงิน","เขตสายไหม",104202,"อาคารตลาดโครงการเคหะพรพระร่วงประสิทธิ์",27,288,294,294,588
5630,"ออเงิน","เขตสายไหม",104202,"ลานอเนกประสงค์โรงเรียนพรพระร่วงประสิทธิ์",28,256,349,385,734
5631,"ออเงิน","เขตสายไหม",104202,"ลานอเนกประสงค์โรงเรียนพรพระร่วงประสิทธิ์",29,321,348,435,783
5632,"ออเงิน","เขตสายไหม",104202,"ลานอเนกประสงค์โรงเรียนพรพระร่วงประสิทธิ์",30,298,335,410,745
5633,"ออเงิน","เขตสายไหม",104202,"ลานอเนกประสงค์โรงเรียนพรพระร่วงประสิทธิ์",31,348,354,422,776
5634,"ออเงิน","เขตสายไหม",104202,"ศาลาอเนกประสงค์วัดพระร่วงประสิทธิ์",32,182,316,356,672
5635,"ออเงิน","เขตสายไหม",104202,"ศาลาอเนกประสงค์วัดพระร่วงประสิทธิ์",33,217,323,326,649
5636,"ออเงิน","เขตสายไหม",104202,"เต็นท์ในบริเวณหมู่บ้านตะวันนา",34,339,379,380,759
5637,"ออเงิน","เขตสายไหม",104202,"เต็นท์ในบริเวณหมู่บ้านตะวันนา",35,280,359,404,763
5638,"ออเงิน","เขตสายไหม",104202,"เต็นท์ในบริเวณหมู่บ้านตะวันนา",36,342,337,412,749
5639,"ออเงิน","เขตสายไหม",104202,"เต็นท์ในบริเวณหมู่บ้านตะวันนา",37,384,324,410,734
5640,"ออเงิน","เขตสายไหม",104202,"เต็นท์ในบริเวณหมู่บ้านตะวันนา",38,456,334,443,777
5641,"ออเงิน","เขตสายไหม",104202,"เต็นท์ในบริเวณวัดโคกจ้าหล่า ซอยจตุโชติ 14",39,245,380,433,813
5642,"ออเงิน","เขตสายไหม",104202,"เต็นท์ในบริเวณวัดโคกจ้าหล่า ซอยจตุโชติ 14",40,217,380,422,802
5643,"ออเงิน","เขตสายไหม",104202,"เต็นท์ในบริเวณวัดโคกจ้าหล่า ซอยจตุโชติ 14",41,354,389,425,814
5644,"ออเงิน","เขตสายไหม",104202,"เต็นท์ในบริเวณวัดโคกจ้าหล่า ซอยจตุโชติ 14",42,410,365,447,812
5645,"คลองถนน","เขตสายไหม",104203,"เต็นท์ในชุมชนพัฒนาหมู่ 1 บริเวณหน้าหมู่บ้านศุภาลัย พรีโม่",1,258,373,396,769
5646,"คลองถนน","เขตสายไหม",104203,"เต็นท์ในชุมชนพัฒนาหมู่ 1 บริเวณหน้าหมู่บ้านศุภาลัย พรีโม่",2,211,304,351,655
5647,"คลองถนน","เขตสายไหม",104203,"อาคารอเนกประสงค์ชุมชนดวงมณี",3,284,438,495,933
5648,"คลองถนน","เขตสายไหม",104203,"เต็นท์ในบริเวณวัดเกาะสุวรรณาราม",4,268,328,342,670
5649,"คลองถนน","เขตสายไหม",104203,"เต็นท์ในบริเวณวัดเกาะสุวรรณาราม",5,224,265,341,606
5650,"คลองถนน","เขตสายไหม",104203,"เต็นท์ในบริเวณวัดเกาะสุวรรณาราม",6,190,290,327,617
5651,"คลองถนน","เขตสายไหม",104203,"เต็นท์ในบริเวณวัดเกาะสุวรรณาราม",7,201,332,373,705
5652,"คลองถนน","เขตสายไหม",104203,"โรงเรียนวัดเกาะสุวรรณาราม อาคาร 3 (ราชาวดี)",8,289,299,356,655
5653,"คลองถนน","เขตสายไหม",104203,"โรงเรียนวัดเกาะสุวรรณาราม อาคาร 3 (ราชาวดี)",9,331,312,338,650
5654,"คลองถนน","เขตสายไหม",104203,"โรงเรียนวัดเกาะสุวรรณาราม อาคาร 4 (มัลลิกา)",10,302,268,336,604
5655,"คลองถนน","เขตสายไหม",104203,"โรงเรียนวัดเกาะสุวรรณาราม อาคาร 4 (มัลลิกา)",11,281,298,345,643
5656,"คลองถนน","เขตสายไหม",104203,"ลานอเนกประสงค์โรงเรียนวัดเกาะสุวรรณาราม",12,294,266,346,612
5657,"คลองถนน","เขตสายไหม",104203,"ลานอเนกประสงค์โรงเรียนวัดเกาะสุวรรณาราม",13,382,277,379,656
5658,"คลองถนน","เขตสายไหม",104203,"ลานอเนกประสงค์โรงเรียนวัดเกาะสุวรรณาราม",14,345,321,411,732
5659,"คลองถนน","เขตสายไหม",104203,"ลานอเนกประสงค์โรงเรียนวัดเกาะสุวรรณาราม",15,223,302,318,620
5660,"คลองถนน","เขตสายไหม",104203,"ลานอเนกประสงค์โรงเรียนวัดเกาะสุวรรณาราม",16,217,298,330,628
5661,"คลองถนน","เขตสายไหม",104203,"ลานอเนกประสงค์โรงเรียนวัดเกาะสุวรรณาราม",17,208,312,323,635
5662,"คลองถนน","เขตสายไหม",104203,"ลานอเนกประสงค์โรงเรียนวัดเกาะสุวรรณาราม",18,199,290,343,633
5663,"คลองถนน","เขตสายไหม",104203,"ลานอเนกประสงค์โรงเรียนวัดเกาะสุวรรณาราม",19,259,264,351,615
5664,"คลองถนน","เขตสายไหม",104203,"ลานอเนกประสงค์โรงเรียนวัดเกาะสุวรรณาราม",20,232,288,364,652
5665,"คลองถนน","เขตสายไหม",104203,"ลานอเนกประสงค์โรงเรียนวัดเกาะสุวรรณาราม",21,215,307,353,660
5666,"คลองถนน","เขตสายไหม",104203,"ลานอเนกประสงค์โรงเรียนวัดเกาะสุวรรณาราม",22,284,272,365,637
5667,"คลองถนน","เขตสายไหม",104203,"ลานอเนกประสงค์โรงเรียนวัดเกาะสุวรรณาราม",23,230,288,337,625
5668,"คลองถนน","เขตสายไหม",104203,"ลานอเนกประสงค์โรงเรียนวัดเกาะสุวรรณาราม",24,214,287,338,625
5669,"คลองถนน","เขตสายไหม",104203,"ลานอเนกประสงค์โรงเรียนวัดเกาะสุวรรณาราม",25,232,259,363,622
5670,"คลองถนน","เขตสายไหม",104203,"ลานอเนกประสงค์โรงเรียนวัดเกาะสุวรรณาราม",26,240,314,298,612
5671,"คลองถนน","เขตสายไหม",104203,"ศาลาอเนกประสงค์ศูนย์พัฒนาเด็กก่อนวัยเรียน (ชุมชนวัดลุ่มฯ)",27,196,279,360,639
5672,"คลองถนน","เขตสายไหม",104203,"ศาลาอเนกประสงค์ศูนย์พัฒนาเด็กก่อนวัยเรียน (ชุมชนวัดลุ่มฯ)",28,141,271,294,565
5673,"คลองถนน","เขตสายไหม",104203,"เต็นท์ในบริเวณสนามกีฬาหมู่บ้านจิตภาวรรณ 2-3",29,291,388,420,808
5674,"คลองถนน","เขตสายไหม",104203,"ลานอเนกประสงค์หมู่บ้านอรุณนิเวศน์",30,248,291,366,657
5675,"คลองถนน","เขตสายไหม",104203,"ลานอเนกประสงค์หมู่บ้านอรุณนิเวศน์",31,254,303,397,700
5676,"คลองถนน","เขตสายไหม",104203,"อาคารที่ทำการชุมชนหมู่บ้านเพิ่มสิน 1-2",32,201,287,330,617
5677,"คลองถนน","เขตสายไหม",104203,"เต็นท์ในบริเวณลานอเนกประสงค์ชุมชนหมู่บ้านเพิ่มสิน 1-2",33,203,295,319,614
5678,"คลองถนน","เขตสายไหม",104203,"เต็นท์ในบริเวณลานอเนกประสงค์ชุมชนหมู่บ้านเพิ่มสิน 1-2",34,248,293,351,644
5679,"คลองถนน","เขตสายไหม",104203,"เต็นท์ในบริเวณหมู่บ้านดอนเมืองวิลล่า 2",35,213,260,283,543
5680,"คลองถนน","เขตสายไหม",104203,"เต็นท์ในบริเวณหมู่บ้านดอนเมืองวิลล่า 2",36,200,227,282,509
5681,"คลองถนน","เขตสายไหม",104203,"เต็นท์ในบริเวณหมู่บ้านดอนเมืองวิลล่า 2",37,225,312,339,651
5682,"คลองถนน","เขตสายไหม",104203,"ลานอเนกประสงค์โรงเรียนฤทธิยะวรรณาลัย",38,1,680,0,680
5683,"คลองถนน","เขตสายไหม",104203,"ลานอเนกประสงค์โรงเรียนฤทธิยะวรรณาลัย",39,186,252,303,555
5684,"คลองถนน","เขตสายไหม",104203,"ลานอเนกประสงค์โรงเรียนฤทธิยะวรรณาลัย",40,264,335,246,581
5685,"คลองถนน","เขตสายไหม",104203,"ลานอเนกประสงค์โรงเรียนฤทธิยะวรรณาลัย",41,270,374,261,635
5686,"คลองถนน","เขตสายไหม",104203,"ลานอเนกประสงค์โรงเรียนฤทธิยะวรรณาลัย",42,298,336,278,614
5687,"คลองถนน","เขตสายไหม",104203,"ลานอเนกประสงค์โรงเรียนฤทธิยะวรรณาลัย",43,360,304,305,609
5688,"คลองถนน","เขตสายไหม",104203,"ลานอเนกประสงค์โรงเรียนฤทธิยะวรรณาลัย",44,435,443,237,680
5689,"คลองถนน","เขตสายไหม",104203,"เต็นท์ในสนามกีฬาโครงการบ้านเอื้ออาทรบางเขน (คลองถนน)",45,425,397,468,865
5690,"คลองถนน","เขตสายไหม",104203,"เต็นท์ในสนามกีฬาโครงการบ้านเอื้ออาทรบางเขน (คลองถนน)",46,417,366,467,833
5691,"คลองถนน","เขตสายไหม",104203,"เต็นท์ในสนามกีฬาโครงการบ้านเอื้ออาทรบางเขน (คลองถนน)",47,471,394,483,877
5692,"คลองถนน","เขตสายไหม",104203,"เต็นท์ในสนามกีฬาโครงการบ้านเอื้ออาทรบางเขน (คลองถนน)",48,403,377,468,845
5693,"คลองถนน","เขตสายไหม",104203,"เต็นท์ในสนามกีฬาโครงการบ้านเอื้ออาทรบางเขน (คลองถนน)",49,425,393,459,852
5694,"คลองถนน","เขตสายไหม",104203,"เต็นท์ในสนามกีฬาโครงการบ้านเอื้ออาทรบางเขน (คลองถนน)",50,472,436,465,901
5695,"คลองถนน","เขตสายไหม",104203,"เต็นท์ในบริเวณชุมชนรวมมิตรสัมพันธ์",51,229,274,337,611
5696,"คลองถนน","เขตสายไหม",104203,"เต็นท์ในบริเวณชุมชนรวมมิตรสัมพันธ์",52,230,341,424,765
5697,"คลองถนน","เขตสายไหม",104203,"เต็นท์ในบริเวณไทยธานีคอนโด",53,344,350,386,736
5698,"คลองถนน","เขตสายไหม",104203,"เต็นท์ในบริเวณไทยธานีคอนโด",54,361,365,475,840
5699,"คลองถนน","เขตสายไหม",104203,"เต็นท์ในบริเวณไทยธานีคอนโด",55,264,348,442,790
5700,"คลองถนน","เขตสายไหม",104203,"เต็นท์ในบริเวณไทยธานีคอนโด",56,236,296,363,659
5701,"คลองถนน","เขตสายไหม",104203,"เต็นท์ในบริเวณโรงเรียนไทยรัฐวิทยา 75 (ซอยวัชรพล 4)",57,407,392,467,859
5702,"คลองถนน","เขตสายไหม",104203,"เต็นท์ในบริเวณโรงเรียนไทยรัฐวิทยา 75 (ซอยวัชรพล 4)",58,374,313,415,728
5703,"คลองถนน","เขตสายไหม",104203,"เต็นท์ในบริเวณโรงเรียนไทยรัฐวิทยา 75 (ซอยวัชรพล 4)",59,412,347,514,861
5704,"คลองถนน","เขตสายไหม",104203,"เต็นท์ในบริเวณโรงเรียนไทยรัฐวิทยา 75 (ซอยวัชรพล 4)",60,430,365,510,875
5705,"คลองถนน","เขตสายไหม",104203,"เต็นท์ในบริเวณโรงเรียนไทยรัฐวิทยา 75 (ซอยวัชรพล 4)",61,392,366,459,825
5706,"คลองถนน","เขตสายไหม",104203,"เต็นท์ในบริเวณโรงเรียนไทยรัฐวิทยา 75 (ซอยวัชรพล 4)",62,334,400,436,836
5707,"คลองถนน","เขตสายไหม",104203,"เต็นท์ในบริเวณโรงเรียนไทยรัฐวิทยา 75 (ซอยวัชรพล 4)",63,393,422,490,912
5708,"คลองถนน","เขตสายไหม",104203,"เต็นท์ในบริเวณโรงเรียนไทยรัฐวิทยา 75 (ซอยวัชรพล 4)",64,363,371,470,841
5709,"คลองถนน","เขตสายไหม",104203,"ลานอเนกประสงค์โรงเรียนวัดราษฎร์นิยมธรรม",65,288,387,478,865
5710,"คลองถนน","เขตสายไหม",104203,"ลานอเนกประสงค์โรงเรียนวัดราษฎร์นิยมธรรม",66,351,402,491,893
5711,"คลองถนน","เขตสายไหม",104203,"ลานอเนกประสงค์โรงเรียนวัดราษฎร์นิยมธรรม",67,345,431,497,928
5712,"คลองถนน","เขตสายไหม",104203,"ลานอเนกประสงค์โรงเรียนวัดราษฎร์นิยมธรรม",68,323,398,491,889
5713,"คลองถนน","เขตสายไหม",104203,"ลานอเนกประสงค์โรงเรียนวัดราษฎร์นิยมธรรม",69,351,392,474,866
5714,"คลองถนน","เขตสายไหม",104203,"ลานอเนกประสงค์โรงเรียนวัดราษฎร์นิยมธรรม",70,249,360,405,765
5715,"คลองถนน","เขตสายไหม",104203,"โรงเรียนวัดราษฎร์นิยมธรรม อาคาร 3 (ห้องประชุมแคแสด)",71,210,342,381,723
5716,"คลองถนน","เขตสายไหม",104203,"โรงเรียนวัดราษฎร์นิยมธรรม อาคาร 3 (ห้องประชุมแคแสด)",72,370,375,485,860
5717,"คลองถนน","เขตสายไหม",104203,"โรงเรียนวัดราษฎร์นิยมธรรม อาคาร 4 (ห้องอาหารพิกุลทอง)",73,294,337,427,764
5718,"คลองถนน","เขตสายไหม",104203,"เต็นท์บริเวณหน้าบวรคอนโด",74,193,256,279,535
5719,"คลองถนน","เขตสายไหม",104203,"เต็นท์บริเวณหน้าบวรคอนโด",75,258,236,348,584
5720,"คลองถนน","เขตสายไหม",104203,"เต็นท์บริเวณหน้าศศิธรคอนโด (ซอยเทพรักษ์ 25)",76,217,325,371,696
5721,"คลองถนน","เขตสายไหม",104203,"เต็นท์บริเวณหน้าศศิธรคอนโด (ซอยเทพรักษ์ 25)",77,237,260,324,584
5722,"คลองถนน","เขตสายไหม",104203,"เต็นท์บริเวณหน้าศศิธรคอนโด (ซอยเทพรักษ์ 25)",78,308,296,352,648
5723,"คลองถนน","เขตสายไหม",104203,"เต็นท์บริเวณหน้าหมู่บ้านสินทรัพย์นคร",79,194,216,252,468
5724,"คลองถนน","เขตสายไหม",104203,"เต็นท์บริเวณหน้าหมู่บ้านสินทรัพย์นคร (หน้าร้าน ป.กุ้งเผา)",80,179,186,269,455
5725,"คลองถนน","เขตสายไหม",104203,"อาคารเฉลิมพระเกียรติฯ มหาวิทยาลัยนอร์ทกรุงเทพ",81,320,216,293,509
5726,"คลองถนน","เขตสายไหม",104203,"อาคารเฉลิมพระเกียรติฯ มหาวิทยาลัยนอร์ทกรุงเทพ",82,157,271,298,569
5727,"คลองถนน","เขตสายไหม",104203,"เต็นท์ในบริเวณลานกีฬาชุมชน กสบ. หมู่ 5",83,190,291,337,628
5728,"คลองถนน","เขตสายไหม",104203,"เต็นท์ในบริเวณลานกีฬาชุมชน กสบ. หมู่ 5",84,303,308,369,677
5729,"คลองถนน","เขตสายไหม",104203,"เต็นท์ในบริเวณลานกีฬาชุมชน กสบ. หมู่ 5",85,151,268,299,567
5730,"คลองถนน","เขตสายไหม",104203,"เต็นท์ในบริเวณลานกีฬาชุมชน กสบ. หมู่ 5",86,186,273,321,594
5731,"คลองถนน","เขตสายไหม",104203,"อาคารอเนกประสงค์หมู่บ้านรุ่งเรืองฯ",87,181,213,244,457
5732,"คลองถนน","เขตสายไหม",104203,"อาคารอเนกประสงค์หมู่บ้านรุ่งเรืองฯ",88,196,246,299,545
5733,"คลองถนน","เขตสายไหม",104203,"เต็นท์บริเวณหน้าหมู่บ้านณัฐกานต์ 3,5",89,274,343,394,737
5734,"คลองถนน","เขตสายไหม",104203,"เต็นท์บริเวณหน้าหมู่บ้านณัฐกานต์ 3,5",90,316,330,421,751
5735,"คลองถนน","เขตสายไหม",104203,"อาคารวิทยาลัยเทคโนโลยีสยามบริหารธุรกิจ (SBAC)",91,288,324,403,727
5736,"คลองถนน","เขตสายไหม",104203,"อาคารวิทยาลัยเทคโนโลยีสยามบริหารธุรกิจ (SBAC)",92,397,356,500,856
5737,"คลองถนน","เขตสายไหม",104203,"อาคารวิทยาลัยเทคโนโลยีสยามบริหารธุรกิจ (SBAC)",93,335,312,444,756
5738,"คลองถนน","เขตสายไหม",104203,"อาคารวิทยาลัยเทคโนโลยีสยามบริหารธุรกิจ (SBAC)",94,451,409,494,903
5739,"คลองถนน","เขตสายไหม",104203,"อาคารวิทยาลัยเทคโนโลยีสยามบริหารธุรกิจ (SBAC)",95,290,330,401,731
5740,"คลองถนน","เขตสายไหม",104203,"อาคารวิทยาลัยเทคโนโลยีสยามบริหารธุรกิจ (SBAC)",96,267,345,404,749
5741,"คลองถนน","เขตสายไหม",104203,"อาคารวิทยาลัยเทคโนโลยีสยามบริหารธุรกิจ (SBAC)",97,223,363,377,740
5742,"คลองถนน","เขตสายไหม",104203,"อาคารวิทยาลัยเทคโนโลยีสยามบริหารธุรกิจ (SBAC)",98,199,235,292,527
5743,"คันนายาว","เขตคันนายาว",104301,"เต็นท์บริเวณหน้าหมู่บ้านเจริญทรัพย์",1,177,169,227,396
5744,"คันนายาว","เขตคันนายาว",104301,"เต็นท์บริเวณหน้าสนามกีฬา (ไนติงเกล)",2,193,218,245,463
5745,"คันนายาว","เขตคันนายาว",104301,"เต็นท์บริเวณลานจอดรถร้านอาหาร PLAY",3,272,212,339,551
5746,"คันนายาว","เขตคันนายาว",104301,"เต็นท์บริเวณลานจอดรถร้านอาหาร PLAY",4,203,243,284,527
5747,"คันนายาว","เขตคันนายาว",104301,"วัดราษฎร์ศรัทธาธรรม (บางชัน)",5,181,216,297,513
5748,"คันนายาว","เขตคันนายาว",104301,"วัดราษฎร์ศรัทธาธรรม (บางชัน)",6,131,218,228,446
5749,"คันนายาว","เขตคันนายาว",104301,"เต็นท์บริเวณปั๊มน้ำมันเอสโซ่ (กม.12)",7,347,352,422,774
5750,"คันนายาว","เขตคันนายาว",104301,"เต็นท์บริเวณหน้าสวนคันนายาวรมณีย์",8,257,292,342,634
5751,"คันนายาว","เขตคันนายาว",104301,"เต็นท์บริเวณหน้าสวนคันนายาวรมณีย์",9,236,255,344,599
5752,"คันนายาว","เขตคันนายาว",104301,"เต็นท์บริเวณหน้าสวนคันนายาวรมณีย์",10,257,304,356,660
5753,"คันนายาว","เขตคันนายาว",104301,"เต็นท์บริเวณอาคารอมรพันธ์แซทเทอไลท์คอนโดทาวน์ (R 4)",11,306,324,390,714
5754,"คันนายาว","เขตคันนายาว",104301,"เต็นท์บริเวณอาคารอมรพันธ์แซทเทอไลท์คอนโดทาวน์ (R 4)",12,393,357,431,788
5755,"คันนายาว","เขตคันนายาว",104301,"ศาลาบริเวณสนามเด็กเล่นหมู่บ้านเก้าแสนเจ็ด",13,208,198,285,483
5756,"คันนายาว","เขตคันนายาว",104301,"ศาลาบริเวณสนามเด็กเล่นหมู่บ้านเก้าแสนเจ็ด",14,156,169,249,418
5757,"คันนายาว","เขตคันนายาว",104301,"เต็นท์บริเวณลานจอดรถแกรนด์สยามอินน์",15,149,197,217,414
5758,"คันนายาว","เขตคันนายาว",104301,"เต็นท์บริเวณลานจอดรถแกรนด์สยามอินน์",16,171,227,291,518
5759,"คันนายาว","เขตคันนายาว",104301,"เต็นท์บริเวณลานกีฬาชุมชนอมรพันธ์นครสวนสยาม",17,220,261,336,597
5760,"คันนายาว","เขตคันนายาว",104301,"เต็นท์บริเวณลานจอดรถธนาคารกรุงเทพ สาขาสวนสยาม",18,234,272,316,588
5761,"คันนายาว","เขตคันนายาว",104301,"เต็นท์บริเวณลานจอดรถธนาคารไทยพาณิชย์ สาขาถนนเสรีไทย",19,250,280,312,592
5762,"คันนายาว","เขตคันนายาว",104301,"เต็นท์บริเวณสนามเด็กเล่นหมู่บ้านเกษรา",20,479,294,454,748
5763,"คันนายาว","เขตคันนายาว",104301,"เต็นท์บริเวณสนามเด็กเล่นหมู่บ้านเกษรา",21,191,208,287,495
5764,"คันนายาว","เขตคันนายาว",104301,"เต็นท์บริเวณลานจอดรถทองประกายคอนโดเทล",22,129,209,276,485
5765,"คันนายาว","เขตคันนายาว",104301,"เต็นท์บริเวณลานจอดรถทองประกายคอนโดเทล",23,191,233,255,488
5766,"คันนายาว","เขตคันนายาว",104301,"โรงเรียนคันนายาว",24,260,389,449,838
5767,"คันนายาว","เขตคันนายาว",104301,"เต็นท์บริเวณหน้าโชว์รูมรถยนต์โตโยต้า สาขาสุขาภิบาล 2",25,253,212,310,522
5768,"คันนายาว","เขตคันนายาว",104301,"โรงเรียนสอนศาสนานูรุดดีน (สุเหร่าแดง)",26,175,343,341,684
5769,"คันนายาว","เขตคันนายาว",104301,"โรงเรียนสอนศาสนานูรุดดีน (สุเหร่าแดง)",27,164,311,348,659
5770,"คันนายาว","เขตคันนายาว",104301,"เต็นท์บริเวณหน้าหมู่บ้านเรือนทองนิเวศน์",28,307,356,416,772
5771,"คันนายาว","เขตคันนายาว",104301,"เต็นท์บริเวณปากซอยเสรีไทย 67",29,220,246,295,541
5772,"คันนายาว","เขตคันนายาว",104301,"เต็นท์บริเวณปากซอยเสรีไทย 69",30,330,312,394,706
5773,"คันนายาว","เขตคันนายาว",104301,"เต็นท์บริเวณปากซอยเสรีไทย 69",31,158,347,340,687
5774,"คันนายาว","เขตคันนายาว",104301,"เต็นท์บริเวณปากซอยเสรีไทย 69",32,155,376,362,738
5775,"คันนายาว","เขตคันนายาว",104301,"เต็นท์บริเวณปากซอยเสรีไทย 71/1",33,301,250,350,600
5776,"คันนายาว","เขตคันนายาว",104301,"เต็นท์บริเวณ สน.บางชัน",34,168,243,172,415
5777,"คันนายาว","เขตคันนายาว",104301,"บริเวณชุมชนหมู่บ้านอมรพันธ์นครเสรีไทย (ศาลามหาราช)",35,289,313,437,750
5778,"คันนายาว","เขตคันนายาว",104301,"เต็นท์บริเวณสนามเด็กเล่นหมู่บ้านราณี",36,149,161,207,368
5779,"คันนายาว","เขตคันนายาว",104301,"ศูนย์พัฒนาเด็กก่อนวัยเรียนชุมชนบ้านเกาะ",37,113,238,243,481
5780,"คันนายาว","เขตคันนายาว",104301,"เต็นท์บริเวณลานกีฬาหมู่บ้านแสงอรุณ",38,201,283,319,602
5781,"คันนายาว","เขตคันนายาว",104301,"เต็นท์บริเวณลานกีฬาหมู่บ้านแสงอรุณ",39,210,321,338,659
5782,"คันนายาว","เขตคันนายาว",104301,"เต็นท์บริเวณลานจอดรถข้างอาคารบลอสซั่ม คอนโด",40,337,248,290,538
5783,"คันนายาว","เขตคันนายาว",104301,"เต็นท์บริเวณลานจอดรถข้างอาคารบลอสซั่ม คอนโด",41,322,315,368,683
5784,"คันนายาว","เขตคันนายาว",104301,"เต็นท์บริเวณหน้าสโมสรหมู่บ้านชลลดา",42,215,255,305,560
5785,"คันนายาว","เขตคันนายาว",104301,"เต็นท์บริเวณสนามเด็กเล่นหมู่บ้านเพชรอนันต์",43,484,404,538,942
5786,"คันนายาว","เขตคันนายาว",104301,"เต็นท์บริเวณสนามเด็กเล่นหมู่บ้านเพชรอนันต์",44,473,382,539,921
5787,"คันนายาว","เขตคันนายาว",104301,"เต็นท์บริเวณสนามเด็กเล่นหมู่บ้านเพชรอนันต์",45,467,445,546,991
5788,"คันนายาว","เขตคันนายาว",104301,"อาคารที่ทำการชุมชนสุขอนันต์",46,155,287,329,616
5789,"คันนายาว","เขตคันนายาว",104301,"เต็นท์ใกล้ที่ทำการชุมชนสุขอนันต์",47,140,256,292,548
5790,"คันนายาว","เขตคันนายาว",104301,"เต็นท์บริเวณหน้าหมู่บ้านเปรมฤทัย 3",48,181,268,270,538
5791,"คันนายาว","เขตคันนายาว",104301,"เต็นท์บริเวณหน้าหมู่บ้านเปรมฤทัย 3",49,201,231,295,526
5792,"คันนายาว","เขตคันนายาว",104301,"เต็นท์บริเวณหน้าอาคารเสียงทิพย์สถานธรรม ถนนปัญญาอินทรา",50,145,172,169,341
5793,"คันนายาว","เขตคันนายาว",104301,"เต็นท์บริเวณหน้าศูนย์การค้าแฟชั่นไอส์แลนด์",51,290,358,410,768
5794,"รามอินทรา","เขตคันนายาว",104302,"เต็นท์บริเวณปากซอยเสรีไทย 42",1,81,166,163,329
5795,"รามอินทรา","เขตคันนายาว",104302,"เต็นท์บริเวณฝั่งตรงข้ามซอยเสรีไทย 38 แยก 4",2,297,338,417,755
5796,"รามอินทรา","เขตคันนายาว",104302,"โรงเรียนสอนศาสนาอัล-คอยรียะฮ์",3,164,343,431,774
5797,"รามอินทรา","เขตคันนายาว",104302,"เต็นท์บริเวณหน้าธนาคารทีเอ็มบีธนชาต สาขาเสรีไทย 32",4,269,361,424,785
5798,"รามอินทรา","เขตคันนายาว",104302,"เต็นท์บริเวณทางเข้าหน้าหมู่บ้านนวธานี",5,329,338,446,784
5799,"รามอินทรา","เขตคันนายาว",104302,"เต็นท์บริเวณชุมชนเกาะแครายพัฒนา",6,51,80,99,179
5800,"รามอินทรา","เขตคันนายาว",104302,"เต็นท์ในซอยเสรีไทย 61 หมู่บ้านสุวธานี",7,271,328,419,747
5801,"รามอินทรา","เขตคันนายาว",104302,"เต็นท์บริเวณปากซอยหน้าหมู่บ้านศิรินเทพ",8,155,160,228,388
5802,"รามอินทรา","เขตคันนายาว",104302,"เต็นท์บริเวณวัดคลองครุ",9,251,185,240,425
5803,"รามอินทรา","เขตคันนายาว",104302,"เต็นท์บริเวณหน้าสโมสรหมู่บ้านบูเลอวาร์ด เฟส 1",10,308,306,406,712
5804,"รามอินทรา","เขตคันนายาว",104302,"เต็นท์บริเวณลานกีฬา 2 เคหะธานี 3 (หน้าหมู่บ้านกัญจเพ็ชร)",11,367,375,512,887
5805,"รามอินทรา","เขตคันนายาว",104302,"เต็นท์บริเวณหน้าศูนย์เด็กปฐมวัยสุขาภิบาล 1 (การเคหะแห่งชาติ)",12,91,153,154,307
5806,"รามอินทรา","เขตคันนายาว",104302,"เต็นท์บริเวณสระน้ำหมู่บ้านปัฐวิกรณ์",13,283,350,485,835
5807,"รามอินทรา","เขตคันนายาว",104302,"เต็นท์บริเวณสระน้ำหมู่บ้านปัฐวิกรณ์",14,287,340,414,754
5808,"รามอินทรา","เขตคันนายาว",104302,"เต็นท์บริเวณลานกีฬา 1 เคหะธานี 3",15,492,353,515,868
5809,"รามอินทรา","เขตคันนายาว",104302,"เต็นท์บริเวณลานกีฬา 1 เคหะธานี 3",16,296,381,458,839
5810,"รามอินทรา","เขตคันนายาว",104302,"เต็นท์บริเวณลานกีฬา 1 เคหะธานี 3",17,307,341,451,792
5811,"รามอินทรา","เขตคันนายาว",104302,"บริเวณร้านเพาเวอร์แมกซ์ (ปากซอยรามอินทรา 62)",18,291,317,391,708
5812,"รามอินทรา","เขตคันนายาว",104302,"เต็นท์บริเวณลานกีฬาหมู่บ้านชื่นกมลนิเวศน์ 4",19,289,330,450,780
5813,"รามอินทรา","เขตคันนายาว",104302,"เต็นท์บริเวณลานจอดรถบริษัทเอส.เอส.แอร์ เซอร์วิส จำกัด",20,232,312,352,664
5814,"รามอินทรา","เขตคันนายาว",104302,"เต็นท์บริเวณลานจอดรถบริษัทเอส.เอส.แอร์ เซอร์วิส จำกัด",21,238,327,425,752
5815,"รามอินทรา","เขตคันนายาว",104302,"เต็นท์บริเวณสนามเด็กเล่นหมู่บ้านฟายโฮมส์ 3",22,333,349,428,777
5816,"รามอินทรา","เขตคันนายาว",104302,"เต็นท์บริเวณหน้าอาคารจอดรถ (P 2) โรงพยาบาลสินแพทย์",23,121,213,237,450
5817,"รามอินทรา","เขตคันนายาว",104302,"เต็นท์บริเวณหน้าโชว์รูมรถยนต์มาสด้า ถนนรามอินทรา",24,277,289,368,657
5818,"รามอินทรา","เขตคันนายาว",104302,"เต็นท์บริเวณลุมพินีคอนโดทาวน์ ถนนนวมินทร์",25,648,315,489,804
5819,"รามอินทรา","เขตคันนายาว",104302,"เต็นท์บริเวณอาคารกีรทรัพย์แมนชั่น",26,234,137,230,367
5820,"รามอินทรา","เขตคันนายาว",104302,"อาคารอเนกประสงค์หมู่บ้านอัมรินทร์นิเวศน์ 2",27,178,193,257,450
5821,"รามอินทรา","เขตคันนายาว",104302,"เต็นท์บริเวณหมู่บ้านธนะสิน 9",28,302,256,338,594
5822,"รามอินทรา","เขตคันนายาว",104302,"เต็นท์บริเวณหมู่บ้านธนะสิน 9",29,278,257,337,594
5823,"รามอินทรา","เขตคันนายาว",104302,"เต็นท์บริเวณหมู่บ้านธนะสิน 9",30,255,252,297,549
5824,"รามอินทรา","เขตคันนายาว",104302,"เต็นท์บริเวณปั๊มน้ำมัน ปตท. ถนนนวมินทร์",31,406,429,552,981
5825,"รามอินทรา","เขตคันนายาว",104302,"ศูนย์พัฒนาเด็กก่อนวัยเรียนวัดบุญศรีมุนีกรณ์",32,251,375,413,788
5826,"รามอินทรา","เขตคันนายาว",104302,"เต็นท์บริเวณลานกีฬาหมู่บ้าน บก. ทหารสูงสุด",33,253,352,421,773
5827,"รามอินทรา","เขตคันนายาว",104302,"เต็นท์บริเวณลานกีฬาหมู่บ้าน บก. ทหารสูงสุด",34,222,301,368,669
5828,"รามอินทรา","เขตคันนายาว",104302,"เต็นท์บริเวณหน้ามัสยิดอัล-เอาว์ก๊อฟ",35,252,351,432,783
5829,"รามอินทรา","เขตคันนายาว",104302,"เต็นท์บริเวณหน้ามัสยิดอัล-เอาว์ก๊อฟ",36,216,332,405,737
5830,"รามอินทรา","เขตคันนายาว",104302,"โรงเรียนเตรียมวิทย์พัฒนา",37,310,356,456,812
5831,"รามอินทรา","เขตคันนายาว",104302,"โรงเรียนเตรียมวิทย์พัฒนา",38,298,368,427,795
5832,"รามอินทรา","เขตคันนายาว",104302,"ศาลารวมน้ำใจ หมู่บ้านรามอินทรานิเวศน์",39,387,363,497,860
5833,"รามอินทรา","เขตคันนายาว",104302,"ศาลารวมน้ำใจ หมู่บ้านรามอินทรานิเวศน์",40,261,315,440,755
5834,"รามอินทรา","เขตคันนายาว",104302,"เต็นท์บริเวณด้านข้างศาลารวมน้ำใจ หมู่บ้านรามอินทรานิเวศน์",41,226,280,374,654
5835,"รามอินทรา","เขตคันนายาว",104302,"เต็นท์บริเวณที่ว่างชุมชนประสิทธิชัย",42,72,115,137,252
5836,"รามอินทรา","เขตคันนายาว",104302,"เต็นท์บริเวณหน้าศาลเจ้าตลาดสายเนตร",43,282,318,383,701
5837,"รามอินทรา","เขตคันนายาว",104302,"เต็นท์บริเวณอิชิบะสะเตชั่น (รามอินทรา กม.9)",44,228,291,326,617
5838,"รามอินทรา","เขตคันนายาว",104302,"เต็นท์บริเวณอิชิบะสะเตชั่น (รามอินทรา กม.9)",45,164,270,306,576
5839,"รามอินทรา","เขตคันนายาว",104302,"เต็นท์บริเวณอิชิบะสะเตชั่น (รามอินทรา กม.9)",46,124,202,220,422
5840,"รามอินทรา","เขตคันนายาว",104302,"โรงเรียนจินดาบำรุง",47,195,280,299,579
5841,"รามอินทรา","เขตคันนายาว",104302,"โรงเรียนจินดาบำรุง",48,315,335,336,671
5842,"รามอินทรา","เขตคันนายาว",104302,"เต็นท์บริเวณหน้าอาคารสำนักงานขายเคหะรามอินทรา",49,258,250,351,601
5843,"รามอินทรา","เขตคันนายาว",104302,"เต็นท์บริเวณปากซอยคู้บอน 19",50,245,387,452,839
5844,"รามอินทรา","เขตคันนายาว",104302,"เต็นท์บริเวณปั๊มน้ำมันเอสโซ่ (ปากซอยคู้บอน 25)",51,169,238,273,511
5845,"รามอินทรา","เขตคันนายาว",104302,"เต็นท์บริเวณปั๊มน้ำมันเอสโซ่ (ปากซอยคู้บอน 25)",52,131,193,234,427
5846,"รามอินทรา","เขตคันนายาว",104302,"เต็นท์บริเวณ สน.คันนายาว",53,290,363,404,767
5847,"รามอินทรา","เขตคันนายาว",104302,"เต็นท์บริเวณ สน.คันนายาว",54,391,413,484,897
5848,"รามอินทรา","เขตคันนายาว",104302,"เต็นท์บริเวณปากซอยคู้บอน 22",55,355,274,370,644
5849,"รามอินทรา","เขตคันนายาว",104302,"เต็นท์บริเวณปากซอยคู้บอน 22",56,307,307,387,694
5850,"รามอินทรา","เขตคันนายาว",104302,"บริเวณที่ว่างใต้อาคารมณีมาศแมนชั่น",57,249,264,314,578
5851,"รามอินทรา","เขตคันนายาว",104302,"เต็นท์บริเวณทางเข้าหมู่บ้านชวนชื่นนีโอเฮาส์",58,262,256,394,650
5852,"รามอินทรา","เขตคันนายาว",104302,"เต็นท์บริเวณหน้าสโมสรหมู่บ้านชวนชื่นนีโอเฮาส์",59,201,234,278,512
5853,"รามอินทรา","เขตคันนายาว",104302,"เต็นท์บริเวณหน้าหมู่บ้านมณีมาศ",60,321,403,461,864
5854,"สะพานสูง","เขตสะพานสูง",104401,"เต็นท์บริเวณสำนักงานเขตสะพานสูง",1,305,346,448,794
5855,"สะพานสูง","เขตสะพานสูง",104401,"เต็นท์บริเวณสำนักงานเขตสะพานสูง",2,274,299,404,703
5856,"สะพานสูง","เขตสะพานสูง",104401,"เต็นท์บริเวณสำนักงานเขตสะพานสูง",3,284,345,435,780
5857,"สะพานสูง","เขตสะพานสูง",104401,"เต็นท์บริเวณสำนักงานเขตสะพานสูง",4,273,338,425,763
5858,"สะพานสูง","เขตสะพานสูง",104401,"เต็นท์บริเวณสำนักงานเขตสะพานสูง",5,227,336,431,767
5859,"สะพานสูง","เขตสะพานสูง",104401,"เต็นท์บริเวณสำนักงานเขตสะพานสูง",6,283,365,421,786
5860,"สะพานสูง","เขตสะพานสูง",104401,"เต็นท์บริเวณสำนักงานเขตสะพานสูง",7,184,384,391,775
5861,"สะพานสูง","เขตสะพานสูง",104401,"เต็นท์บริเวณสำนักงานเขตสะพานสูง",8,265,333,417,750
5862,"สะพานสูง","เขตสะพานสูง",104401,"เต็นท์บริเวณสำนักงานเขตสะพานสูง",9,203,317,348,665
5863,"สะพานสูง","เขตสะพานสูง",104401,"เต็นท์บริเวณสำนักงานเขตสะพานสูง",10,275,321,378,699
5864,"สะพานสูง","เขตสะพานสูง",104401,"โรงเรียนศิริเพ็ญ",11,323,348,444,792
5865,"สะพานสูง","เขตสะพานสูง",104401,"โรงเรียนศิริเพ็ญ",12,361,322,434,756
5866,"สะพานสูง","เขตสะพานสูง",104401,"โรงเรียนศิริเพ็ญ",13,298,331,410,741
5867,"สะพานสูง","เขตสะพานสูง",104401,"โรงเรียนศิริเพ็ญ",14,264,327,418,745
5868,"สะพานสูง","เขตสะพานสูง",104401,"เต็นท์บริเวณโรงเรียนนวมินทราชินูทิศ เตรียมอุดมศึกษาน้อมเกล้า",15,250,308,353,661
5869,"สะพานสูง","เขตสะพานสูง",104401,"เต็นท์บริเวณโรงเรียนนวมินทราชินูทิศ เตรียมอุดมศึกษาน้อมเกล้า",16,210,295,334,629
5870,"สะพานสูง","เขตสะพานสูง",104401,"เต็นท์บริเวณโรงเรียนนวมินทราชินูทิศ เตรียมอุดมศึกษาน้อมเกล้า",17,234,275,379,654
5871,"สะพานสูง","เขตสะพานสูง",104401,"เต็นท์บริเวณโรงเรียนนวมินทราชินูทิศ เตรียมอุดมศึกษาน้อมเกล้า",18,246,283,367,650
5872,"สะพานสูง","เขตสะพานสูง",104401,"เต็นท์บริเวณโรงเรียนนวมินทราชินูทิศ เตรียมอุดมศึกษาน้อมเกล้า",19,225,263,361,624
5873,"สะพานสูง","เขตสะพานสูง",104401,"เต็นท์บริเวณโรงเรียนนวมินทราชินูทิศ เตรียมอุดมศึกษาน้อมเกล้า",20,241,273,383,656
5874,"สะพานสูง","เขตสะพานสูง",104401,"เต็นท์บริเวณโรงเรียนนวมินทราชินูทิศ เตรียมอุดมศึกษาน้อมเกล้า",21,230,283,355,638
5875,"สะพานสูง","เขตสะพานสูง",104401,"เต็นท์บริเวณโรงเรียนนวมินทราชินูทิศ เตรียมอุดมศึกษาน้อมเกล้า",22,228,291,351,642
5876,"สะพานสูง","เขตสะพานสูง",104401,"เต็นท์บริเวณโรงเรียนนวมินทราชินูทิศ เตรียมอุดมศึกษาน้อมเกล้า",23,234,286,371,657
5877,"สะพานสูง","เขตสะพานสูง",104401,"เต็นท์บริเวณโรงเรียนนวมินทราชินูทิศ เตรียมอุดมศึกษาน้อมเกล้า",24,236,287,361,648
5878,"สะพานสูง","เขตสะพานสูง",104401,"เต็นท์บริเวณโรงเรียนนวมินทราชินูทิศ เตรียมอุดมศึกษาน้อมเกล้า",25,245,287,356,643
5879,"สะพานสูง","เขตสะพานสูง",104401,"เต็นท์บริเวณโรงเรียนนวมินทราชินูทิศ เตรียมอุดมศึกษาน้อมเกล้า",26,259,312,378,690
5880,"สะพานสูง","เขตสะพานสูง",104401,"เต็นท์บริเวณโรงเรียนนวมินทราชินูทิศ เตรียมอุดมศึกษาน้อมเกล้า",27,261,324,393,717
5881,"สะพานสูง","เขตสะพานสูง",104401,"เต็นท์บริเวณโรงเรียนโสมาภานุสสรณ์",28,220,343,414,757
5882,"สะพานสูง","เขตสะพานสูง",104401,"เต็นท์บริเวณโรงเรียนโสมาภานุสสรณ์",29,356,341,460,801
5883,"สะพานสูง","เขตสะพานสูง",104401,"เต็นท์บริเวณโรงเรียนโสมาภานุสสรณ์",30,424,310,456,766
5884,"สะพานสูง","เขตสะพานสูง",104401,"เต็นท์บริเวณโรงเรียนโสมาภานุสสรณ์",31,290,317,418,735
5885,"สะพานสูง","เขตสะพานสูง",104401,"เต็นท์บริเวณโรงเรียนโสมาภานุสสรณ์",32,284,331,420,751
5886,"ราษฎร์พัฒนา","เขตสะพานสูง",104402,"โรงเรียนอัลยุซรอพิทักษ์ศาสน์ ซอยรามคำแหง 165",1,228,333,360,693
5887,"ราษฎร์พัฒนา","เขตสะพานสูง",104402,"โรงเรียนอัลยุซรอพิทักษ์ศาสน์ ซอยรามคำแหง 165",2,309,338,437,775
5888,"ราษฎร์พัฒนา","เขตสะพานสูง",104402,"เต็นท์บริเวณหน้าหมู่บ้านศรีประจักษ์วิลล่า ซอยรามคำแหง 156",3,228,306,371,677
5889,"ราษฎร์พัฒนา","เขตสะพานสูง",104402,"เต็นท์บริเวณหน้าหมู่บ้านศรีประจักษ์วิลล่า ซอยรามคำแหง 156",4,270,315,387,702
5890,"ราษฎร์พัฒนา","เขตสะพานสูง",104402,"เต็นท์บริเวณหน้าหมู่บ้านคลองจั่นวิลล่า 7",5,232,247,358,605
5891,"ราษฎร์พัฒนา","เขตสะพานสูง",104402,"เต็นท์บริเวณสถานีบริการเติมน้ำมัน ปตท. ซอยรามคำแหง 152",6,255,314,379,693
5892,"ราษฎร์พัฒนา","เขตสะพานสูง",104402,"เต็นท์บริเวณสโมสรหมู่บ้านธารารมณ์",7,244,275,360,635
5893,"ราษฎร์พัฒนา","เขตสะพานสูง",104402,"เต็นท์บริเวณสโมสรหมู่บ้านธารารมณ์",8,233,268,359,627
5894,"ราษฎร์พัฒนา","เขตสะพานสูง",104402,"เต็นท์บริเวณสโมสรหมู่บ้านธารารมณ์",9,272,301,397,698
5895,"ราษฎร์พัฒนา","เขตสะพานสูง",104402,"โรงเรียนเตรียมอุดมศึกษาน้อมเกล้า",10,346,330,409,739
5896,"ราษฎร์พัฒนา","เขตสะพานสูง",104402,"โรงเรียนเตรียมอุดมศึกษาน้อมเกล้า",11,296,298,390,688
5897,"ราษฎร์พัฒนา","เขตสะพานสูง",104402,"โรงเรียนเตรียมอุดมศึกษาน้อมเกล้า",12,267,351,415,766
5898,"ราษฎร์พัฒนา","เขตสะพานสูง",104402,"โรงเรียนเตรียมอุดมศึกษาน้อมเกล้า",13,284,304,395,699
5899,"ราษฎร์พัฒนา","เขตสะพานสูง",104402,"โรงเรียนเตรียมอุดมศึกษาน้อมเกล้า",14,316,344,446,790
5900,"ราษฎร์พัฒนา","เขตสะพานสูง",104402,"โรงเรียนเตรียมอุดมศึกษาน้อมเกล้า",15,348,369,411,780
5901,"ราษฎร์พัฒนา","เขตสะพานสูง",104402,"เต็นท์บริเวณโรงเรียนวิทยานนท์ ถนนราษฎร์พัฒนา",16,393,325,451,776
5902,"ราษฎร์พัฒนา","เขตสะพานสูง",104402,"เต็นท์บริเวณโรงเรียนวิทยานนท์ ถนนราษฎร์พัฒนา",17,415,330,481,811
5903,"ราษฎร์พัฒนา","เขตสะพานสูง",104402,"เต็นท์บริเวณโรงเรียนวิทยานนท์ ถนนราษฎร์พัฒนา",18,346,347,432,779
5904,"ราษฎร์พัฒนา","เขตสะพานสูง",104402,"เต็นท์บริเวณลานกีฬาหมู่บ้านเคหะนคร (เคหะธานี 4)",19,239,330,355,685
5905,"ราษฎร์พัฒนา","เขตสะพานสูง",104402,"เต็นท์บริเวณลานกีฬาหมู่บ้านเคหะนคร (เคหะธานี 4)",20,262,339,371,710
5906,"ราษฎร์พัฒนา","เขตสะพานสูง",104402,"เต็นท์บริเวณลานกีฬาหมู่บ้านเคหะนคร (เคหะธานี 4)",21,247,314,373,687
5907,"ราษฎร์พัฒนา","เขตสะพานสูง",104402,"เต็นท์บริเวณลานกีฬาหมู่บ้านเคหะนคร (เคหะธานี 4)",22,280,327,375,702
5908,"ราษฎร์พัฒนา","เขตสะพานสูง",104402,"เต็นท์บริเวณลานกีฬาหมู่บ้านเคหะนคร (เคหะธานี 4)",23,259,309,405,714
5909,"ราษฎร์พัฒนา","เขตสะพานสูง",104402,"เต็นท์บริเวณลานกีฬาหมู่บ้านเคหะนคร (เคหะธานี 4)",24,251,299,372,671
5910,"ราษฎร์พัฒนา","เขตสะพานสูง",104402,"เต็นท์บริเวณลานกีฬาหมู่บ้านเคหะนคร (เคหะธานี 4)",25,293,319,407,726
5911,"ราษฎร์พัฒนา","เขตสะพานสูง",104402,"โรงเรียนสามแยกคลองหลอแหล",26,321,350,434,784
5912,"ราษฎร์พัฒนา","เขตสะพานสูง",104402,"โรงเรียนสามแยกคลองหลอแหล",27,214,353,383,736
5913,"ราษฎร์พัฒนา","เขตสะพานสูง",104402,"โรงเรียนสามแยกคลองหลอแหล",28,301,361,444,805
5914,"ราษฎร์พัฒนา","เขตสะพานสูง",104402,"เต็นท์บริเวณหมู่บ้านคาซ่าวิลล์ ถนนราษฎร์พัฒนา",29,244,215,306,521
5915,"ราษฎร์พัฒนา","เขตสะพานสูง",104402,"เต็นท์บริเวณหมู่บ้านคาซ่าวิลล์ ถนนราษฎร์พัฒนา",30,270,220,299,519
5916,"ราษฎร์พัฒนา","เขตสะพานสูง",104402,"เต็นท์บริเวณหมู่บ้านพฤกษา ถนนราษฎร์พัฒนา",31,415,347,480,827
5917,"ราษฎร์พัฒนา","เขตสะพานสูง",104402,"เต็นท์บริเวณสโมสรหมู่บ้านพาร์คเวย์ ซอยราษฎร์พัฒนา 22",32,286,310,434,744
5918,"ราษฎร์พัฒนา","เขตสะพานสูง",104402,"เต็นท์บริเวณสโมสรหมู่บ้านพาร์คเวย์ ซอยราษฎร์พัฒนา 22",33,309,329,433,762
5919,"ราษฎร์พัฒนา","เขตสะพานสูง",104402,"เต็นท์บริเวณสโมสรหมู่บ้านพาร์คเวย์ ซอยราษฎร์พัฒนา 22",34,307,323,425,748
5920,"ราษฎร์พัฒนา","เขตสะพานสูง",104402,"เต็นท์บริเวณสโมสรหมู่บ้านพาร์คเวย์ ซอยราษฎร์พัฒนา 22",35,359,340,415,755
5921,"ราษฎร์พัฒนา","เขตสะพานสูง",104402,"เต็นท์บริเวณสโมสรหมู่บ้านพาร์คเวย์ ซอยราษฎร์พัฒนา 22",36,374,315,430,745
5922,"ราษฎร์พัฒนา","เขตสะพานสูง",104402,"เต็นท์บริเวณสโมสรหมู่บ้านพาร์คเวย์ ซอยราษฎร์พัฒนา 22",37,343,338,427,765
5923,"ราษฎร์พัฒนา","เขตสะพานสูง",104402,"โรงเรียนสุเหร่าซีรอ",38,362,337,439,776
5924,"ราษฎร์พัฒนา","เขตสะพานสูง",104402,"โรงเรียนสุเหร่าซีรอ",39,325,358,427,785
5925,"ราษฎร์พัฒนา","เขตสะพานสูง",104402,"โรงเรียนสุเหร่าซีรอ",40,174,354,388,742
5926,"ราษฎร์พัฒนา","เขตสะพานสูง",104402,"โรงเรียนสุเหร่าซีรอ",41,233,386,412,798
5927,"ราษฎร์พัฒนา","เขตสะพานสูง",104402,"โรงเรียนสุเหร่าลาดบัวขาว",42,260,279,350,629
5928,"ราษฎร์พัฒนา","เขตสะพานสูง",104402,"โรงเรียนสุเหร่าลาดบัวขาว",43,137,309,333,642
5929,"ราษฎร์พัฒนา","เขตสะพานสูง",104402,"โรงเรียนสุเหร่าลาดบัวขาว",44,224,299,322,621
5930,"ราษฎร์พัฒนา","เขตสะพานสูง",104402,"โรงเรียนสุเหร่าลาดบัวขาว",45,265,274,368,642
5931,"ราษฎร์พัฒนา","เขตสะพานสูง",104402,"โรงเรียนสุเหร่าลาดบัวขาว",46,367,312,377,689
5932,"ราษฎร์พัฒนา","เขตสะพานสูง",104402,"โรงเรียนสุเหร่าลาดบัวขาว",47,201,301,338,639
5933,"ทับช้าง","เขตสะพานสูง",104403,"เต็นท์บริเวณทางเข้าหมู่บ้านกฤษณา ไพรเวทซิตี้ ถนนกรุงเทพกรีฑา",1,328,377,462,839
5934,"ทับช้าง","เขตสะพานสูง",104403,"โรงเรียนฮิดายาตุ้ลอิสลาม (บ้านม้าบน)",2,137,213,236,449
5935,"ทับช้าง","เขตสะพานสูง",104403,"โรงเรียนฮิดายาตุ้ลอิสลาม (บ้านม้าบน)",3,241,221,288,509
5936,"ทับช้าง","เขตสะพานสูง",104403,"เต็นท์บริเวณห้างเทสโก้โลตัส สาขาถนนกรุงเทพกรีฑา",4,242,313,356,669
5937,"ทับช้าง","เขตสะพานสูง",104403,"เต็นท์บริเวณห้างเทสโก้โลตัส สาขาถนนกรุงเทพกรีฑา",5,236,279,311,590
5938,"ทับช้าง","เขตสะพานสูง",104403,"เต็นท์บริเวณห้างเทสโก้โลตัส สาขาถนนกรุงเทพกรีฑา",6,182,291,301,592
5939,"ทับช้าง","เขตสะพานสูง",104403,"มัสยิดดารุ้ลนาอีม (ทับช้างล่าง)",7,293,326,382,708
5940,"ทับช้าง","เขตสะพานสูง",104403,"มัสยิดดารุ้ลนาอีม (ทับช้างล่าง)",8,177,305,341,646
5941,"ทับช้าง","เขตสะพานสูง",104403,"มัสยิดดารุ้ลนาอีม (ทับช้างล่าง)",9,244,257,332,589
5942,"ทับช้าง","เขตสะพานสูง",104403,"มัสยิดดารุ้ลนาอีม (ทับช้างล่าง)",10,167,269,311,580
5943,"ทับช้าง","เขตสะพานสูง",104403,"เต็นท์บริเวณโรงเรียนสมโภชกรุงอนุสรณ์ (200 ปี)",11,257,321,410,731
5944,"ทับช้าง","เขตสะพานสูง",104403,"เต็นท์บริเวณโรงเรียนสมโภชกรุงอนุสรณ์ (200 ปี)",12,309,282,406,688
5945,"ทับช้าง","เขตสะพานสูง",104403,"เต็นท์บริเวณโรงเรียนสมโภชกรุงอนุสรณ์ (200 ปี)",13,284,299,398,697
5946,"ทับช้าง","เขตสะพานสูง",104403,"เต็นท์บริเวณโรงเรียนสมโภชกรุงอนุสรณ์ (200 ปี)",14,281,294,422,716
5947,"ทับช้าง","เขตสะพานสูง",104403,"เต็นท์บริเวณโรงเรียนสมโภชกรุงอนุสรณ์ (200 ปี)",15,249,317,363,680
5948,"ทับช้าง","เขตสะพานสูง",104403,"เต็นท์บริเวณโรงเรียนสมโภชกรุงอนุสรณ์ (200 ปี)",16,239,325,421,746
5949,"ทับช้าง","เขตสะพานสูง",104403,"เต็นท์บริเวณโรงเรียนสมโภชกรุงอนุสรณ์ (200 ปี)",17,241,317,407,724
5950,"ทับช้าง","เขตสะพานสูง",104403,"เต็นท์บริเวณโรงเรียนสมโภชกรุงอนุสรณ์ (200 ปี)",18,270,286,412,698
5951,"ทับช้าง","เขตสะพานสูง",104403,"เต็นท์บริเวณโรงเรียนศรีพฤฒา",19,240,269,388,657
5952,"ทับช้าง","เขตสะพานสูง",104403,"เต็นท์บริเวณโรงเรียนศรีพฤฒา",20,229,294,378,672
5953,"ทับช้าง","เขตสะพานสูง",104403,"เต็นท์บริเวณโรงเรียนศรีพฤฒา",21,233,293,382,675
5954,"ทับช้าง","เขตสะพานสูง",104403,"เต็นท์บริเวณโรงเรียนศรีพฤฒา",22,335,329,417,746
5955,"ทับช้าง","เขตสะพานสูง",104403,"เต็นท์บริเวณโรงเรียนศรีพฤฒา",23,357,280,400,680
5956,"ทับช้าง","เขตสะพานสูง",104403,"โรงเรียนสุเหร่าทับช้างคลองบน",24,329,275,356,631
5957,"ทับช้าง","เขตสะพานสูง",104403,"โรงเรียนสุเหร่าทับช้างคลองบน",25,339,266,336,602
5958,"ทับช้าง","เขตสะพานสูง",104403,"โรงเรียนสุเหร่าทับช้างคลองบน",26,186,285,297,582
5959,"ทับช้าง","เขตสะพานสูง",104403,"โรงเรียนสุเหร่าทับช้างคลองบน",27,223,253,291,544
5960,"ทับช้าง","เขตสะพานสูง",104403,"โรงเรียนสุเหร่าทับช้างคลองบน",28,308,295,343,638
5961,"ทับช้าง","เขตสะพานสูง",104403,"โรงเรียนวัดลาดบัวขาว",29,275,279,344,623
5962,"ทับช้าง","เขตสะพานสูง",104403,"โรงเรียนวัดลาดบัวขาว",30,310,263,314,577
5963,"ทับช้าง","เขตสะพานสูง",104403,"โรงเรียนวัดลาดบัวขาว",31,172,261,277,538
5964,"วังทองหลาง","เขตวังทองหลาง",104501,"โรงเรียนสุเหร่าลาดพร้าว ซอยสหการประมูล",1,333,259,387,646
5965,"วังทองหลาง","เขตวังทองหลาง",104501,"โรงเรียนสุเหร่าลาดพร้าว ซอยสหการประมูล",2,319,276,373,649
5966,"วังทองหลาง","เขตวังทองหลาง",104501,"โรงเรียนสุเหร่าลาดพร้าว ซอยสหการประมูล",3,320,277,382,659
5967,"วังทองหลาง","เขตวังทองหลาง",104501,"เต็นท์ข้างอาคารไอยรา แพลนเน็ท(ปากซอยลาดพร้าว84)",4,329,347,425,772
5968,"วังทองหลาง","เขตวังทองหลาง",104501,"เต็นท์ข้างอาคารไอยรา แพลนเน็ท(ปากซอยลาดพร้าว84)",5,426,342,448,790
5969,"วังทองหลาง","เขตวังทองหลาง",104501,"เต็นท์ข้างอาคารไอยรา แพลนเน็ท(ปากซอยลาดพร้าว84)",6,241,315,407,722
5970,"วังทองหลาง","เขตวังทองหลาง",104501,"เต็นท์ข้างอาคารไอยรา แพลนเนท (ปากซอยลาดพร้าว84)",7,310,314,406,720
5971,"วังทองหลาง","เขตวังทองหลาง",104501,"โรงเรียนวัดสามัคคีธรรม(ซอยลาดพร้าว80แยก14)",8,289,329,428,757
5972,"วังทองหลาง","เขตวังทองหลาง",104501,"โรงเรียนวัดสามัคคีธรรม(ซอยลาดพร้าว80แยก14)",9,330,329,481,810
5973,"วังทองหลาง","เขตวังทองหลาง",104501,"โรงเรียนวัดสามัคคีธรรม(ซอยลาดพร้าว80แยก14)",10,272,346,453,799
5974,"วังทองหลาง","เขตวังทองหลาง",104501,"โรงเรียนวัดสามัคคีธรรม(ซอยลาดพร้าว80แยก14)",11,265,312,436,748
5975,"วังทองหลาง","เขตวังทองหลาง",104501,"โรงเรียนวัดสามัคคีธรรม(ซอยลาดพร้าว80แยก14)",12,318,351,440,791
5976,"วังทองหลาง","เขตวังทองหลาง",104501,"โรงเรียนวัดสามัคคีธรรม(ซอยลาดพร้าว80แยก14)",13,298,372,428,800
5977,"วังทองหลาง","เขตวังทองหลาง",104501,"โรงเรียนวัดสามัคคีธรรม(ซอยลาดพร้าว80แยก14)",14,346,371,406,777
5978,"วังทองหลาง","เขตวังทองหลาง",104501,"โรงเรียนวัดสามัคคีธรรม(ซอยลาดพร้าว80แยก14)",15,333,373,416,789
5979,"วังทองหลาง","เขตวังทองหลาง",104501,"เต็นท์ในโรงเรียนถนอมพิศวิทยา(ระหว่างซอยลาดพร้าว62-64)",16,324,350,369,719
5980,"วังทองหลาง","เขตวังทองหลาง",104501,"เต็นท์ในโรงเรียนถนอมพิศวิทยา(ระหว่างซอยลาดพร้าว62-64)",17,255,328,401,729
5981,"วังทองหลาง","เขตวังทองหลาง",104501,"เต็นท์ในโรงเรียนถนอมพิศวิทยา(ระหว่างซอยลาดพร้าว62-64)",18,275,304,408,712
5982,"วังทองหลาง","เขตวังทองหลาง",104501,"เต็นท์ในโรงเรียนถนอมพิศวิทยา(ระหว่างซอยลาดพร้าว62-64)",19,242,318,370,688
5983,"วังทองหลาง","เขตวังทองหลาง",104501,"เต็นท์ในโรงเรียนถนอมพิศวิทยา(ระหว่างซอยลาดพร้าว62-64)",20,265,316,384,700
5984,"วังทองหลาง","เขตวังทองหลาง",104501,"เต็นท์ในโรงเรียนถนอมพิศวิทยา(ระหว่างซอยลาดพร้าว62-64)",21,231,334,399,733
5985,"วังทองหลาง","เขตวังทองหลาง",104501,"เต็นท์ในโรงเรียนถนอมพิศวิทยา(ระหว่างซอยลาดพร้าว62-64)",22,217,322,385,707
5986,"วังทองหลาง","เขตวังทองหลาง",104501,"เต็นท์ในโรงเรียนถนอมพิศวิทยา(ระหว่างซอยลาดพร้าว62-64)",23,371,301,411,712
5987,"วังทองหลาง","เขตวังทองหลาง",104501,"เต็นท์ลานจอดรถโรงเรียนกานดา(ซอยลาดพร้าว64แยก7)",24,312,291,376,667
5988,"วังทองหลาง","เขตวังทองหลาง",104501,"เต็นท์ลานจอดรถโรงเรียนกานดา(ซอยลาดพร้าว64แยก7)",25,242,335,369,704
5989,"วังทองหลาง","เขตวังทองหลาง",104501,"เต็นท์ลานจอดรถโรงเรียนกานดา(ซอยลาดพร้าว64แยก7)",26,271,304,402,706
5990,"วังทองหลาง","เขตวังทองหลาง",104501,"เต็นท์ลานจอดรถโรงเรียนกานดา(ซอยลาดพร้าว64แยก7)",27,217,310,397,707
5991,"สะพานสอง","เขตวังทองหลาง",104502,"เต็นท์ในโรงเรียนแจ่มศึกษา(ซอยลาดพร้าว47ฝั่งซ้าย)",1,264,360,345,705
5992,"สะพานสอง","เขตวังทองหลาง",104502,"เต็นท์ในโรงเรียนแจ่มศึกษา(ซอยลาดพร้าว47ฝั่งซ้าย)",2,286,327,396,723
5993,"สะพานสอง","เขตวังทองหลาง",104502,"เต็นท์ในโรงเรียนแจ่มศึกษา(ซอยลาดพร้าว47ฝั่งซ้าย)",3,253,287,409,696
5994,"สะพานสอง","เขตวังทองหลาง",104502,"เต็นท์ในโรงเรียนแจ่มศึกษา(ซอยลาดพร้าว47ฝั่งซ้าย)",4,252,315,399,714
5995,"สะพานสอง","เขตวังทองหลาง",104502,"เต็นท์ในโรงเรียนแจ่มศึกษา(ซอยลาดพร้าว47ฝั่งซ้าย)",5,472,294,426,720
5996,"สะพานสอง","เขตวังทองหลาง",104502,"เต็นท์ในโรงเรียนแจ่มศึกษา(ซอยลาดพร้าว47ฝั่งซ้าย)",6,352,309,388,697
5997,"สะพานสอง","เขตวังทองหลาง",104502,"องค์การค้า สกสค.(โรงพิมพ์คุรุสภาระหว่างซอยลาดพร้าว61-63)",7,208,253,329,582
5998,"สะพานสอง","เขตวังทองหลาง",104502,"องค์การค้า สกสค.(โรงพิมพ์คุรุสภาระหว่างซอยลาดพร้าว61-63)",8,205,277,343,620
5999,"สะพานสอง","เขตวังทองหลาง",104502,"องค์การค้า สกสค.(โรงพิมพ์คุรุสภาระหว่างซอยลาดพร้าว61-63)",9,217,259,346,605
6000,"สะพานสอง","เขตวังทองหลาง",104502,"องค์การค้า สกสค.(โรงพิมพ์คุรุสภาระหว่างซอยลาดพร้าว61-63)",10,197,253,277,530
6001,"สะพานสอง","เขตวังทองหลาง",104502,"เต็นท์สวนวังทอง1(ปากซอยลาดพร้าว71ฝั่งขวา)",11,303,337,380,717
6002,"สะพานสอง","เขตวังทองหลาง",104502,"โรงเรียนนวมินทราชินูทิศบดินทรเดชา(ซอยลาดพร้าว69)",12,225,284,356,640
6003,"สะพานสอง","เขตวังทองหลาง",104502,"โรงเรียนนวมินทราชินูทิศบดินทรเดชา(ซอยลาดพร้าว69)",13,199,293,332,625
6004,"สะพานสอง","เขตวังทองหลาง",104502,"โรงเรียนนวมินทราชินูทิศบดินทรเดชา(ซอยลาดพร้าว69)",14,201,275,340,615
6005,"สะพานสอง","เขตวังทองหลาง",104502,"โรงเรียนนวมินทราชินูทิศบดินทรเดชา(ซอยลาดพร้าว69)",15,174,207,291,498
6006,"คลองเจ้าคุณสิงห์","เขตวังทองหลาง",104503,"เต็นท์หน้าร้านชายคาพักกาย(ซอยลาดพร้าว83)",1,433,351,440,791
6007,"คลองเจ้าคุณสิงห์","เขตวังทองหลาง",104503,"เต็นท์หน้าร้านชายคาพักกาย(ซอยลาดพร้าว83)",2,289,294,380,674
6008,"คลองเจ้าคุณสิงห์","เขตวังทองหลาง",104503,"เต็นท์หน้าร้านชายคาพักกาย(ซอยลาดพร้าว83)",3,257,282,357,639
6009,"คลองเจ้าคุณสิงห์","เขตวังทองหลาง",104503,"เต็นท์หน้าร้านชายคาพักกาย (ซอยลาดพร้าว83)",4,292,336,366,702
6010,"คลองเจ้าคุณสิงห์","เขตวังทองหลาง",104503,"เต็นท์หน้าร้านชายคาพักกาย (ซอยลาดพร้าว83)",5,263,312,402,714
6011,"คลองเจ้าคุณสิงห์","เขตวังทองหลาง",104503,"เต็นท์บริเวณปากซอยลาดพร้าว 87 แยก 2",6,224,274,358,632
6012,"คลองเจ้าคุณสิงห์","เขตวังทองหลาง",104503,"เต็นท์บริเวณปากซอยลาดพร้าว 87 แยก 2",7,284,306,380,686
6013,"คลองเจ้าคุณสิงห์","เขตวังทองหลาง",104503,"เต็นท์บริเวณปากซอยลาดพร้าว 87 แยก 2",8,226,257,338,595
6014,"คลองเจ้าคุณสิงห์","เขตวังทองหลาง",104503,"เต็นท์บริเวณปากซอยลาดพร้าว 87 แยก 2",9,245,281,386,667
6015,"คลองเจ้าคุณสิงห์","เขตวังทองหลาง",104503,"เต็นท์บริเวณปากซอยลาดพร้าว 87 แยก 2",10,185,305,318,623
6016,"คลองเจ้าคุณสิงห์","เขตวังทองหลาง",104503,"เต็นท์บริเวณปากซอยลาดพร้าว 87 แยก 2",11,364,304,388,692
6017,"คลองเจ้าคุณสิงห์","เขตวังทองหลาง",104503,"เต็นท์บริเวณลานกีฬาหมู่บ้านจัดสรร บ้านสวนซื่อตรง(ซอยลาดพร้าว87 แยก7)",12,105,267,266,533
6018,"คลองเจ้าคุณสิงห์","เขตวังทองหลาง",104503,"เต็นท์บริเวณลานกีฬาหมู่บ้านจัดสรร บ้านสวนซื่อตรง(ซอยลาดพร้าว87 แยก7)",13,155,300,317,617
6019,"คลองเจ้าคุณสิงห์","เขตวังทองหลาง",104503,"เต็นท์บริเวณหมู่บ้านทิวสนโครงการ 4(ซอยลาดพร้าว87แยก18)",14,282,297,392,689
6020,"คลองเจ้าคุณสิงห์","เขตวังทองหลาง",104503,"เต็นท์บริเวณหมู่บ้านทิวสนโครงการ 4(ซอยลาดพร้าว87แยก18)",15,283,312,378,690
6021,"คลองเจ้าคุณสิงห์","เขตวังทองหลาง",104503,"เต็นท์บริเวณหมู่บ้านทิวสนโครงการ 4(ซอยลาดพร้าว87แยก18)",16,269,302,395,697
6022,"คลองเจ้าคุณสิงห์","เขตวังทองหลาง",104503,"เต็นท์บริเวณหมู่บ้านทิวสนโครงการ 4(ซอยลาดพร้าว87แยก18)",17,234,293,369,662
6023,"คลองเจ้าคุณสิงห์","เขตวังทองหลาง",104503,"เต็นท์บริเวณหมู่บ้านทิวสนโครงการ 4(ซอยลาดพร้าว87แยก18)",18,237,302,367,669
6024,"คลองเจ้าคุณสิงห์","เขตวังทองหลาง",104503,"เต็นท์บริเวณหมู่บ้านทิวสนโครงการ 4(ซอยลาดพร้าว87แยก18)",19,227,296,388,684
6025,"คลองเจ้าคุณสิงห์","เขตวังทองหลาง",104503,"เต็นท์บริเวณหมู่บ้านทิวสนโครงการ 4(ซอยลาดพร้าว87แยก18)",20,266,297,375,672
6026,"คลองเจ้าคุณสิงห์","เขตวังทองหลาง",104503,"เต็นท์บริเวณหมู่บ้านทิวสนโครงการ 4(ซอยลาดพร้าว87แยก18)",21,207,279,373,652
6027,"คลองเจ้าคุณสิงห์","เขตวังทองหลาง",104503,"เต็นท์ลานจอดรถสนามฟุตบอลซอคเกอร์โปร(ปากซอยลาดพร้าว89)",22,272,350,424,774
6028,"คลองเจ้าคุณสิงห์","เขตวังทองหลาง",104503,"เต็นท์ลานจอดรถสนามฟุตบอลซอคเกอร์โปร(ปากซอยลาดพร้าว89)",23,273,319,382,701
6029,"คลองเจ้าคุณสิงห์","เขตวังทองหลาง",104503,"เต็นท์ลานจอดรถสนามฟุตบอลซอคเกอร์โปร(ปากซอยลาดพร้าว89)",24,249,309,382,691
6030,"คลองเจ้าคุณสิงห์","เขตวังทองหลาง",104503,"เต็นท์ลานจอดรถสนามฟุตบอลซอคเกอร์โปร(ปากซอยลาดพร้าว89)",25,272,316,406,722
6031,"คลองเจ้าคุณสิงห์","เขตวังทองหลาง",104503,"เต็นท์ลานจอดรถฟู้ดแลนด์(ปากซอยลาดพร้าว95)",26,297,276,387,663
6032,"คลองเจ้าคุณสิงห์","เขตวังทองหลาง",104503,"เต็นท์ลานจอดรถฟู้ดแลนด์(ปากซอยลาดพร้าว95)",27,241,264,329,593
6033,"คลองเจ้าคุณสิงห์","เขตวังทองหลาง",104503,"เต็นท์หน้าธนาคารกสิกรไทย(ปากซอยลาดพร้าว99)",28,145,174,226,400
6034,"คลองเจ้าคุณสิงห์","เขตวังทองหลาง",104503,"เต็นท์หน้าโรงเรียนอนุบาลราชพงษา(ซอยลาดพร้าว101)",29,232,330,421,751
6035,"คลองเจ้าคุณสิงห์","เขตวังทองหลาง",104503,"เต็นท์หน้าโรงเรียนอนุบาลราชพงษา(ซอยลาดพร้าว101)",30,295,318,437,755
6036,"คลองเจ้าคุณสิงห์","เขตวังทองหลาง",104503,"เต็นท์หน้าโรงเรียนอนุบาลราชพงษา(ซอยลาดพร้าว101)",31,248,321,390,711
6037,"คลองเจ้าคุณสิงห์","เขตวังทองหลาง",104503,"เต็นท์หน้าโรงเรียนอนุบาลราชพงษา(ซอยลาดพร้าว101)",32,466,286,435,721
6038,"คลองเจ้าคุณสิงห์","เขตวังทองหลาง",104503,"เต็นท์หน้าโรงเรียนอนุบาลราชพงษา(ซอยลาดพร้าว101)",33,332,331,453,784
6039,"พลับพลา","เขตวังทองหลาง",104504,"อาคารชุมชนหมู่บ้านพลับพลา (ซอยรามคำแหง21)",1,270,292,375,667
6040,"พลับพลา","เขตวังทองหลาง",104504,"อาคารชุมชนหมู่บ้านพลับพลา (ซอยรามคำแหง21)",2,256,290,384,674
6041,"พลับพลา","เขตวังทองหลาง",104504,"อาคารชุมชนหมู่บ้านพลับพลา (ซอยรามคำแหง21)",3,226,297,348,645
6042,"พลับพลา","เขตวังทองหลาง",104504,"อาคารชุมชนหมู่บ้านพลับพลา(ซอยรามคำแหง21)",4,214,326,328,654
6043,"พลับพลา","เขตวังทองหลาง",104504,"อาคารชุมชนหมู่บ้านพลับพลา(ซอยรามคำแหง21)",5,199,298,358,656
6044,"พลับพลา","เขตวังทองหลาง",104504,"วิทยาลัยพณิชยการอินทราชัย(ซอยรามคำแหง39)",6,329,367,419,786
6045,"พลับพลา","เขตวังทองหลาง",104504,"วิทยาลัยพณิชยการอินทราชัย(ซอยรามคำแหง39)",7,180,357,385,742
6046,"พลับพลา","เขตวังทองหลาง",104504,"วิทยาลัยพณิชยการอินทราชัย(ซอยรามคำแหง39)",8,193,369,400,769
6047,"พลับพลา","เขตวังทองหลาง",104504,"วิทยาลัยพณิชยการอินทราชัย(ซอยรามคำแหง39)",9,181,337,421,758
6048,"พลับพลา","เขตวังทองหลาง",104504,"วิทยาลัยพณิชยการอินทราชัย(ซอยรามคำแหง39)",10,232,346,404,750
6049,"พลับพลา","เขตวังทองหลาง",104504,"วิทยาลัยพณิชยการอินทราชัย(ซอยรามคำแหง39)",11,240,369,412,781
6050,"พลับพลา","เขตวังทองหลาง",104504,"วิทยาลัยพณิชยการอินทราชัย(ซอยรามคำแหง39)",12,197,326,397,723
6051,"พลับพลา","เขตวังทองหลาง",104504,"วิทยาลัยพณิชยการอินทราชัย(ซอยรามคำแหง39)",13,258,351,388,739
6052,"พลับพลา","เขตวังทองหลาง",104504,"เต็นท์ลานจอดรถวัดแม่พระกุหลาบทิพย์(ปากซอยลาดพร้าว124)",14,275,311,355,666
6053,"พลับพลา","เขตวังทองหลาง",104504,"เต็นท์ลานจอดรถวัดแม่พระกุหลาบทิพย์(ปากซอยลาดพร้าว124)",15,249,292,355,647
6054,"พลับพลา","เขตวังทองหลาง",104504,"เต็นท์ลานจอดรถวัดแม่พระกุหลาบทิพย์(ปากซอยลาดพร้าว124)",16,412,318,405,723
6055,"พลับพลา","เขตวังทองหลาง",104504,"เต็นท์ลานจอดรถวัดแม่พระกุหลาบทิพย์(ปากซอยลาดพร้าว124)",17,363,287,366,653
6056,"พลับพลา","เขตวังทองหลาง",104504,"เต็นท์ลานจอดรถวัดแม่พระกุหลาบทิพย์(ปากซอยลาดพร้าว124)",18,276,293,343,636
6057,"พลับพลา","เขตวังทองหลาง",104504,"โรงเรียนอิสลามสันติชน(ซอยลาดพร้าว112ฝั่งขวา)",19,259,334,417,751
6058,"พลับพลา","เขตวังทองหลาง",104504,"โรงเรียนอิสลามสันติชน(ซอยลาดพร้าว112ฝั่งขวา)",20,305,324,405,729
6059,"พลับพลา","เขตวังทองหลาง",104504,"โรงเรียนอิสลามสันติชน(ซอยลาดพร้าว112ฝั่งขวา)",21,300,350,392,742
6060,"พลับพลา","เขตวังทองหลาง",104504,"โรงเรียนอิสลามสันติชน(ซอยลาดพร้าว112ฝั่งขวา)",22,291,301,380,681
6061,"พลับพลา","เขตวังทองหลาง",104504,"โรงเรียนอิสลามสันติชน(ซอยลาดพร้าว112ฝั่งขวา)",23,246,360,385,745
6062,"พลับพลา","เขตวังทองหลาง",104504,"เต็นท์บริเวณลานจอดรถตลาดสายหยุด (ซอยลาดพร้าว112)",24,261,306,334,640
6063,"พลับพลา","เขตวังทองหลาง",104504,"เต็นท์บริเวณลานจอดรถตลาดสายหยุด (ซอยลาดพร้าว112)",25,257,294,372,666
6064,"พลับพลา","เขตวังทองหลาง",104504,"เต็นท์บริเวณลานจอดรถตลาดสายหยุด (ซอยลาดพร้าว112)",26,281,315,360,675
6065,"พลับพลา","เขตวังทองหลาง",104504,"เต็นท์บริเวณลานจอดรถตลาดสายหยุด (ซอยลาดพร้าว112)",27,308,329,417,746
6066,"พลับพลา","เขตวังทองหลาง",104504,"เต็นท์บริเวณลานจอดรถตลาดสายหยุด (ซอยลาดพร้าว112)",28,277,342,425,767
6067,"พลับพลา","เขตวังทองหลาง",104504,"เต็นท์บริเวณลานจอดรถตลาดสายหยุด (ซอยลาดพร้าว112)",29,225,269,316,585
6068,"พลับพลา","เขตวังทองหลาง",104504,"โรงเรียนสุเหร่าดอนสะแก(ซอยลาดพร้าว96ฝั่งซ้าย)",30,264,330,430,760
6069,"พลับพลา","เขตวังทองหลาง",104504,"โรงเรียนสุเหร่าดอนสะแก(ซอยลาดพร้าว96ฝั่งซ้าย)",31,292,318,426,744
6070,"พลับพลา","เขตวังทองหลาง",104504,"โรงเรียนสุเหร่าดอนสะแก(ซอยลาดพร้าว96ฝั่งซ้าย)",32,387,327,472,799
6071,"พลับพลา","เขตวังทองหลาง",104504,"โรงเรียนสุเหร่าดอนสะแก(ซอยลาดพร้าว96ฝั่งซ้าย)",33,231,305,375,680
6072,"พลับพลา","เขตวังทองหลาง",104504,"โรงเรียนสุเหร่าดอนสะแก(ซอยลาดพร้าว96ฝั่งซ้าย)",34,257,314,431,745
6073,"พลับพลา","เขตวังทองหลาง",104504,"เต็นท์ในโรงเรียนอุดมศึกษา(ซอยลาดพร้าว94ฝั่งซ้าย)",35,299,332,398,730
6074,"พลับพลา","เขตวังทองหลาง",104504,"เต็นท์ในโรงเรียนอุดมศึกษา(ซอยลาดพร้าว94ฝั่งซ้าย)",36,463,293,451,744
6075,"พลับพลา","เขตวังทองหลาง",104504,"เต็นท์ในโรงเรียนอุดมศึกษา(ซอยลาดพร้าว94ฝั่งซ้าย)",37,402,317,422,739
6076,"พลับพลา","เขตวังทองหลาง",104504,"เต็นท์ในโรงเรียนอุดมศึกษา(ซอยลาดพร้าว94ฝั่งซ้าย)",38,398,345,396,741
6077,"พลับพลา","เขตวังทองหลาง",104504,"เต็นท์ในโรงเรียนอุดมศึกษา(ซอยลาดพร้าว94ฝั่งซ้าย)",39,302,339,401,740
6078,"พลับพลา","เขตวังทองหลาง",104504,"เต็นท์ในโรงเรียนอุดมศึกษา(ซอยลาดพร้าว94ฝั่งซ้าย)",40,357,293,425,718
6079,"พลับพลา","เขตวังทองหลาง",104504,"เต็นท์ในโรงเรียนอุดมศึกษา(ซอยลาดพร้าว94ฝั่งซ้าย)",41,363,309,427,736
6080,"พลับพลา","เขตวังทองหลาง",104504,"เต็นท์ในโรงเรียนอุดมศึกษา(ซอยลาดพร้าว94ฝั่งซ้าย)",42,345,321,441,762
6081,"พลับพลา","เขตวังทองหลาง",104504,"เต็นท์ในโรงเรียนอุดมศึกษา(ซอยลาดพร้าว94ฝั่งซ้าย)",43,327,312,415,727
6082,"พลับพลา","เขตวังทองหลาง",104504,"เต็นท์ในโรงเรียนอุดมศึกษา(ซอยลาดพร้าว94ฝั่งซ้าย)",44,339,259,408,667
6083,"พลับพลา","เขตวังทองหลาง",104504,"เต็นท์ในโรงเรียนอุดมศึกษา(ซอยลาดพร้าว94ฝั่งซ้าย)",45,529,285,458,743
6084,"พลับพลา","เขตวังทองหลาง",104504,"เต็นท์ในโรงเรียนอุดมศึกษา(ซอยลาดพร้าว94ฝั่งซ้าย)",46,575,319,472,791
6085,"พลับพลา","เขตวังทองหลาง",104504,"เต็นท์ในโรงเรียนอุดมศึกษา(ซอยลาดพร้าว94ฝั่งซ้าย)",47,473,326,409,735
6086,"สามวาตะวันตก","เขตคลองสามวา",104601,"เต็นท์หน้าหมู่บ้านพนาสนธิ์การ์เด้นโฮม 1 ถนนหทัยราษฎร์",1,290,407,445,852
6087,"สามวาตะวันตก","เขตคลองสามวา",104601,"เต็นท์บริเวณวงเวียนศาลพระพรหมหมู่บ้านเมืองประชา",2,267,279,349,628
6088,"สามวาตะวันตก","เขตคลองสามวา",104601,"เต็นท์บริเวณวงเวียนศาลพระพรหมหมู่บ้านเมืองประชา",3,272,302,334,636
6089,"สามวาตะวันตก","เขตคลองสามวา",104601,"เต็นท์บริเวณวงเวียนศาลพระพรหมหมู่บ้านเมืองประชา",4,255,278,310,588
6090,"สามวาตะวันตก","เขตคลองสามวา",104601,"เต็นท์บริเวณวงเวียนศาลพระพรหมหมู่บ้านเมืองประชา",5,226,265,277,542
6091,"สามวาตะวันตก","เขตคลองสามวา",104601,"เต็นท์บริเวณวงเวียนศาลพระพรหมหมู่บ้านเมืองประชา",6,258,285,334,619
6092,"สามวาตะวันตก","เขตคลองสามวา",104601,"เต็นท์บริเวณวงเวียนศาลพระพรหมหมู่บ้านเมืองประชา",7,246,270,337,607
6093,"สามวาตะวันตก","เขตคลองสามวา",104601,"เต็นท์ริมถนนหทัยราษฎร์ระหว่างซอยหทัยราษฎร์ 37 - 39",8,205,281,318,599
6094,"สามวาตะวันตก","เขตคลองสามวา",104601,"เต็นท์ริมถนนหทัยราษฎร์ระหว่างซอยหทัยราษฎร์ 37 - 39",9,250,295,332,627
6095,"สามวาตะวันตก","เขตคลองสามวา",104601,"โรงเรียนสุเหร่าสามวา ซอยหทัยราษฎร์ 40",10,357,326,376,702
6096,"สามวาตะวันตก","เขตคลองสามวา",104601,"โรงเรียนสุเหร่าสามวา ซอยหทัยราษฎร์ 40",11,368,282,374,656
6097,"สามวาตะวันตก","เขตคลองสามวา",104601,"โรงเรียนสุเหร่าสามวา ซอยหทัยราษฎร์ 40",12,167,242,275,517
6098,"สามวาตะวันตก","เขตคลองสามวา",104601,"โรงเรียนสุเหร่าสามวา ซอยหทัยราษฎร์ 40",13,166,290,294,584
6099,"สามวาตะวันตก","เขตคลองสามวา",104601,"อาคารอเนกประสงค์ 3 ชั้น โรงเรียนนวมินทราชินูทิศ เบญจมราชาลัย",14,328,308,357,665
6100,"สามวาตะวันตก","เขตคลองสามวา",104601,"อาคารอเนกประสงค์ 3 ชั้น โรงเรียนนวมินทราชินูทิศ เบญจมราชาลัย",15,248,290,325,615
6101,"สามวาตะวันตก","เขตคลองสามวา",104601,"อาคารอเนกประสงค์ 3 ชั้น โรงเรียนนวมินทราชินูทิศ เบญจมราชาลัย",16,253,282,338,620
6102,"สามวาตะวันตก","เขตคลองสามวา",104601,"อาคารอเนกประสงค์ 3 ชั้น โรงเรียนนวมินทราชินูทิศ เบญจมราชาลัย",17,272,295,356,651
6103,"สามวาตะวันตก","เขตคลองสามวา",104601,"โรงอาหาร 2 โรงเรียนนวมินทราชินูทิศ เบญจมราชาลัย",18,327,295,369,664
6104,"สามวาตะวันตก","เขตคลองสามวา",104601,"โรงอาหาร 2 โรงเรียนนวมินทราชินูทิศ เบญจมราชาลัย",19,294,287,371,658
6105,"สามวาตะวันตก","เขตคลองสามวา",104601,"โรงอาหาร 2 โรงเรียนนวมินทราชินูทิศ เบญจมราชาลัย",20,284,278,317,595
6106,"สามวาตะวันตก","เขตคลองสามวา",104601,"โรงอาหาร 2 โรงเรียนนวมินทราชินูทิศ เบญจมราชาลัย",21,254,252,306,558
6107,"สามวาตะวันตก","เขตคลองสามวา",104601,"อาคาร 30 ปี นวมินทร์ โรงเรียนนวมินทราชินูทิศ เบญจมราชาลัย",22,282,287,317,604
6108,"สามวาตะวันตก","เขตคลองสามวา",104601,"อาคาร 30 ปี นวมินทร์ โรงเรียนนวมินทราชินูทิศ เบญจมราชาลัย",23,326,310,336,646
6109,"สามวาตะวันตก","เขตคลองสามวา",104601,"โรงเรียนวัดแป้นทอง ซอยหทัยราษฎร์ 39",24,313,284,372,656
6110,"สามวาตะวันตก","เขตคลองสามวา",104601,"โรงเรียนวัดแป้นทอง ซอยหทัยราษฎร์ 39",25,195,253,274,527
6111,"สามวาตะวันตก","เขตคลองสามวา",104601,"โรงเรียนวัดแป้นทอง ซอยหทัยราษฎร์ 39",26,198,222,252,474
6112,"สามวาตะวันตก","เขตคลองสามวา",104601,"โรงเรียนวัดแป้นทอง ซอยหทัยราษฎร์ 39",27,192,230,263,493
6113,"สามวาตะวันตก","เขตคลองสามวา",104601,"โรงเรียนวัดแป้นทอง ซอยหทัยราษฎร์ 39",28,194,250,275,525
6114,"สามวาตะวันตก","เขตคลองสามวา",104601,"เต็นท์สนามกีฬาในหมู่บ้าน เค.ซี.รามอินทรา 1 ซอยหทัยราษฎร์ 39",29,246,290,316,606
6115,"สามวาตะวันตก","เขตคลองสามวา",104601,"เต็นท์สนามกีฬาในหมู่บ้าน เค.ซี.รามอินทรา 1 ซอยหทัยราษฎร์ 39",30,252,279,377,656
6116,"สามวาตะวันตก","เขตคลองสามวา",104601,"เต็นท์สนามกีฬาในหมู่บ้าน เค.ซี.รามอินทรา 1 ซอยหทัยราษฎร์ 39",31,244,272,335,607
6117,"สามวาตะวันตก","เขตคลองสามวา",104601,"เต็นท์สนามกีฬาในหมู่บ้าน เค.ซี.รามอินทรา 1 ซอยหทัยราษฎร์ 39",32,246,289,321,610
6118,"สามวาตะวันตก","เขตคลองสามวา",104601,"เต็นท์สนามกีฬาในหมู่บ้าน เค.ซี.รามอินทรา 1 ซอยหทัยราษฎร์ 39",33,225,253,314,567
6119,"สามวาตะวันตก","เขตคลองสามวา",104601,"เต็นท์สนามกีฬาในหมู่บ้าน เค.ซี.รามอินทรา 2 ซอยหทัยราษฎร์ 39",34,225,294,310,604
6120,"สามวาตะวันตก","เขตคลองสามวา",104601,"เต็นท์สนามกีฬาในหมู่บ้าน เค.ซี.รามอินทรา 2 ซอยหทัยราษฎร์ 39",35,177,228,271,499
6121,"สามวาตะวันตก","เขตคลองสามวา",104601,"เต็นท์สนามกีฬาในหมู่บ้าน เค.ซี.รามอินทรา 3 ซอยหทัยราษฎร์ 39",36,266,321,378,699
6122,"สามวาตะวันตก","เขตคลองสามวา",104601,"เต็นท์สนามกีฬาในหมู่บ้าน เค.ซี.รามอินทรา 3 ซอยหทัยราษฎร์ 39",37,284,335,416,751
6123,"สามวาตะวันตก","เขตคลองสามวา",104601,"เต็นท์ลานอเนกประสงค์หมู่บ้านวงศกร 3 ซอยหนองระแหง 3",38,325,334,435,769
6124,"สามวาตะวันตก","เขตคลองสามวา",104601,"เต็นท์ลานอเนกประสงค์หมู่บ้านวงศกร 3 ซอยหนองระแหง 3",39,255,312,329,641
6125,"สามวาตะวันตก","เขตคลองสามวา",104601,"โรงเรียนบ้านหนองระแหง ถนนหนองระแหง",40,424,319,389,708
6126,"สามวาตะวันตก","เขตคลองสามวา",104601,"โรงเรียนบ้านหนองระแหง ถนนหนองระแหง",41,237,311,352,663
6127,"สามวาตะวันตก","เขตคลองสามวา",104601,"เต็นท์บริเวณลานกีฬาหมู่บ้านวงศกร 5 ซอยหนองระแหง 4 แยก 1",42,190,260,243,503
6128,"สามวาตะวันตก","เขตคลองสามวา",104601,"เต็นท์บริเวณลานกีฬาหมู่บ้านวงศกร 5 ซอยหนองระแหง 4 แยก 1",43,185,220,252,472
6129,"สามวาตะวันตก","เขตคลองสามวา",104601,"เต็นท์หน้าสโมสรหมู่บ้านเนเบอร์โฮม ซอยสุขาภิบาล 5 ซอย 82",44,287,295,366,661
6130,"สามวาตะวันตก","เขตคลองสามวา",104601,"เต็นท์หน้าสโมสรหมู่บ้านเนเบอร์โฮม ซอยสุขาภิบาล 5 ซอย 82",45,340,306,384,690
6131,"สามวาตะวันตก","เขตคลองสามวา",104601,"โรงเรียนกลางคลองสอง ซอยพระยาสุเรนทร์ 40",46,302,322,412,734
6132,"สามวาตะวันตก","เขตคลองสามวา",104601,"โรงเรียนกลางคลองสอง ซอยพระยาสุเรนทร์ 40",47,300,310,391,701
6133,"สามวาตะวันตก","เขตคลองสามวา",104601,"โรงเรียนกลางคลองสอง ซอยพระยาสุเรนทร์ 40",48,287,330,376,706
6134,"สามวาตะวันตก","เขตคลองสามวา",104601,"เต็นท์ใกล้สโมสรหมู่บ้านบุศรินทร์ ซอยพระยาสุเรนทร์ 40",49,284,277,360,637
6135,"สามวาตะวันตก","เขตคลองสามวา",104601,"เต็นท์ใกล้สโมสรหมู่บ้านบุศรินทร์ ซอยพระยาสุเรนทร์ 40",50,284,280,338,618
6136,"สามวาตะวันตก","เขตคลองสามวา",104601,"เต็นท์หมู่บ้านเสนาวิลล่า 4 ซอยพระยาสุเรนทร์ 40",51,311,335,447,782
6137,"สามวาตะวันตก","เขตคลองสามวา",104601,"อาคารอเนกประสงค์หมู่บ้านเลิศอุบล ซอยพระยาสุเรนทร์ 44",52,202,218,241,459
6138,"สามวาตะวันตก","เขตคลองสามวา",104601,"อาคารอเนกประสงค์หมู่บ้านเลิศอุบล ซอยพระยาสุเรนทร์ 44",53,161,211,232,443
6139,"สามวาตะวันตก","เขตคลองสามวา",104601,"โรงเรียนวัดพระยาสุเรนทร์ ถนนพระยาสุเรนทร์",54,212,305,363,668
6140,"สามวาตะวันตก","เขตคลองสามวา",104601,"โรงเรียนวัดพระยาสุเรนทร์ ถนนพระยาสุเรนทร์",55,207,225,303,528
6141,"สามวาตะวันตก","เขตคลองสามวา",104601,"โรงเรียนวัดพระยาสุเรนทร์ ถนนพระยาสุเรนทร์",56,327,317,409,726
6142,"สามวาตะวันตก","เขตคลองสามวา",104601,"โรงเรียนวัดพระยาสุเรนทร์ ถนนพระยาสุเรนทร์",57,277,313,363,676
6143,"สามวาตะวันตก","เขตคลองสามวา",104601,"เต็นท์ข้างสโมสรหมู่บ้านบุรีรมย์ ซอยคู้บอน 41",58,301,324,377,701
6144,"สามวาตะวันตก","เขตคลองสามวา",104601,"เต็นท์ข้างสโมสรหมู่บ้านบุรีรมย์ ซอยคู้บอน 41",59,247,278,311,589
6145,"สามวาตะวันตก","เขตคลองสามวา",104601,"อาคารอเนกประสงค์วิทยาลัยบริหารธุรกิจและการท่องเที่ยวกรุงเทพ",60,254,309,393,702
6146,"สามวาตะวันตก","เขตคลองสามวา",104601,"อาคารอเนกประสงค์วิทยาลัยบริหารธุรกิจและการท่องเที่ยวกรุงเทพ",61,216,275,320,595
6147,"สามวาตะวันตก","เขตคลองสามวา",104601,"อาคารอเนกประสงค์วิทยาลัยบริหารธุรกิจและการท่องเที่ยวกรุงเทพ",62,251,318,340,658
6148,"สามวาตะวันตก","เขตคลองสามวา",104601,"อาคารอเนกประสงค์วิทยาลัยบริหารธุรกิจและการท่องเที่ยวกรุงเทพ",63,182,249,291,540
6149,"สามวาตะวันตก","เขตคลองสามวา",104601,"อาคารอเนกประสงค์วิทยาลัยบริหารธุรกิจและการท่องเที่ยวกรุงเทพ",64,280,283,364,647
6150,"สามวาตะวันตก","เขตคลองสามวา",104601,"อาคารอเนกประสงค์วิทยาลัยบริหารธุรกิจและการท่องเที่ยวกรุงเทพ",65,340,351,402,753
6151,"สามวาตะวันตก","เขตคลองสามวา",104601,"เต็นท์หน้าหมู่บ้านพร้อมพัฒน์ 1 ถนนปัญญาอินทรา",66,288,278,313,591
6152,"สามวาตะวันตก","เขตคลองสามวา",104601,"เต็นท์หน้าหมู่บ้านพร้อมพัฒน์ 1 ถนนปัญญาอินทรา",67,345,294,340,634
6153,"สามวาตะวันตก","เขตคลองสามวา",104601,"เต็นท์หน้าหมู่บ้านพร้อมพัฒน์ 1 ถนนปัญญาอินทรา",68,335,290,368,658
6154,"สามวาตะวันตก","เขตคลองสามวา",104601,"เต็นท์หน้าหมู่บ้านพร้อมพัฒน์ 1 ถนนปัญญาอินทรา",69,282,260,292,552
6155,"สามวาตะวันตก","เขตคลองสามวา",104601,"เต็นท์หน้าหมู่บ้านพร้อมพัฒน์ 1 ถนนปัญญาอินทรา",70,255,250,298,548
6156,"สามวาตะวันตก","เขตคลองสามวา",104601,"เต็นท์หน้าหมู่บ้านพร้อมพัฒน์ 1 ถนนปัญญาอินทรา",71,310,282,357,639
6157,"สามวาตะวันตก","เขตคลองสามวา",104601,"เต็นท์หน้าหมู่บ้านมโนรมย์ 2 ถนนเลียบคลองสอง",72,243,305,344,649
6158,"สามวาตะวันตก","เขตคลองสามวา",104601,"เต็นท์หน้าหมู่บ้านมโนรมย์ 2 ถนนเลียบคลองสอง",73,255,320,341,661
6159,"สามวาตะวันตก","เขตคลองสามวา",104601,"เต็นท์หน้าสโมสรหมู่บ้านวรารักษ์ ถนนเลียบคลองสอง",74,337,365,415,780
6160,"สามวาตะวันตก","เขตคลองสามวา",104601,"เต็นท์หน้าสโมสรหมู่บ้านวรารักษ์ ถนนเลียบคลองสอง",75,323,351,417,768
6161,"สามวาตะวันออก","เขตคลองสามวา",104602,"โรงเรียนวัดสุทธิสะอาด ถนนนิมิตใหม่",1,206,310,346,656
6162,"สามวาตะวันออก","เขตคลองสามวา",104602,"โรงเรียนวัดสุทธิสะอาด ถนนนิมิตใหม่",2,292,313,406,719
6163,"สามวาตะวันออก","เขตคลองสามวา",104602,"โรงเรียนวัดสุทธิสะอาด ถนนนิมิตใหม่",3,310,350,389,739
6164,"สามวาตะวันออก","เขตคลองสามวา",104602,"เต็นท์บริเวณสโมสรหมู่บ้านปัญญาเลคโฮม ซอยนิมิตใหม่ 28",4,361,403,448,851
6165,"สามวาตะวันออก","เขตคลองสามวา",104602,"เต็นท์ศูนย์เกษตรคลองสาม ซอยนิมิตใหม่ 36",5,203,360,390,750
6166,"สามวาตะวันออก","เขตคลองสามวา",104602,"เต็นท์สนามฟุตบอล ซอยนิมิตใหม่ 55",6,211,334,350,684
6167,"สามวาตะวันออก","เขตคลองสามวา",104602,"เต็นท์สนามฟุตบอล ซอยนิมิตใหม่ 55",7,196,318,352,670
6168,"สามวาตะวันออก","เขตคลองสามวา",104602,"เต็นท์สนามฟุตบอล ซอยนิมิตใหม่ 55",8,181,330,343,673
6169,"สามวาตะวันออก","เขตคลองสามวา",104602,"เต็นท์สนามเด็กเล่น เค.ซี.การ์เด้นโฮม 3 หมู่บ้านเค.ซี.การ์เด้นโฮม ซอยนิมิตใหม่ 40",9,253,286,312,598
6170,"สามวาตะวันออก","เขตคลองสามวา",104602,"เต็นท์สนามเด็กเล่น เค.ซี.การ์เด้นโฮม 3หมู่บ้านเค.ซี.การ์เด้นโฮม ซอยนิมิตใหม่ 40",10,227,302,318,620
6171,"สามวาตะวันออก","เขตคลองสามวา",104602,"เต็นท์สนามเด็กเล่น เค.ซี.การ์เด้นโฮม 3หมู่บ้านเค.ซี.การ์เด้นโฮม ซอยนิมิตใหม่ 40",11,274,263,322,585
6172,"สามวาตะวันออก","เขตคลองสามวา",104602,"เต็นท์สนามเด็กเล่น เค.ซี.การ์เด้นโฮม 3หมู่บ้านเค.ซี.การ์เด้นโฮม ซอยนิมิตใหม่ 40",12,253,294,324,618
6173,"สามวาตะวันออก","เขตคลองสามวา",104602,"เต็นท์สนามเด็กเล่น เค.ซี.การ์เด้นโฮม 3หมู่บ้านเค.ซี.การ์เด้นโฮม ซอยนิมิตใหม่ 40",13,251,287,321,608
6174,"สามวาตะวันออก","เขตคลองสามวา",104602,"เต็นท์สนามเด็กเล่น เค.ซี.การ์เด้นโฮม 3หมู่บ้านเค.ซี.การ์เด้นโฮม ซอยนิมิตใหม่ 40",14,233,272,346,618
6175,"สามวาตะวันออก","เขตคลองสามวา",104602,"เต็นท์สนามเด็กเล่น เค.ซี.การ์เด้นโฮม 3หมู่บ้านเค.ซี.การ์เด้นโฮม ซอยนิมิตใหม่ 40",15,272,305,380,685
6176,"สามวาตะวันออก","เขตคลองสามวา",104602,"เต็นท์สนามเด็กเล่น เค.ซี.การ์เด้นโฮม 3หมู่บ้านเค.ซี.การ์เด้นโฮม ซอยนิมิตใหม่ 40",16,275,305,356,661
6177,"สามวาตะวันออก","เขตคลองสามวา",104602,"โรงเรียนนวมินทราชินูทิศ สตรีวิทยา 2 ซอยนิมิตใหม่ 64",17,155,239,261,500
6178,"สามวาตะวันออก","เขตคลองสามวา",104602,"โรงเรียนนวมินทราชินูทิศ สตรีวิทยา 2 ซอยนิมิตใหม่ 64",18,145,214,246,460
6179,"สามวาตะวันออก","เขตคลองสามวา",104602,"โรงเรียนวัดลำกะดาน ถนนนิมิตใหม่",19,217,307,321,628
6180,"สามวาตะวันออก","เขตคลองสามวา",104602,"โรงเรียนวัดลำกะดาน ถนนนิมิตใหม่",20,206,299,347,646
6181,"สามวาตะวันออก","เขตคลองสามวา",104602,"โรงเรียนสุเหร่าคลองสี่ ถนนไมตรีจิต",21,269,411,445,856
6182,"สามวาตะวันออก","เขตคลองสามวา",104602,"เต็นท์บริเวณมัสยิดดารุสสะอาดะห์ ถนนไมตรีจิต",22,249,343,368,711
6183,"สามวาตะวันออก","เขตคลองสามวา",104602,"เต็นท์บริเวณมัสยิดดารุสสะอาดะห์ ถนนไมตรีจิต",23,231,372,400,772
6184,"สามวาตะวันออก","เขตคลองสามวา",104602,"โรงเรียนวัดศรีสุก ถนนไมตรีจิต",24,301,364,351,715
6185,"สามวาตะวันออก","เขตคลองสามวา",104602,"โรงเรียนวัดศรีสุก ถนนไมตรีจิต",25,240,336,346,682
6186,"สามวาตะวันออก","เขตคลองสามวา",104602,"เต็นท์สนามกีฬาชุมชนเคหะมีนบุรีคลองเก้า ถนนคลองเก้า",26,199,263,289,552
6187,"สามวาตะวันออก","เขตคลองสามวา",104602,"เต็นท์สนามกีฬาชุมชนเคหะมีนบุรีคลองเก้า ถนนคลองเก้า",27,240,306,324,630
6188,"สามวาตะวันออก","เขตคลองสามวา",104602,"เต็นท์สนามกีฬาชุมชนเคหะมีนบุรีคลองเก้า ถนนคลองเก้า",28,204,252,304,556
6189,"สามวาตะวันออก","เขตคลองสามวา",104602,"เต็นท์สนามกีฬาชุมชนเคหะมีนบุรีคลองเก้า ถนนคลองเก้า",29,201,261,289,550
6190,"สามวาตะวันออก","เขตคลองสามวา",104602,"เต็นท์หมู่บ้านไพศาลปาร์ควิลล์ ถนนวัดสุขใจ",30,202,247,295,542
6191,"สามวาตะวันออก","เขตคลองสามวา",104602,"เต็นท์หมู่บ้านไพศาลปาร์ควิลล์ ถนนวัดสุขใจ",31,196,263,267,530
6192,"สามวาตะวันออก","เขตคลองสามวา",104602,"เต็นท์หน้าวัดเสนานนท์ ถนนลำมะเขือขื่น",32,205,425,445,870
6193,"บางชัน","เขตคลองสามวา",104603,"เต็นท์บริเวณโรงเรียนสอนขับรถแอดวานซ์หทัยราษฎร์",1,333,310,394,704
6194,"บางชัน","เขตคลองสามวา",104603,"เต็นท์บริเวณโรงเรียนสอนขับรถแอดวานซ์หทัยราษฎร์",2,381,326,450,776
6195,"บางชัน","เขตคลองสามวา",104603,"เต็นท์บริเวณโรงเรียนสอนขับรถแอดวานซ์หทัยราษฎร์",3,295,269,362,631
6196,"บางชัน","เขตคลองสามวา",104603,"เต็นท์บริเวณโรงเรียนสอนขับรถแอดวานซ์หทัยราษฎร์",4,334,341,425,766
6197,"บางชัน","เขตคลองสามวา",104603,"เต็นท์บริเวณโรงเรียนสอนขับรถแอดวานซ์หทัยราษฎร์",5,316,275,348,623
6198,"บางชัน","เขตคลองสามวา",104603,"เต็นท์บริเวณโรงเรียนสอนขับรถแอดวานซ์หทัยราษฎร์",6,242,285,350,635
6199,"บางชัน","เขตคลองสามวา",104603,"เต็นท์บริเวณโรงเรียนสอนขับรถแอดวานซ์หทัยราษฎร์",7,253,341,388,729
6200,"บางชัน","เขตคลองสามวา",104603,"เต็นท์บริเวณโรงเรียนสอนขับรถแอดวานซ์หทัยราษฎร์",8,279,361,400,761
6201,"บางชัน","เขตคลองสามวา",104603,"อาคารศูนย์ชุมชนโครงการเอื้ออาทรหทัยราษฎร์",9,409,315,455,770
6202,"บางชัน","เขตคลองสามวา",104603,"อาคารศูนย์ชุมชนโครงการเอื้ออาทรหทัยราษฎร์",10,386,318,414,732
6203,"บางชัน","เขตคลองสามวา",104603,"อาคารอเนกประสงค์หมู่บ้านร่มทิพย์ ซอยหทัยราษฎร์ 33",11,274,263,357,620
6204,"บางชัน","เขตคลองสามวา",104603,"อาคารอเนกประสงค์หมู่บ้านร่มทิพย์ ซอยหทัยราษฎร์ 33",12,254,294,355,649
6205,"บางชัน","เขตคลองสามวา",104603,"อาคารอเนกประสงค์หมู่บ้านร่มทิพย์ ซอยหทัยราษฎร์ 33",13,233,268,336,604
6206,"บางชัน","เขตคลองสามวา",104603,"อาคารอเนกประสงค์หมู่บ้านร่มทิพย์ ซอยหทัยราษฎร์ 33",14,226,274,312,586
6207,"บางชัน","เขตคลองสามวา",104603,"อาคารอเนกประสงค์วิทยาลัยอาชีวศึกษาเจริญพัฒนาบริหารธุรกิจ ถนนสามวา",15,345,296,402,698
6208,"บางชัน","เขตคลองสามวา",104603,"อาคารอเนกประสงค์วิทยาลัยอาชีวศึกษาเจริญพัฒนาบริหารธุรกิจถนนสามวา",16,321,303,379,682
6209,"บางชัน","เขตคลองสามวา",104603,"อาคารอเนกประสงค์วิทยาลัยอาชีวศึกษาเจริญพัฒนาบริหารธุรกิจ ถนนสามวา",17,262,290,381,671
6210,"บางชัน","เขตคลองสามวา",104603,"อาคารอเนกประสงค์วิทยาลัยอาชีวศึกษาเจริญพัฒนาบริหารธุรกิจถนนสามวา",18,238,319,365,684
6211,"บางชัน","เขตคลองสามวา",104603,"อาคารอเนกประสงค์วิทยาลัยอาชีวศึกษาเจริญพัฒนาบริหารธุรกิจถนนสามวา",19,274,282,350,632
6212,"บางชัน","เขตคลองสามวา",104603,"อาคารอเนกประสงค์วิทยาลัยอาชีวศึกษาเจริญพัฒนาบริหารธุรกิจถนนสามวา",20,286,391,432,823
6213,"บางชัน","เขตคลองสามวา",104603,"อาคารอเนกประสงค์วิทยาลัยอาชีวศึกษาเจริญพัฒนาบริหารธุรกิจถนนสามวา",21,296,325,388,713
6214,"บางชัน","เขตคลองสามวา",104603,"โรงเรียนบางชัน ถนนพระยาสุเรนทร์",22,273,266,361,627
6215,"บางชัน","เขตคลองสามวา",104603,"โรงเรียนบางชัน ถนนพระยาสุเรนทร์",23,227,307,383,690
6216,"บางชัน","เขตคลองสามวา",104603,"โรงเรียนบางชัน ถนนพระยาสุเรนทร์",24,294,385,481,866
6217,"บางชัน","เขตคลองสามวา",104603,"โรงเรียนบางชัน ถนนพระยาสุเรนทร์",25,282,335,391,726
6218,"บางชัน","เขตคลองสามวา",104603,"เต็นท์ตลาดนัดเศรษฐีทรงไชย ข้างซอยพระยาสุเรนทร์ 11",26,252,313,358,671
6219,"บางชัน","เขตคลองสามวา",104603,"เต็นท์ตลาดนัดเศรษฐีทรงไชย ข้างซอยพระยาสุเรนทร์ 11",27,235,288,343,631
6220,"บางชัน","เขตคลองสามวา",104603,"เต็นท์ตลาดนัดเศรษฐีทรงไชย ข้างซอยพระยาสุเรนทร์ 11",28,316,344,414,758
6221,"บางชัน","เขตคลองสามวา",104603,"อาคารอเนกประสงค์หมู่บ้านเฟื่องฟ้า ซอยพระยาสุเรนทร์ 12",29,147,192,238,430
6222,"บางชัน","เขตคลองสามวา",104603,"เต็นท์บริเวณตลาดใหม่พระยาสุเรนทร์ ถนนพระยาสุเรนทร์",30,147,273,296,569
6223,"บางชัน","เขตคลองสามวา",104603,"เต็นท์บริเวณตลาดใหม่พระยาสุเรนทร์ ถนนพระยาสุเรนทร์",31,135,243,284,527
6224,"บางชัน","เขตคลองสามวา",104603,"เต็นท์บริเวณตลาดใหม่พระยาสุเรนทร์ ถนนพระยาสุเรนทร์",32,208,255,310,565
6225,"บางชัน","เขตคลองสามวา",104603,"ที่ทำการชุมชนหมู่บ้านทหารกองหนุน ซอยพระยาสุเรนทร์ 28",33,298,380,474,854
6226,"บางชัน","เขตคลองสามวา",104603,"เต็นท์หน้าหมู่บ้านโครงการอินทราวิว ซอยพระยาสุเรนทร์ 19",34,367,375,400,775
6227,"บางชัน","เขตคลองสามวา",104603,"เต็นท์หน้าหมู่บ้านกาญจนทิพย์ 1 ซอยพระยาสุเรนทร์ 15",35,265,311,396,707
6228,"บางชัน","เขตคลองสามวา",104603,"เต็นท์บริเวณโรงเรียนสอนขับรถยนต์แสงอาทิตย์ ซอยพระยาสุเรนทร์ 30",36,323,310,348,658
6229,"บางชัน","เขตคลองสามวา",104603,"เต็นท์บริเวณโรงเรียนสอนขับรถยนต์แสงอาทิตย์ซอยพระยาสุเรนทร์ 30",37,425,350,466,816
6230,"บางชัน","เขตคลองสามวา",104603,"เต็นท์บริเวณโรงเรียนสอนขับรถยนต์แสงอาทิตย์ซอยพระยาสุเรนทร์ 30",38,288,343,413,756
6231,"บางชัน","เขตคลองสามวา",104603,"เต็นท์บริเวณโรงเรียนสอนขับรถยนต์แสงอาทิตย์ซอยพระยาสุเรนทร์ 30",39,292,390,411,801
6232,"บางชัน","เขตคลองสามวา",104603,"เต็นท์ข้างสโมสรหมู่บ้านมัณฑนา ซอยพระยาสุเรนทร์ 26",40,263,304,333,637
6233,"บางชัน","เขตคลองสามวา",104603,"เต็นท์ข้างสโมสรหมู่บ้านมัณฑนา ซอยพระยาสุเรนทร์ 26",41,254,273,331,604
6234,"บางชัน","เขตคลองสามวา",104603,"เต็นท์บริเวณเทสโก้ โลตัส รามอินทรา 109 ถนนพระยาสุเรนทร์",42,226,275,323,598
6235,"บางชัน","เขตคลองสามวา",104603,"เต็นท์บริเวณเทสโก้ โลตัส รามอินทรา 109 ถนนพระยาสุเรนทร์",43,194,369,403,772
6236,"บางชัน","เขตคลองสามวา",104603,"เต็นท์บริเวณเทสโก้ โลตัส รามอินทรา 109 ถนนพระยาสุเรนทร์",44,358,370,421,791
6237,"บางชัน","เขตคลองสามวา",104603,"เต็นท์บริเวณเทสโก้ โลตัส รามอินทรา 109 ถนนพระยาสุเรนทร์",45,298,321,388,709
6238,"บางชัน","เขตคลองสามวา",104603,"เต็นท์บริเวณเทสโก้ โลตัส รามอินทรา 109 ถนนพระยาสุเรนทร์",46,240,299,371,670
6239,"บางชัน","เขตคลองสามวา",104603,"โรงเรียนประชาราษฎร์อุปถัมภ์วิทยา ถนนพระยาสุเรนทร์",47,290,288,384,672
6240,"บางชัน","เขตคลองสามวา",104603,"โรงเรียนประชาราษฎร์อุปถัมภ์วิทยา ถนนพระยาสุเรนทร์",48,297,292,365,657
6241,"บางชัน","เขตคลองสามวา",104603,"โรงเรียนประชาราษฎร์อุปถัมภ์วิทยา ถนนพระยาสุเรนทร์",49,245,283,326,609
6242,"บางชัน","เขตคลองสามวา",104603,"โรงเรียนประชาราษฎร์อุปถัมภ์วิทยา ถนนพระยาสุเรนทร์",50,255,278,349,627
6243,"บางชัน","เขตคลองสามวา",104603,"โรงเรียนประชาราษฎร์อุปถัมภ์วิทยา ถนนพระยาสุเรนทร์",51,239,316,336,652
6244,"บางชัน","เขตคลองสามวา",104603,"โรงเรียนประชาราษฎร์อุปถัมภ์วิทยา ถนนพระยาสุเรนทร์",52,244,258,328,586
6245,"บางชัน","เขตคลองสามวา",104603,"อาคารศูนย์ชุมชนโครงการเอื้ออาทรปัญญาอินทรา",53,334,264,332,596
6246,"บางชัน","เขตคลองสามวา",104603,"อาคารศูนย์ชุมชนโครงการเอื้ออาทรปัญญาอินทรา",54,330,263,334,597
6247,"บางชัน","เขตคลองสามวา",104603,"เต็นท์บริเวณหน้าอาคารศูนย์ชุมชนโครงการเอื้ออาทรปัญญาอินทรา",55,358,303,355,658
6248,"บางชัน","เขตคลองสามวา",104603,"เต็นท์หน้าหมู่บ้านสราญสิริ 1 ถนนปัญญาอินทรา",56,273,254,331,585
6249,"บางชัน","เขตคลองสามวา",104603,"เต็นท์หน้าหมู่บ้านสราญสิริ 1 ถนนปัญญาอินทรา",57,294,299,366,665
6250,"บางชัน","เขตคลองสามวา",104603,"โรงเรียนโสมาภาพัฒนา (หอประชุมสมพงศ์) ซอยพระยาสุเรนทร์ 35",58,234,307,330,637
6251,"บางชัน","เขตคลองสามวา",104603,"โรงเรียนโสมาภาพัฒนา (หอประชุมสมพงศ์) ซอยพระยาสุเรนทร์ 35",59,274,247,320,567
6252,"บางชัน","เขตคลองสามวา",104603,"โรงเรียนโสมาภาพัฒนา (หอประชุมสมพงศ์) ซอยพระยาสุเรนทร์ 35",60,279,296,356,652
6253,"บางชัน","เขตคลองสามวา",104603,"โรงเรียนโสมาภาพัฒนา (หอประชุมสมพงศ์) ซอยพระยาสุเรนทร์ 35",61,228,218,299,517
6254,"บางชัน","เขตคลองสามวา",104603,"เต็นท์บริเวณวัดสัมมาชัญญาวาส ถนนพระยาสุเรนทร์",62,244,292,330,622
6255,"บางชัน","เขตคลองสามวา",104603,"เต็นท์บริเวณวัดสัมมาชัญญาวาส ถนนพระยาสุเรนทร์",63,208,239,287,526
6256,"บางชัน","เขตคลองสามวา",104603,"เต็นท์บริเวณวัดสัมมาชัญญาวาส ถนนพระยาสุเรนทร์",64,233,231,332,563
6257,"บางชัน","เขตคลองสามวา",104603,"เต็นท์บริเวณวัดสัมมาชัญญาวาส ถนนพระยาสุเรนทร์",65,270,229,328,557
6258,"บางชัน","เขตคลองสามวา",104603,"เต็นท์บริเวณวัดสัมมาชัญญาวาส ถนนพระยาสุเรนทร์",66,286,265,349,614
6259,"บางชัน","เขตคลองสามวา",104603,"เต็นท์บริเวณวัดสัมมาชัญญาวาส ถนนพระยาสุเรนทร์",67,301,232,328,560
6260,"บางชัน","เขตคลองสามวา",104603,"เต็นท์บริเวณวัดสัมมาชัญญาวาส ถนนพระยาสุเรนทร์",68,236,257,348,605
6261,"บางชัน","เขตคลองสามวา",104603,"เต็นท์บริเวณวัดสัมมาชัญญาวาส ถนนพระยาสุเรนทร์",69,252,261,325,586
6262,"บางชัน","เขตคลองสามวา",104603,"เต็นท์บริเวณวัดสัมมาชัญญาวาส ถนนพระยาสุเรนทร์",70,173,241,275,516
6263,"บางชัน","เขตคลองสามวา",104603,"เต็นท์บริเวณบิ๊กซี มาร์เก็ต หทัยราษฎร์ ถนนเลียบคลองสอง",71,355,346,441,787
6264,"บางชัน","เขตคลองสามวา",104603,"เต็นท์บริเวณบิ๊กซี มาร์เก็ต หทัยราษฎร์ ถนนเลียบคลองสอง",72,449,311,497,808
6265,"บางชัน","เขตคลองสามวา",104603,"เต็นท์บริเวณบิ๊กซี มาร์เก็ต หทัยราษฎร์ ถนนเลียบคลองสอง",73,416,342,486,828
6266,"บางชัน","เขตคลองสามวา",104603,"เต็นท์บริเวณบิ๊กซี มาร์เก็ต หทัยราษฎร์ ถนนเลียบคลองสอง",74,366,355,455,810
6267,"บางชัน","เขตคลองสามวา",104603,"เต็นท์บริเวณบิ๊กซี มาร์เก็ต หทัยราษฎร์ ถนนเลียบคลองสอง",75,273,328,361,689
6268,"บางชัน","เขตคลองสามวา",104603,"เต็นท์บริเวณบิ๊กซี มาร์เก็ต หทัยราษฎร์ ถนนเลียบคลองสอง",76,308,328,429,757
6269,"บางชัน","เขตคลองสามวา",104603,"เต็นท์บริเวณบิ๊กซี มาร์เก็ต หทัยราษฎร์ ถนนเลียบคลองสอง",77,251,277,342,619
6270,"บางชัน","เขตคลองสามวา",104603,"โรงเรียนวัดคู้บอน ถนนคู้บอน",78,311,270,346,616
6271,"บางชัน","เขตคลองสามวา",104603,"โรงเรียนวัดคู้บอน ถนนคู้บอน",79,217,253,331,584
6272,"บางชัน","เขตคลองสามวา",104603,"โรงเรียนวัดคู้บอน ถนนคู้บอน",80,223,310,348,658
6273,"บางชัน","เขตคลองสามวา",104603,"โรงเรียนวัดคู้บอน ถนนคู้บอน",81,322,354,420,774
6274,"บางชัน","เขตคลองสามวา",104603,"โรงเรียนวัดคู้บอน ถนนคู้บอน",82,233,312,369,681
6275,"บางชัน","เขตคลองสามวา",104603,"โรงเรียนวัดคู้บอน ถนนคู้บอน",83,354,323,408,731
6276,"บางชัน","เขตคลองสามวา",104603,"เต็นท์บริเวณหมู่บ้านชัยพฤกษ์ รามอินทราวงแหวน 2 ถนนคู้บอน",84,250,212,272,484
6277,"บางชัน","เขตคลองสามวา",104603,"เต็นท์บริเวณหมู่บ้านชัยพฤกษ์ รามอินทราวงแหวน 2 ถนนคู้บอน",85,203,182,231,413
6278,"บางชัน","เขตคลองสามวา",104603,"อาคารอเนกประสงค์โรงเรียนสุเหร่าคลองหนึ่ง ถนนสุเหร่าคลองหนึ่ง",86,306,360,432,792
6279,"บางชัน","เขตคลองสามวา",104603,"อาคารอเนกประสงค์โรงเรียนสุเหร่าคลองหนึ่ง ถนนสุเหร่าคลองหนึ่ง",87,245,318,365,683
6280,"บางชัน","เขตคลองสามวา",104603,"อาคารอเนกประสงค์โรงเรียนสุเหร่าคลองหนึ่ง ถนนสุเหร่าคลองหนึ่ง",88,273,319,349,668
6281,"บางชัน","เขตคลองสามวา",104603,"อาคารอเนกประสงค์โรงเรียนสุเหร่าคลองหนึ่ง ถนนสุเหร่าคลองหนึ่ง",89,160,262,300,562
6282,"บางชัน","เขตคลองสามวา",104603,"อาคารอเนกประสงค์โรงเรียนสุเหร่าคลองหนึ่ง ถนนสุเหร่าคลองหนึ่ง",90,290,277,334,611
6283,"บางชัน","เขตคลองสามวา",104603,"อาคารอเนกประสงค์โรงเรียนสุเหร่าคลองหนึ่ง ถนนสุเหร่าคลองหนึ่ง",91,374,292,372,664
6284,"บางชัน","เขตคลองสามวา",104603,"ห้องประชุมโรงเรียนสุเหร่าคลองหนึ่ง ถนนสุเหร่าคลองหนึ่ง",92,340,289,340,629
6285,"บางชัน","เขตคลองสามวา",104603,"โรงอาหารโรงเรียนสุเหร่าคลองหนึ่ง ถนนสุเหร่าคลองหนึ่ง",93,281,375,392,767
6286,"บางชัน","เขตคลองสามวา",104603,"โรงอาหารโรงเรียนสุเหร่าคลองหนึ่ง ถนนสุเหร่าคลองหนึ่ง",94,176,319,332,651
6287,"บางชัน","เขตคลองสามวา",104603,"เต็นท์หน้าสวนสาธารณะหมู่บ้านพฤกษาวิลล์ 55/1 ซอยสุเหร่าคลองหนึ่ง 13",95,295,260,318,578
6288,"บางชัน","เขตคลองสามวา",104603,"เต็นท์หน้าสวนสาธารณะหมู่บ้านพฤกษาวิลล์ 55/1ซอยสุเหร่าคลองหนึ่ง 13",96,339,327,386,713
6289,"บางชัน","เขตคลองสามวา",104603,"เต็นท์หน้าหมู่บ้านประภาทรัพย์ 5 ถนนเจริญพัฒนา",97,354,356,442,798
6290,"บางชัน","เขตคลองสามวา",104603,"เต็นท์หน้าหมู่บ้านประภาทรัพย์ 5 ถนนเจริญพัฒนา",98,268,310,356,666
6291,"บางชัน","เขตคลองสามวา",104603,"อาคารศูนย์ชุมชนโครงการเอื้ออาทร ถนนเจริญพัฒนา",99,321,290,338,628
6292,"บางชัน","เขตคลองสามวา",104603,"อาคารศูนย์ชุมชนโครงการเอื้ออาทร ถนนเจริญพัฒนา",100,327,317,328,645
6293,"บางชัน","เขตคลองสามวา",104603,"เต็นท์บริเวณหน้าอาคารศูนย์ชุมชนโครงการเอื้ออาทร ถนนเจริญพัฒนา",101,342,287,376,663
6294,"บางชัน","เขตคลองสามวา",104603,"เต็นท์บริเวณหน้าอาคารศูนย์ชุมชนโครงการเอื้ออาทรถนนเจริญพัฒนา",102,272,303,349,652
6295,"บางชัน","เขตคลองสามวา",104603,"เต็นท์บริเวณหน้าอาคารศูนย์ชุมชนโครงการเอื้ออาทรถนนเจริญพัฒนา",103,226,305,392,697
6296,"บางชัน","เขตคลองสามวา",104603,"เต็นท์บริเวณหน้าอาคารศูนย์ชุมชนโครงการเอื้ออาทร ถนนเจริญพัฒนา",104,203,308,346,654
6297,"ทรายกองดิน","เขตคลองสามวา",104604,"เต็นท์หมู่บ้านพนาสนธิ์ 6 ซอยนิมิตใหม่ 7",1,200,266,272,538
6298,"ทรายกองดิน","เขตคลองสามวา",104604,"เต็นท์หมู่บ้านพนาสนธิ์ 7 ซอยนิมิตใหม่ 9",2,307,348,407,755
6299,"ทรายกองดิน","เขตคลองสามวา",104604,"เต็นท์หมู่บ้านพนาสนธิ์ 7 ซอยนิมิตใหม่ 9",3,310,341,394,735
6300,"ทรายกองดิน","เขตคลองสามวา",104604,"โรงเรียนวัดบัวแก้ว ถนนนิมิตใหม่",4,260,265,297,562
6301,"ทรายกองดิน","เขตคลองสามวา",104604,"โรงเรียนวัดบัวแก้ว ถนนนิมิตใหม่",5,293,301,347,648
6302,"ทรายกองดิน","เขตคลองสามวา",104604,"โรงเรียนวัดบัวแก้ว ถนนนิมิตใหม่",6,249,296,344,640
6303,"ทรายกองดิน","เขตคลองสามวา",104604,"โรงเรียนวัดบัวแก้ว ถนนนิมิตใหม่",7,278,268,329,597
6304,"ทรายกองดิน","เขตคลองสามวา",104604,"โรงเรียนวัดบัวแก้ว ถนนนิมิตใหม่",8,279,291,333,624
6305,"ทรายกองดิน","เขตคลองสามวา",104604,"โรงเรียนวัดบัวแก้ว ถนนนิมิตใหม่",9,210,292,316,608
6306,"ทรายกองดิน","เขตคลองสามวา",104604,"เต็นท์บริเวณวัดจินดิตวิหาร ถนนนิมิตใหม่",10,139,198,255,453
6307,"ทรายกองดิน","เขตคลองสามวา",104604,"เต็นท์บริเวณวัดจินดิตวิหาร ถนนนิมิตใหม่",11,249,290,331,621
6308,"ทรายกองดิน","เขตคลองสามวา",104604,"โรงเรียนสอนศาสนาอิสลามศาสนวิทยา ซอยประชาร่วมใจ 13",12,82,189,192,381
6309,"ทรายกองดิน","เขตคลองสามวา",104604,"เต็นท์สนามฟุตบอล หมู่บ้านคาซาลีน่า 2 ซอยนิมิตใหม่ 20",13,291,355,408,763
6310,"ทรายกองดิน","เขตคลองสามวา",104604,"เต็นท์ลานกิจกรรมชมรมบึงบัวแดง หมู่บ้านคาซาลีน่า 2 ซอยนิมิตใหม่ 20",14,258,327,398,725
6311,"ทรายกองดิน","เขตคลองสามวา",104604,"เต็นท์ปากซอยบุญมา ถนนวัดสุขใจ",15,171,251,269,520
6312,"ทรายกองดิน","เขตคลองสามวา",104604,"เต็นท์ปากซอยบุญมา ถนนวัดสุขใจ",16,180,282,327,609
6313,"ทรายกองดิน","เขตคลองสามวา",104604,"เต็นท์ปากซอยบุญมา ถนนวัดสุขใจ",17,174,270,286,556
6314,"ทรายกองดินใต้","เขตคลองสามวา",104605,"โรงเรียนสุเหร่าแสนแสบ ถนนประชาร่วมใจ",1,187,259,264,523
6315,"ทรายกองดินใต้","เขตคลองสามวา",104605,"โรงเรียนสุเหร่าแสนแสบ ถนนประชาร่วมใจ",2,144,241,272,513
6316,"ทรายกองดินใต้","เขตคลองสามวา",104605,"โรงเรียนสุเหร่าแสนแสบ ถนนประชาร่วมใจ",3,163,340,382,722
6317,"ทรายกองดินใต้","เขตคลองสามวา",104605,"เต็นท์โรงเรียนสอนศาสนาสันนิธิอิสลาม ซอยประชาร่วมใจ 14",4,203,382,428,810
6318,"ทรายกองดินใต้","เขตคลองสามวา",104605,"เต็นท์โรงเรียนสอนศาสนาสันนิธิอิสลาม ซอยประชาร่วมใจ 14",5,274,385,428,813
6319,"ทรายกองดินใต้","เขตคลองสามวา",104605,"เต็นท์โรงเรียนสอนศาสนาสันนิธิอิสลาม ซอยประชาร่วมใจ 14",6,172,340,364,704
6320,"ทรายกองดินใต้","เขตคลองสามวา",104605,"เต็นท์บริเวณศูนย์พัฒนาเด็กก่อนวัยเรียนชุมชนกมาลุลอิสลาม ซอยประชาร่วมใจ 48",7,225,330,368,698
6321,"ทรายกองดินใต้","เขตคลองสามวา",104605,"เต็นท์บริเวณศูนย์พัฒนาเด็กก่อนวัยเรียนชุมชนกมาลุลอิสลามซอยประชาร่วมใจ 48",8,260,363,383,746
6322,"ทรายกองดินใต้","เขตคลองสามวา",104605,"เต็นท์บริเวณศูนย์พัฒนาเด็กก่อนวัยเรียนชุมชนกมาลุลอิสลาม ซอยประชาร่วมใจ 48",9,220,320,382,702
6323,"ทรายกองดินใต้","เขตคลองสามวา",104605,"เต็นท์บริเวณศูนย์พัฒนาเด็กก่อนวัยเรียนชุมชนกมาลุลอิสลามซอยประชาร่วมใจ 48",10,305,322,361,683
6324,"ทรายกองดินใต้","เขตคลองสามวา",104605,"เต็นท์บริเวณศูนย์พัฒนาเด็กก่อนวัยเรียนชุมชนกมาลุลอิสลามซอยประชาร่วมใจ 48",11,289,336,376,712
6325,"ทรายกองดินใต้","เขตคลองสามวา",104605,"โรงเรียนสุเหร่าเกาะขุนเณร ซอยประชาร่วมใจ 63",12,224,361,394,755
6326,"ทรายกองดินใต้","เขตคลองสามวา",104605,"โรงเรียนสุเหร่าเกาะขุนเณร ซอยประชาร่วมใจ 63",13,211,360,402,762
6327,"ทรายกองดินใต้","เขตคลองสามวา",104605,"เต็นท์ตลาดนัดเกาะขุนเณร ตรงข้ามปากทางเข้าโรงเรียนบ้านแบนชะโด",14,190,335,353,688
6328,"ทรายกองดินใต้","เขตคลองสามวา",104605,"เต็นท์ตลาดนัดเกาะขุนเณร ตรงข้ามปากทางเข้าโรงเรียนบ้านแบนชะโด",15,213,289,330,619
6329,"ทรายกองดินใต้","เขตคลองสามวา",104605,"เต็นท์ตลาดนัดเกาะขุนเณร ตรงข้ามปากทางเข้าโรงเรียนบ้านแบนชะโด",16,145,282,293,575
6330,"ทรายกองดินใต้","เขตคลองสามวา",104605,"เต็นท์ตลาดนัดเกาะขุนเณร ตรงข้ามปากทางเข้าโรงเรียนบ้านแบนชะโด",17,162,285,293,578
6331,"ทรายกองดินใต้","เขตคลองสามวา",104605,"โรงเรียนบ้านแบนชะโด ซอยแบนชะโด 2",18,202,371,379,750
6332,"ทรายกองดินใต้","เขตคลองสามวา",104605,"โรงเรียนวัดสุขใจ ถนนวัดสุขใจ",19,204,334,344,678
6333,"บางนาเหนือ","เขตบางนา",104701,"สนามกีฬาอเนกประสงค์โรงเรียนอรรถวิทย์",1,545,295,443,738
6334,"บางนาเหนือ","เขตบางนา",104701,"สนามกีฬาอเนกประสงค์โรงเรียนอรรถวิทย์",2,314,307,322,629
6335,"บางนาเหนือ","เขตบางนา",104701,"สนามกีฬาอเนกประสงค์โรงเรียนอรรถวิทย์",3,265,323,387,710
6336,"บางนาเหนือ","เขตบางนา",104701,"สนามกีฬาอเนกประสงค์โรงเรียนอรรถวิทย์",4,210,257,281,538
6337,"บางนาเหนือ","เขตบางนา",104701,"สนามกีฬาอเนกประสงค์โรงเรียนอรรถวิทย์",5,277,292,322,614
6338,"บางนาเหนือ","เขตบางนา",104701,"สนามกีฬาอเนกประสงค์โรงเรียนอรรถวิทย์",6,182,218,283,501
6339,"บางนาเหนือ","เขตบางนา",104701,"สนามกีฬาอเนกประสงค์โรงเรียนอรรถวิทย์",7,178,210,266,476
6340,"บางนาเหนือ","เขตบางนา",104701,"สนามกีฬาอเนกประสงค์โรงเรียนอรรถวิทย์",8,142,184,212,396
6341,"บางนาเหนือ","เขตบางนา",104701,"สนามกีฬาอเนกประสงค์โรงเรียนอรรถวิทย์",9,367,272,346,618
6342,"บางนาเหนือ","เขตบางนา",104701,"เต็นท์ในบริเวณโรงเรียนสิริรัตนาธร",10,352,235,357,592
6343,"บางนาเหนือ","เขตบางนา",104701,"เต็นท์ในบริเวณโรงเรียนสิริรัตนาธร",11,250,224,288,512
6344,"บางนาเหนือ","เขตบางนา",104701,"เต็นท์ในบริเวณโรงเรียนสิริรัตนาธร",12,183,214,275,489
6345,"บางนาเหนือ","เขตบางนา",104701,"เต็นท์ในบริเวณโรงเรียนสิริรัตนาธร",13,125,196,251,447
6346,"บางนาเหนือ","เขตบางนา",104701,"เต็นท์ในบริเวณโรงเรียนสิริรัตนาธร",14,148,205,287,492
6347,"บางนาเหนือ","เขตบางนา",104701,"เต็นท์ในบริเวณโรงเรียนสิริรัตนาธร",15,142,216,282,498
6348,"บางนาเหนือ","เขตบางนา",104701,"เต็นท์ในบริเวณโรงเรียนสิริรัตนาธร",16,185,233,290,523
6349,"บางนาเหนือ","เขตบางนา",104701,"เต็นท์ในบริเวณโรงเรียนสิริรัตนาธร",17,172,276,363,639
6350,"บางนาเหนือ","เขตบางนา",104701,"เต็นท์ในบริเวณโรงเรียนสิริรัตนาธร",18,212,289,357,646
6351,"บางนาเหนือ","เขตบางนา",104701,"เต็นท์ในบริเวณโรงเรียนสิริรัตนาธร",19,186,277,302,579
6352,"บางนาเหนือ","เขตบางนา",104701,"เต็นท์ในบริเวณโรงเรียนสิริรัตนาธร",20,410,311,466,777
6353,"บางนาเหนือ","เขตบางนา",104701,"เต็นท์ในบริเวณโรงเรียนสิริรัตนาธร",21,412,345,442,787
6354,"บางนาเหนือ","เขตบางนา",104701,"เต็นท์ในบริเวณโรงเรียนสิริรัตนาธร",22,250,336,371,707
6355,"บางนาเหนือ","เขตบางนา",104701,"เต็นท์ในบริเวณโรงเรียนสิริรัตนาธร",23,284,337,433,770
6356,"บางนาเหนือ","เขตบางนา",104701,"เต็นท์ในบริเวณโรงเรียนสิริรัตนาธร",24,153,201,266,467
6357,"บางนาเหนือ","เขตบางนา",104701,"โรงเรียนอำนวยกนกศิริอนุสรณ์",25,168,239,230,469
6358,"บางนาเหนือ","เขตบางนา",104701,"โรงเรียนอำนวยกนกศิริอนุสรณ์",26,124,266,294,560
6359,"บางนาเหนือ","เขตบางนา",104701,"โรงเรียนอำนวยกนกศิริอนุสรณ์",27,201,210,303,513
6360,"บางนาเหนือ","เขตบางนา",104701,"โรงเรียนอำนวยกนกศิริอนุสรณ์",28,140,230,280,510
6361,"บางนาเหนือ","เขตบางนา",104701,"โรงเรียนอำนวยกนกศิริอนุสรณ์",29,158,227,271,498
6362,"บางนาเหนือ","เขตบางนา",104701,"โรงเรียนอำนวยกนกศิริอนุสรณ์",30,175,318,347,665
6363,"บางนาเหนือ","เขตบางนา",104701,"โรงเรียนอำนวยกนกศิริอนุสรณ์",31,161,300,340,640
6364,"บางนาเหนือ","เขตบางนา",104701,"โรงเรียนอำนวยกนกศิริอนุสรณ์",32,118,202,224,426
6365,"บางนาเหนือ","เขตบางนา",104701,"โรงเรียนศรีเอี่ยมอนุสรณ์",33,505,324,468,792
6366,"บางนาเหนือ","เขตบางนา",104701,"โรงเรียนศรีเอี่ยมอนุสรณ์",34,278,304,370,674
6367,"บางนาเหนือ","เขตบางนา",104701,"โรงเรียนศรีเอี่ยมอนุสรณ์",35,245,275,312,587
6368,"บางนาเหนือ","เขตบางนา",104701,"โรงเรียนศรีเอี่ยมอนุสรณ์",36,255,271,358,629
6369,"บางนาเหนือ","เขตบางนา",104701,"โรงเรียนศรีเอี่ยมอนุสรณ์",37,235,250,307,557
6370,"บางนาเหนือ","เขตบางนา",104701,"อาคารเดอะพาร์คแลนด์เซ็นเตอร์",38,347,199,358,557
6371,"บางนาเหนือ","เขตบางนา",104701,"อาคารเดอะพาร์คแลนด์เซ็นเตอร์",39,414,208,381,589
6372,"บางนาเหนือ","เขตบางนา",104701,"โรงเรียนรุ่งเรืองอุปถัมภ์",40,328,304,370,674
6373,"บางนาเหนือ","เขตบางนา",104701,"โรงเรียนรุ่งเรืองอุปถัมภ์",41,173,219,269,488
6374,"บางนาเหนือ","เขตบางนา",104701,"โรงเรียนรุ่งเรืองอุปถัมภ์",42,153,254,279,533
6375,"บางนาเหนือ","เขตบางนา",104701,"โรงเรียนรุ่งเรืองอุปถัมภ์",43,426,248,413,661
6376,"บางนาเหนือ","เขตบางนา",104701,"โรงเรียนรุ่งเรืองอุปถัมภ์",44,236,192,272,464
6377,"บางนาเหนือ","เขตบางนา",104701,"โรงเรียนรุ่งเรืองอุปถัมภ์",45,252,221,296,517
6378,"บางนาเหนือ","เขตบางนา",104701,"โรงเรียนรุ่งเรืองอุปถัมภ์",46,168,214,306,520
6379,"บางนาเหนือ","เขตบางนา",104701,"โรงเรียนรุ่งเรืองอุปถัมภ์",47,451,231,379,610
6380,"บางนาเหนือ","เขตบางนา",104701,"เต็นท์บริเวณหมู่บ้านมณียาวิลล์",48,443,263,421,684
6381,"บางนาเหนือ","เขตบางนา",104701,"เต็นท์บริเวณหมู่บ้านมณียาวิลล์",49,347,299,430,729
6382,"บางนาเหนือ","เขตบางนา",104701,"เต็นท์บริเวณหมู่บ้านมณียาวิลล์",50,288,288,378,666
6383,"บางนาเหนือ","เขตบางนา",104701,"เต็นท์บริเวณหมู่บ้านมณียาวิลล์",51,225,222,342,564
6384,"บางนาเหนือ","เขตบางนา",104701,"เต็นท์บริเวณหมู่บ้านมณียาวิลล์",52,203,222,273,495
6385,"บางนาเหนือ","เขตบางนา",104701,"เต็นท์หน้าตลาดมหาสิน",53,161,221,268,489
6386,"บางนาเหนือ","เขตบางนา",104701,"เต็นท์หน้าตลาดมหาสิน",54,153,236,261,497
6387,"บางนาเหนือ","เขตบางนา",104701,"เต็นท์หน้าตลาดมหาสิน",55,163,253,262,515
6388,"บางนาเหนือ","เขตบางนา",104701,"เต็นท์หน้าตลาดมหาสิน",56,182,254,285,539
6389,"บางนาใต้","เขตบางนา",104703,"ชั้นล่างอาคาร 19 อาคารชุดทหารเรือ",1,273,336,190,526
6390,"บางนาใต้","เขตบางนา",104703,"ชั้นล่างอาคาร 19 อาคารชุดทหารเรือ",2,282,342,220,562
6391,"บางนาใต้","เขตบางนา",104703,"ชั้นล่างอาคาร 19 อาคารชุดทหารเรือ",3,340,391,218,609
6392,"บางนาใต้","เขตบางนา",104703,"ชั้นล่างอาคาร 16 อาคารชุดทหารเรือ",4,221,265,188,453
6393,"บางนาใต้","เขตบางนา",104703,"ชั้นล่างอาคาร 16 อาคารชุดทหารเรือ",5,308,359,260,619
6394,"บางนาใต้","เขตบางนา",104703,"ชั้นล่างอาคาร 16 อาคารชุดทหารเรือ",6,289,402,246,648
6395,"บางนาใต้","เขตบางนา",104703,"ศูนย์เยาวชนบางนา",7,198,263,130,393
6396,"บางนาใต้","เขตบางนา",104703,"โรงเรียนวัดบางนานอก",8,174,236,274,510
6397,"บางนาใต้","เขตบางนา",104703,"โรงเรียนวัดบางนานอก",9,167,255,306,561
6398,"บางนาใต้","เขตบางนา",104703,"หอประชุมกรมอุตุนิยมวิทยา",10,386,267,310,577
6399,"บางนาใต้","เขตบางนา",104703,"โรงเรียนวัดบางนาใน",11,291,305,301,606
6400,"บางนาใต้","เขตบางนา",104703,"โรงเรียนวัดบางนาใน",12,211,286,337,623
6401,"บางนาใต้","เขตบางนา",104703,"โรงเรียนวัดบางนาใน",13,609,336,389,725
6402,"บางนาใต้","เขตบางนา",104703,"โรงเรียนวัดบางนาใน",14,347,320,414,734
6403,"บางนาใต้","เขตบางนา",104703,"โรงเรียนวัดบางนาใน",15,223,268,283,551
6404,"บางนาใต้","เขตบางนา",104703,"โรงเรียนวัดบางนาใน",16,190,267,305,572
6405,"บางนาใต้","เขตบางนา",104703,"ชั้นล่างใต้อาคาร 2 โรงเรียนรุ่งเรืองวิทยา",17,105,220,189,409
6406,"บางนาใต้","เขตบางนา",104703,"โรงเรียนเพี้ยนพินอนุสรณ์",18,178,238,309,547
6407,"บางนาใต้","เขตบางนา",104703,"โรงเรียนเพี้ยนพินอนุสรณ์",19,205,272,331,603
6408,"บางนาใต้","เขตบางนา",104703,"โรงเรียนเพี้ยนพินอนุสรณ์",20,152,250,339,589
6409,"บางนาใต้","เขตบางนา",104703,"โรงเรียนเพี้ยนพินอนุสรณ์",21,119,249,242,491
6410,"บางนาใต้","เขตบางนา",104703,"โรงเรียนเพี้ยนพินอนุสรณ์",22,157,236,292,528
6411,"บางนาใต้","เขตบางนา",104703,"โรงเรียนเพี้ยนพินอนุสรณ์",23,156,305,301,606
6412,"บางนาใต้","เขตบางนา",104703,"โรงเรียนเพี้ยนพินอนุสรณ์",24,225,263,330,593
6413,"บางนาใต้","เขตบางนา",104703,"เต็นท์หน้าสโมสรหมู่บ้านนภาลัย",25,240,289,394,683
6414,"บางนาใต้","เขตบางนา",104703,"เต็นท์หน้าสโมสรหมู่บ้านนภาลัย",26,221,254,350,604
6415,"บางนาใต้","เขตบางนา",104703,"โรงอาหารโรงเรียนประภามนตรี",27,438,336,425,761
6416,"บางนาใต้","เขตบางนา",104703,"โรงอาหารโรงเรียนประภามนตรี",28,267,261,354,615
6417,"บางนาใต้","เขตบางนา",104703,"โรงอาหารโรงเรียนประภามนตรี",29,223,239,350,589
6418,"บางนาใต้","เขตบางนา",104703,"โรงอาหารโรงเรียนประภามนตรี",30,216,304,335,639
6419,"บางนาใต้","เขตบางนา",104703,"โรงอาหารโรงเรียนประภามนตรี",31,365,268,379,647
6420,"บางนาใต้","เขตบางนา",104703,"โรงอาหารโรงเรียนประภามนตรี",32,233,260,344,604
6421,"บางนาใต้","เขตบางนา",104703,"โรงเรียนผ่องพลอยอนุสรณ์",33,520,276,422,698
6422,"บางนาใต้","เขตบางนา",104703,"โรงเรียนผ่องพลอยอนุสรณ์",34,452,273,363,636
6423,"บางนาใต้","เขตบางนา",104703,"โรงเรียนผ่องพลอยอนุสรณ์",35,201,226,286,512
6424,"บางนาใต้","เขตบางนา",104703,"โรงเรียนผ่องพลอยอนุสรณ์",36,485,233,388,621
6425,"บางนาใต้","เขตบางนา",104703,"โรงเรียนผ่องพลอยอนุสรณ์",37,317,288,358,646
6426,"บางนาใต้","เขตบางนา",104703,"โรงเรียนผ่องพลอยอนุสรณ์",38,418,278,420,698
6427,"บางนาใต้","เขตบางนา",104703,"โรงเรียนผ่องพลอยอนุสรณ์",39,290,287,372,659
6428,"บางนาใต้","เขตบางนา",104703,"โรงเรียนผ่องพลอยอนุสรณ์",40,144,242,284,526
6429,"บางนาใต้","เขตบางนา",104703,"โรงเรียนผ่องพลอยอนุสรณ์",41,351,217,353,570
6430,"บางนาใต้","เขตบางนา",104703,"โรงเรียนผ่องพลอยอนุสรณ์",42,272,248,352,600
6431,"บางนาใต้","เขตบางนา",104703,"โรงเรียนผ่องพลอยอนุสรณ์",43,198,255,296,551
6432,"บางนาใต้","เขตบางนา",104703,"โรงเรียนผ่องพลอยอนุสรณ์",44,253,235,325,560
6433,"บางนาใต้","เขตบางนา",104703,"โรงเรียนผ่องพลอยอนุสรณ์",45,195,256,272,528
6434,"บางนาใต้","เขตบางนา",104703,"เต็นท์บริเวณหน้าสโมสรหมู่บ้านแฮปปี้แลนด์",46,206,251,329,580
6435,"บางนาใต้","เขตบางนา",104703,"เต็นท์บริเวณหน้าสโมสรหมู่บ้านแฮปปี้แลนด์",47,197,256,281,537
6436,"บางนาใต้","เขตบางนา",104703,"เต็นท์บริเวณหน้าสโมสรหมู่บ้านแฮปปี้แลนด์",48,159,225,271,496
6437,"บางนาใต้","เขตบางนา",104703,"เต็นท์บริเวณหน้าสโมสรหมู่บ้านแฮปปี้แลนด์",49,136,249,292,541
6438,"บางนาใต้","เขตบางนา",104703,"เต็นท์บริเวณที่จอดรถโรงเรียนบางกอกพัฒนา",50,381,236,365,601
6439,"บางนาใต้","เขตบางนา",104703,"เต็นท์บริเวณที่จอดรถโรงเรียนบางกอกพัฒนา",51,486,344,461,805
6440,"บางนาใต้","เขตบางนา",104703,"เต็นท์บริเวณที่จอดรถโรงเรียนบางกอกพัฒนา",52,238,248,327,575
6441,"บางนาใต้","เขตบางนา",104703,"เต็นท์บริเวณที่จอดรถโรงเรียนบางกอกพัฒนา",53,180,275,341,616
6442,"บางนาใต้","เขตบางนา",104703,"เต็นท์บริเวณที่จอดรถโรงเรียนบางกอกพัฒนา",54,384,222,370,592
6443,"บางนาใต้","เขตบางนา",104703,"เต็นท์บริเวณที่จอดรถโรงเรียนบางกอกพัฒนา",55,178,228,262,490
6444,"บางนาใต้","เขตบางนา",104703,"เต็นท์บริเวณที่จอดรถโรงเรียนบางกอกพัฒนา",56,162,194,239,433
6445,"บางนาใต้","เขตบางนา",104703,"ชั้นล่างใต้อาคารการเคหะแห่งชาติหลังที่ 4",57,220,217,282,499
6446,"บางนาใต้","เขตบางนา",104703,"ชั้นล่างใต้อาคารการเคหะแห่งชาติหลังที่ 4",58,207,189,270,459
6447,"บางนาใต้","เขตบางนา",104703,"ชั้นล่างใต้อาคารการเคหะแห่งชาติหลังที่ 6",59,226,207,301,508
6448,"บางนาใต้","เขตบางนา",104703,"ชั้นล่างใต้อาคารการเคหะแห่งชาติหลังที่ 6",60,234,198,310,508
6449,"บางนาใต้","เขตบางนา",104703,"ชั้นล่างใต้อาคารการเคหะแห่งชาติหลังที่ 6",61,270,271,306,577
6450,"บางนาใต้","เขตบางนา",104703,"โรงเรียนลาซาล",62,309,291,363,654
6451,"บางนาใต้","เขตบางนา",104703,"โรงเรียนลาซาล",63,183,210,251,461
6452,"บางนาใต้","เขตบางนา",104703,"โรงเรียนลาซาล",64,166,228,309,537
6453,"บางนาใต้","เขตบางนา",104703,"โรงเรียนลาซาล",65,148,264,298,562
6454,"บางนาใต้","เขตบางนา",104703,"โรงเรียนลาซาล",66,168,249,312,561
6455,"บางนาใต้","เขตบางนา",104703,"โรงเรียนลาซาล",67,155,273,284,557
6456,"ทวีวัฒนา","เขตทวีวัฒนา",104801,"โรงเรียนคลองทวีวัฒนา",1,134,223,268,491
6457,"ทวีวัฒนา","เขตทวีวัฒนา",104801,"โรงเรียนคลองทวีวัฒนา",2,197,237,284,521
6458,"ทวีวัฒนา","เขตทวีวัฒนา",104801,"โรงเรียนคลองทวีวัฒนา",3,193,237,294,531
6459,"ทวีวัฒนา","เขตทวีวัฒนา",104801,"โรงเรียนคลองทวีวัฒนา",4,162,246,274,520
6460,"ทวีวัฒนา","เขตทวีวัฒนา",104801,"โรงเรียนคลองทวีวัฒนา",5,204,243,329,572
6461,"ทวีวัฒนา","เขตทวีวัฒนา",104801,"โรงเรียนคลองทวีวัฒนา",6,221,301,361,662
6462,"ทวีวัฒนา","เขตทวีวัฒนา",104801,"โรงเรียนคลองทวีวัฒนา",7,227,278,304,582
6463,"ทวีวัฒนา","เขตทวีวัฒนา",104801,"โรงเรียนทีปังกรวิทยาพัฒน์ (ทวีวัฒนา) ในพระบรมราชูปถัมภ์ฯ",8,150,243,255,498
6464,"ทวีวัฒนา","เขตทวีวัฒนา",104801,"โรงเรียนทีปังกรวิทยาพัฒน์ (ทวีวัฒนา) ในพระบรมราชูปถัมภ์ฯ",9,145,243,283,526
6465,"ทวีวัฒนา","เขตทวีวัฒนา",104801,"เต็นท์ข้างที่ทำการชุมชนสินพัฒนาธานี ซอยทวีวัมนา 9 (อำนวยโชค)",10,183,274,315,589
6466,"ทวีวัฒนา","เขตทวีวัฒนา",104801,"เต็นท์ข้างที่ทำการชุมชนสินพัฒนาธานี ซอยทวีวัมนา 9 (อำนวยโชค)",11,235,263,316,579
6467,"ทวีวัฒนา","เขตทวีวัฒนา",104801,"เต็นท์ข้างที่ทำการชุมชนสินพัฒนาธานี ซอยทวีวัมนา 9 (อำนวยโชค)",12,250,317,356,673
6468,"ทวีวัฒนา","เขตทวีวัฒนา",104801,"เต็นท์ข้างที่ทำการชุมชนสินพัฒนาธานี ซอยทวีวัมนา 9 (อำนวยโชค)",13,349,307,407,714
6469,"ทวีวัฒนา","เขตทวีวัฒนา",104801,"อาคารบริเวณปากซอยทวีวัฒนา 19",14,201,282,344,626
6470,"ทวีวัฒนา","เขตทวีวัฒนา",104801,"อาคารบริเวณลานกีฬาหมู่บ้านพรทวี ซอยทวีวัฒนา 19/1",15,223,281,330,611
6471,"ทวีวัฒนา","เขตทวีวัฒนา",104801,"อาคารโรงเรียนเกษตรทฤษฎีใหม่ใกล้ซอยทวีวัฒนา 15/1",16,123,189,197,386
6472,"ทวีวัฒนา","เขตทวีวัฒนา",104801,"อาคารโรงเรียนเกษตรทฤษฎีใหม่ใกล้ซอยทวีวัฒนา 15/1",17,137,178,203,381
6473,"ทวีวัฒนา","เขตทวีวัฒนา",104801,"เต็นท์หน้าศูนย์บริการสาธารณสุข แจ่ม-ดำ ควรชม",18,132,160,198,358
6474,"ทวีวัฒนา","เขตทวีวัฒนา",104801,"เต็นท์หน้าศูนย์บริการสาธารณสุข แจ่ม-ดำ ควรชม",19,151,215,182,397
6475,"ทวีวัฒนา","เขตทวีวัฒนา",104801,"ชั้นล่างอาคารศูนย์สันสกฤต มหาวิทยาลัยศิลปากร ใกล้สี่แยกสุภาพบุรุษ",20,271,283,382,665
6476,"ทวีวัฒนา","เขตทวีวัฒนา",104801,"ชั้นล่างอาคารศูนย์สันสกฤต มหาวิทยาลัยศิลปากร ใกล้สี่แยกสุภาพบุรุษ",21,175,266,290,556
6477,"ทวีวัฒนา","เขตทวีวัฒนา",104801,"อาคารเอนกประสงค์ที่ทำการชุมชนหมู่บ้านร่วมเกื้อ",22,218,260,343,603
6478,"ทวีวัฒนา","เขตทวีวัฒนา",104801,"อาคารเอนกประสงค์ที่ทำการชุมชนหมู่บ้านร่วมเกื้อ",23,179,250,300,550
6479,"ทวีวัฒนา","เขตทวีวัฒนา",104801,"อาคารเอนกประสงค์ที่ทำการชุมชนหมู่บ้านร่วมเกื้อ",24,194,276,294,570
6480,"ทวีวัฒนา","เขตทวีวัฒนา",104801,"เต็นท์บริเวณหน้าอาคารเอนกประสงค์ที่ทำการชุมชนหมู่บ้านร่วมเกื้อ",25,181,222,274,496
6481,"ทวีวัฒนา","เขตทวีวัฒนา",104801,"เต็นท์บริเวณหน้าอาคารเอนกประสงค์ที่ทำการชุมชนหมู่บ้านร่วมเกื้อ",26,221,233,299,532
6482,"ทวีวัฒนา","เขตทวีวัฒนา",104801,"เต็นท์หน้าศูนย์บริการสาธารณสุข พล.ต.บุศษ์-ประดับ โกมุทซอยลัดนิ่มไสว",27,89,153,173,326
6483,"ทวีวัฒนา","เขตทวีวัฒนา",104801,"เต็นท์หน้าศูนย์บริการสาธารณสุข พล.ต.บุศษ์-ประดับ โกมุทซอยลัดนิ่มไสว",28,180,269,279,548
6484,"ทวีวัฒนา","เขตทวีวัฒนา",104801,"อาคารเอนกประสงค์ศูนย์สุขภาพพาณิชยการราชดำเนินถนนทวีวัฒนา-กาญจนาภิเษก",29,155,249,268,517
6485,"ทวีวัฒนา","เขตทวีวัฒนา",104801,"อาคารเอนกประสงค์ศูนย์สุขภาพพาณิชยการราชดำเนินถนนทวีวัฒนา-กาญจนาภิเษก",30,192,245,315,560
6486,"ทวีวัฒนา","เขตทวีวัฒนา",104801,"อาคารเอนกประสงค์ศูนย์สุขภาพพาณิชยการราชดำเนินถนนทวีวัฒนา-กาญจนาภิเษก",31,225,237,315,552
6487,"ทวีวัฒนา","เขตทวีวัฒนา",104801,"อาคารบริษัท เค อาร์ อาร์ โอ๋เซอร์วิสสาย 2ใกล้สี่แยกทวีวัฒนา-กาญจนาภิเษก",32,151,216,259,475
6488,"ทวีวัฒนา","เขตทวีวัฒนา",104801,"อาคารบริษัท เค อาร์ อาร์ โอ๋เซอร์วิสสาย 2ใกล้สี่แยกทวีวัฒนา-กาญจนาภิเษก",33,193,229,257,486
6489,"ทวีวัฒนา","เขตทวีวัฒนา",104801,"เต็นท์บริเวณลานจอดรถ บริษัท เค อาร์ อาร์ โอ๋เซอร์วิสสาย 2ใกล้สี่แยกทวีวัฒนา-กาญจนาภิเษก",34,208,230,283,513
6490,"ทวีวัฒนา","เขตทวีวัฒนา",104801,"เต็นท์บริเวณลานจอดรถ บริษัท เค อาร์ อาร์ โอ๋เซอร์วิสสาย 2ใกล้สี่แยกทวีวัฒนา-กาญจนาภิเษก",35,185,226,286,512
6491,"ศาลาธรรมสพน์","เขตทวีวัฒนา",104802,"โรงเรียนวัดปุรณาวาส",1,228,298,353,651
6492,"ศาลาธรรมสพน์","เขตทวีวัฒนา",104802,"โรงเรียนวัดปุรณาวาส",2,158,268,332,600
6493,"ศาลาธรรมสพน์","เขตทวีวัฒนา",104802,"โรงเรียนคลองมหาสวัสดิ์",3,141,277,277,554
6494,"ศาลาธรรมสพน์","เขตทวีวัฒนา",104802,"โรงเรียนคลองมหาสวัสดิ์",4,244,282,342,624
6495,"ศาลาธรรมสพน์","เขตทวีวัฒนา",104802,"เต็นท์หน้าสถานีรถไฟศาลาธรรมสพน์",5,168,263,286,549
6496,"ศาลาธรรมสพน์","เขตทวีวัฒนา",104802,"เต็นท์หน้าสถานีรถไฟศาลาธรรมสพน์",6,219,274,317,591
6497,"ศาลาธรรมสพน์","เขตทวีวัฒนา",104802,"เต็นท์หน้าสถานีรถไฟศาลาธรรมสพน์",7,170,271,297,568
6498,"ศาลาธรรมสพน์","เขตทวีวัฒนา",104802,"เต็นท์บริเวณปั๊มน้ำมัน พี.ที. ปากซอยศาลาธรรมสพน์ 16",8,149,192,225,417
6499,"ศาลาธรรมสพน์","เขตทวีวัฒนา",104802,"เต็นท์บริเวณปั๊มน้ำมัน พี.ที. ปากซอยศาลาธรรมสพน์ 16",9,212,229,299,528
6500,"ศาลาธรรมสพน์","เขตทวีวัฒนา",104802,"เต็นท์บริเวณหน้าร้านสะดวกซื้อเซเว่น อีเลฟเว่น ตรงข้ามหมู่บ้านชัยพฤกษ์ ซอยทวีวัฒนา 24 ถนนเลียบคลองทวีวัฒนา",10,217,233,295,528
6501,"ศาลาธรรมสพน์","เขตทวีวัฒนา",104802,"เต็นท์บริเวณหน้าร้านสะดวกซื้อเซเว่น อีเลฟเว่น ตรงข้ามหมู่บ้านชัยพฤกษ์ ซอยทวีวัฒนา 24 ถนนเลียบคลองทวีวัฒนา",11,214,218,302,520
6502,"ศาลาธรรมสพน์","เขตทวีวัฒนา",104802,"เต็นท์บริเวณหน้าร้านสะดวกซื้อเซเว่น อีเลฟเว่น ตรงข้ามหมู่บ้านชัยพฤกษ์ ซอยทวีวัฒนา 24 ถนนเลียบคลองทวีวัฒนา",12,143,238,260,498
6503,"ศาลาธรรมสพน์","เขตทวีวัฒนา",104802,"เต็นท์บริเวณหน้าร้านสะดวกซื้อเซเว่น อีเลฟเว่น ตรงข้ามหมู่บ้านชัยพฤกษ์ ซอยทวีวัฒนา 24 ถนนเลียบคลองทวีวัฒนา",13,195,230,276,506
6504,"ศาลาธรรมสพน์","เขตทวีวัฒนา",104802,"เต็นท์บริเวณหน้าร้านสะดวกซื้อเซเว่น อีเลฟเว่น ตรงข้ามหมู่บ้านชัยพฤกษ์ ซอยทวีวัฒนา 24 ถนนเลียบคลองทวีวัฒนา",14,192,233,286,519
6505,"ศาลาธรรมสพน์","เขตทวีวัฒนา",104802,"เต็นท์บริเวณศูนย์ฝึกฟุตบอล โรงเรียนอัสสัมชันธนบุรีใกล้ซอยทวีวัฒนา 35",15,137,198,266,464
6506,"ศาลาธรรมสพน์","เขตทวีวัฒนา",104802,"เต็นท์บริเวณศูนย์ฝึกฟุตบอล โรงเรียนอัสสัมชันธนบุรีใกล้ซอยทวีวัฒนา 35",16,163,191,233,424
6507,"ศาลาธรรมสพน์","เขตทวีวัฒนา",104802,"เต็นท์บริเวณศูนย์ฝึกฟุตบอล โรงเรียนอัสสัมชันธนบุรีใกล้ซอยทวีวัฒนา 35",17,188,289,356,645
6508,"ศาลาธรรมสพน์","เขตทวีวัฒนา",104802,"อาคารโรงเรียนอนุบาลพลอยแก้ว ซอยบรมราชชนนี 74",18,288,267,335,602
6509,"ศาลาธรรมสพน์","เขตทวีวัฒนา",104802,"เต็นท์บริเวณโรงเรียนอนุบาลพลอยแก้ว ซอยบรมราชชนนี 74",19,183,258,303,561
6510,"ศาลาธรรมสพน์","เขตทวีวัฒนา",104802,"เต็นท์บริเวณหมู่บ้านสุขทวีวิลเลจ ปากซอยบรมราชชนนี 76",20,187,224,257,481
6511,"ศาลาธรรมสพน์","เขตทวีวัฒนา",104802,"อาคารลานเอนกประสงค์หมู่บ้านสุขทวีวิลเลจซอยบรมราชชนนี 76 แยก 14",21,214,275,368,643
6512,"ศาลาธรรมสพน์","เขตทวีวัฒนา",104802,"อาคารลานกีฬาหมู่บ้านสกุลทิพย์ ซอยบรมราชชนนี 123",22,176,203,263,466
6513,"ศาลาธรรมสพน์","เขตทวีวัฒนา",104802,"เต็นท์บริเวณลานกีฬาหมู่บ้านสกุลทิพย์ ซอยบรมราชชนนี 123",23,145,185,214,399
6514,"ศาลาธรรมสพน์","เขตทวีวัฒนา",104802,"โรงเรียนตั้งพิรุฬห์ธรรม",24,173,209,261,470
6515,"ศาลาธรรมสพน์","เขตทวีวัฒนา",104802,"เต็นท์หน้าสโมสรหมู่บ้านลดาวัลย์ ปิ่นเกล้า",25,256,269,340,609
6516,"ศาลาธรรมสพน์","เขตทวีวัฒนา",104802,"เต็นท์หน้าสโมสรหมู่บ้านลดาวัลย์ ปิ่นเกล้า",26,273,291,358,649
6517,"ศาลาธรรมสพน์","เขตทวีวัฒนา",104802,"เต็นท์ริมถนนบรมราชชนนีตัดถนนพุทธมณฑลสาย 3หมู่บ้านกฤษดานคร 16-17",27,192,211,291,502
6518,"ศาลาธรรมสพน์","เขตทวีวัฒนา",104802,"เต็นท์ริมถนนบรมราชชนนีตัดถนนพุทธมณฑลสาย 3หมู่บ้านกฤษดานคร 16-17",28,202,238,317,555
6519,"ศาลาธรรมสพน์","เขตทวีวัฒนา",104802,"เต็นท์ริมถนนบรมราชชนนีตัดถนนพุทธมณฑลสาย 3หมู่บ้านกฤษดานคร 16-17",29,206,220,311,531
6520,"ศาลาธรรมสพน์","เขตทวีวัฒนา",104802,"เต็นท์ริมถนนบรมราชชนนีตัดถนนพุทธมณฑลสาย 3หมู่บ้านกฤษดานคร 16-17",30,261,267,314,581
6521,"ศาลาธรรมสพน์","เขตทวีวัฒนา",104802,"เต็นท์ริมถนนบรมราชชนนีตัดถนนพุทธมณฑลสาย 3หมู่บ้านกฤษดานคร 16-17",31,310,294,374,668
6522,"ศาลาธรรมสพน์","เขตทวีวัฒนา",104802,"เต็นท์หลังอาคารสโมสรหมู่บ้านกฤษดานคร 18ซอยอัญมณี ซอย 17 แยก 1",32,198,199,268,467
6523,"ศาลาธรรมสพน์","เขตทวีวัฒนา",104802,"เต็นท์หลังอาคารสโมสรหมู่บ้านกฤษดานคร 18ซอยอัญมณี ซอย 17 แยก 1",33,177,199,261,460
6524,"ศาลาธรรมสพน์","เขตทวีวัฒนา",104802,"เต็นท์หลังอาคารสโมสรหมู่บ้านกฤษดานคร 18ซอยอัญมณี ซอย 17 แยก 1",34,189,220,266,486
6525,"ศาลาธรรมสพน์","เขตทวีวัฒนา",104802,"โรงเรียนคลองบางพรหม",35,107,266,241,507
6526,"ศาลาธรรมสพน์","เขตทวีวัฒนา",104802,"โรงเรียนคลองบางพรหม",36,165,299,302,601
6527,"ศาลาธรรมสพน์","เขตทวีวัฒนา",104802,"เต็นท์บริเวณปั๊มน้ำมันเอสโซ่ ถนนบรมราชชนนี (ทางเข้าหมู่บ้านสวนดอกไม้)",37,207,235,307,542
6528,"ศาลาธรรมสพน์","เขตทวีวัฒนา",104802,"เต็นท์ข้างอาคารสโมสรหมู่บ้านกฤษดานคร 20",38,242,256,286,542
6529,"ศาลาธรรมสพน์","เขตทวีวัฒนา",104802,"เต็นท์ข้างอาคารสโมสรหมู่บ้านกฤษดานคร 20",39,189,226,258,484
6530,"ศาลาธรรมสพน์","เขตทวีวัฒนา",104802,"เต็นท์บริเวณหน้าสถานตรวจสภาพรถเอกชน ชุมชนเจ้าพระยาร่วมใจ",40,164,204,258,462
6531,"ศาลาธรรมสพน์","เขตทวีวัฒนา",104802,"เต็นท์บริเวณหน้าสถานตรวจสภาพรถเอกชน ชุมชนเจ้าพระยาร่วมใจ",41,190,225,267,492
6532,"ศาลาธรรมสพน์","เขตทวีวัฒนา",104802,"อาคารเอนกประสงค์หมู่บ้านอมรชัย 3 ซอยบรมราชชนี 72",42,223,217,300,517
6533,"ศาลาธรรมสพน์","เขตทวีวัฒนา",104802,"อาคารเอนกประสงค์หมู่บ้านอมรชัย 3 ซอยบรมราชชนี 72",43,199,226,287,513
6534,"ศาลาธรรมสพน์","เขตทวีวัฒนา",104802,"อาคารเอนกประสงค์หมู่บ้านอมรชัย 3 ซอยบรมราชชนี 72",44,220,231,301,532
6535,"ศาลาธรรมสพน์","เขตทวีวัฒนา",104802,"อาคารเอนกประสงค์หมู่บ้านอมรชัย 3 ซอยบรมราชชนี 72",45,218,242,296,538
6536,"ศาลาธรรมสพน์","เขตทวีวัฒนา",104802,"เต็นท์บริเวณลานเอนกประสงค์หมู่บ้านพระปิ่น 2 โครงการใหม่(ด้านถนนศาลาธรรมสพน์)",46,243,244,305,549
6537,"ศาลาธรรมสพน์","เขตทวีวัฒนา",104802,"เต็นท์บริเวณลานเอนกประสงค์หมู่บ้านพระปิ่น 2 โครงการใหม่(ด้านถนนศาลาธรรมสพน์)",47,234,220,328,548
6538,"ศาลาธรรมสพน์","เขตทวีวัฒนา",104802,"เต็นท์บริเวณลานเอนกประสงค์หมู่บ้านพระปิ่น 2 โครงการใหม่(ด้านถนนศาลาธรรมสพน์)",48,223,233,310,543
6539,"ศาลาธรรมสพน์","เขตทวีวัฒนา",104802,"เต็นท์บริเวณลานเอนกประสงค์หมู่บ้านพระปิ่น 2 โครงการใหม่(ด้านถนนศาลาธรรมสพน์)",49,267,259,318,577
6540,"ศาลาธรรมสพน์","เขตทวีวัฒนา",104802,"เต็นท์บริเวณลานกีฬาหมู่บ้านพระปิ่น 2 ซอยบรมราชชนนี 70 แยก 6",50,208,235,293,528
6541,"ศาลาธรรมสพน์","เขตทวีวัฒนา",104802,"เต็นท์บริเวณลานกีฬาหมู่บ้านพระปิ่น 2 ซอยบรมราชชนนี 70 แยก 6",51,201,241,282,523
6542,"ศาลาธรรมสพน์","เขตทวีวัฒนา",104802,"เต็นท์บริเวณลานกีฬาหมู่บ้านพระปิ่น 2 ซอยบรมราชชนนี 70 แยก 6",52,210,248,272,520
6543,"ศาลาธรรมสพน์","เขตทวีวัฒนา",104802,"เต็นท์บริเวณลานกีฬาหมู่บ้านพระปิ่น 2 ซอยบรมราชชนนี 70 แยก 6",53,193,213,286,499
6544,"ศาลาธรรมสพน์","เขตทวีวัฒนา",104802,"เต็นท์บริเวณลานกีฬาหมู่บ้านพระปิ่น 2 ซอยบรมราชชนนี 70 แยก 6",54,239,213,312,525
6545,"ศาลาธรรมสพน์","เขตทวีวัฒนา",104802,"เต็นท์หน้าหมู่บ้านทิพย์มณฑล ซอยบรมราชชนนี 64 แยก 1",55,203,225,284,509
6546,"ศาลาธรรมสพน์","เขตทวีวัฒนา",104802,"เต็นท์หน้าหมู่บ้านทิพย์มณฑล ซอยบรมราชชนนี 64 แยก 1",56,221,250,278,528
6547,"ศาลาธรรมสพน์","เขตทวีวัฒนา",104802,"เต็นท์ริมถนนพุทธมณฑลสาย 2 ช่วงปลายด้านทางรถไฟสายใต้",57,117,247,290,537
6548,"ศาลาธรรมสพน์","เขตทวีวัฒนา",104802,"เต็นท์ริมถนนพุทธมณฑลสาย 2 ช่วงปลายด้านทางรถไฟสายใต้",58,139,250,269,519
6549,"ศาลาธรรมสพน์","เขตทวีวัฒนา",104802,"เต็นท์ริมถนนพุทธมณฑลสาย 2 ช่วงปลายด้านทางรถไฟสายใต้",59,233,303,316,619
6550,"ศาลาธรรมสพน์","เขตทวีวัฒนา",104802,"เต็นท์ริมถนนพุทธมณฑลสาย 2 ช่วงปลายด้านทางรถไฟสายใต้",60,224,240,342,582
6551,"ศาลาธรรมสพน์","เขตทวีวัฒนา",104802,"วิทยาลัยเทคโนโลยีปิ่นมณฑล",61,206,243,296,539
6552,"ศาลาธรรมสพน์","เขตทวีวัฒนา",104802,"วิทยาลัยเทคโนโลยีปิ่นมณฑล",62,258,295,358,653
6553,"ศาลาธรรมสพน์","เขตทวีวัฒนา",104802,"วิทยาลัยเทคโนโลยีปิ่นมณฑล",63,298,278,366,644
6554,"ศาลาธรรมสพน์","เขตทวีวัฒนา",104802,"เต็นท์บริเวณถนนสายกลางหมู่บ้านชวนชื่น-กรีนวิลล์",64,186,209,287,496
6555,"ศาลาธรรมสพน์","เขตทวีวัฒนา",104802,"เต็นท์บริเวณถนนสายกลางหมู่บ้านชวนชื่น-กรีนวิลล์",65,177,217,255,472
6556,"ศาลาธรรมสพน์","เขตทวีวัฒนา",104802,"เต็นท์บริเวณถนนสายกลางหมู่บ้านชวนชื่น-กรีนวิลล์",66,173,193,264,457
6557,"ศาลาธรรมสพน์","เขตทวีวัฒนา",104802,"เต็นท์บริเวณถนนสายกลางหมู่บ้านชวนชื่น-กรีนวิลล์",67,178,212,270,482
6558,"ศาลาธรรมสพน์","เขตทวีวัฒนา",104802,"เต็นท์บริเวณข้างองค์พระหมู่บ้านชวนชื่น-พาร์ควิลล์",68,178,221,272,493
6559,"ศาลาธรรมสพน์","เขตทวีวัฒนา",104802,"เต็นท์บริเวณข้างองค์พระหมู่บ้านชวนชื่น-พาร์ควิลล์",69,197,240,274,514
6560,"ศาลาธรรมสพน์","เขตทวีวัฒนา",104802,"เต็นท์หน้าหมู่บ้านเพชรมณี ซอยกาญจนาภิเษก 0017",70,110,146,155,301
6561,"ศาลาธรรมสพน์","เขตทวีวัฒนา",104802,"โรงอาหารวิทยาลัยทองสุข",71,237,272,338,610
6562,"ศาลาธรรมสพน์","เขตทวีวัฒนา",104802,"โรงอาหารวิทยาลัยทองสุข",72,261,302,326,628
6563,"ศาลาธรรมสพน์","เขตทวีวัฒนา",104802,"เต็นท์บริเวณทางเท้าริมถนนพุทธมณฑลสาย 2หน้าบริษัท เอส.อาร์ โฮมเซ็นเตอร์ จำกัด ใกล้ซอย 25",73,210,245,288,533
6564,"ศาลาธรรมสพน์","เขตทวีวัฒนา",104802,"เต็นท์บริเวณทางเท้าริมถนนพุทธมณฑลสาย 2หน้าบริษัท เอส.อาร์ โฮมเซ็นเตอร์ จำกัด ใกล้ซอย 25",74,212,229,305,534
6565,"ศาลาธรรมสพน์","เขตทวีวัฒนา",104802,"เต็นท์บริเวณทางเท้าริมถนนพุทธมณฑลสาย 2หน้าบริษัท เอส.อาร์ โฮมเซ็นเตอร์ จำกัด ใกล้ซอย 25",75,200,250,316,566
6566,"ศาลาธรรมสพน์","เขตทวีวัฒนา",104802,"เต็นท์บริเวณทางเท้าริมถนนพุทธมณฑลสาย 2หน้าบริษัท เอส.อาร์ โฮมเซ็นเตอร์ จำกัด ใกล้ซอย 25",76,239,269,319,588
6567,"ศาลาธรรมสพน์","เขตทวีวัฒนา",104802,"เต็นท์บริเวณทางเท้าริมถนนพุทธมณฑลสาย 2หน้าบริษัท เอส.อาร์ โฮมเซ็นเตอร์ จำกัด ใกล้ซอย 25",77,257,280,344,624
6568,"ศาลาธรรมสพน์","เขตทวีวัฒนา",104802,"เต็นท์บริเวณสนามเด็กเล่นโรงเรียนอนุบาลสร้างสรรค์หมู่บ้าน ป.ผาสุก ซอย 6",78,193,273,305,578
6569,"ศาลาธรรมสพน์","เขตทวีวัฒนา",104802,"เต็นท์บริเวณสนามเด็กเล่นโรงเรียนอนุบาลสร้างสรรค์หมู่บ้าน ป.ผาสุก ซอย 6",79,232,258,367,625
6570,"ศาลาธรรมสพน์","เขตทวีวัฒนา",104802,"เต็นท์บริเวณสนามเด็กเล่นโรงเรียนอนุบาลสร้างสรรค์หมู่บ้าน ป.ผาสุก ซอย 6",80,230,283,357,640
6571,"ศาลาธรรมสพน์","เขตทวีวัฒนา",104802,"เต็นท์บริเวณหน้าร้านอาหารร่มไม้ชายคา ถนนพุทธมณฑลสาย 2 ซอย 24",81,122,176,176,352
6572,"ศาลาธรรมสพน์","เขตทวีวัฒนา",104802,"เต็นท์บริเวณหน้าร้านอาหารร่มไม้ชายคา ถนนพุทธมณฑลสาย 2 ซอย 24",82,111,136,195,331
6573,"ศาลาธรรมสพน์","เขตทวีวัฒนา",104802,"เต็นท์บริเวณหน้าหมู่บ้านกอบแก้ว 1 ถนนพุทธมณฑลสาย 2 ซอย 24",83,121,154,184,338
6574,"ศาลาธรรมสพน์","เขตทวีวัฒนา",104802,"เต็นท์บริเวณหน้าหมู่บ้านกอบแก้ว 1 ถนนพุทธมณฑลสาย 2 ซอย 24",84,191,188,221,409
6575,"ศาลาธรรมสพน์","เขตทวีวัฒนา",104802,"เต็นท์บริเวณทางเท้าถนนพุทธมณฑลสาย 2 ซอย 21 (ซอยอัยเวศน์)",85,165,210,233,443
6576,"ศาลาธรรมสพน์","เขตทวีวัฒนา",104802,"เต็นท์บริเวณทางเท้าถนนพุทธมณฑลสาย 2 ซอย 21 (ซอยอัยเวศน์)",86,175,231,275,506
6577,"ศาลาธรรมสพน์","เขตทวีวัฒนา",104802,"เต็นท์บริเวณทางเท้าถนนพุทธมณฑลสาย 2 ปากซอย 22",87,175,192,231,423
6578,"ศาลาธรรมสพน์","เขตทวีวัฒนา",104802,"เต็นท์บริเวณทางเท้าถนนพุทธมณฑลสาย 2 ปากซอย 22",88,131,136,199,335
6579,"บางมด","เขตทุ่งครุ",104901,"โรงเรียนนาหลวง",1,286,358,390,748
6580,"บางมด","เขตทุ่งครุ",104901,"โรงเรียนนาหลวง",2,228,344,381,725
6581,"บางมด","เขตทุ่งครุ",104901,"โรงเรียนนาหลวง",3,322,390,416,806
6582,"บางมด","เขตทุ่งครุ",104901,"โรงเรียนนาหลวง",4,269,370,447,817
6583,"บางมด","เขตทุ่งครุ",104901,"เต็นท์ในบริเวณศูนย์กีฬาเฉลิมพระเกียรติ",5,257,330,455,785
6584,"บางมด","เขตทุ่งครุ",104901,"เต็นท์ในบริเวณศูนย์กีฬาเฉลิมพระเกียรติ",6,188,346,383,729
6585,"บางมด","เขตทุ่งครุ",104901,"เต็นท์ในบริเวณศูนย์กีฬาเฉลิมพระเกียรติ",7,277,337,443,780
6586,"บางมด","เขตทุ่งครุ",104901,"เต็นท์ในบริเวณศูนย์กีฬาเฉลิมพระเกียรติ",8,275,278,393,671
6587,"บางมด","เขตทุ่งครุ",104901,"เต็นท์ในบริเวณศูนย์กีฬาเฉลิมพระเกียรติ",9,230,274,326,600
6588,"บางมด","เขตทุ่งครุ",104901,"โรงเรียนมัมบะอิลอิสลาม",10,230,383,460,843
6589,"บางมด","เขตทุ่งครุ",104901,"โรงเรียนมัมบะอิลอิสลาม",11,300,428,480,908
6590,"บางมด","เขตทุ่งครุ",104901,"โรงเรียนมัมบะอิลอิสลาม",12,237,412,506,918
6591,"บางมด","เขตทุ่งครุ",104901,"โรงเรียนมัมบะอิลอิสลาม",13,299,421,509,930
6592,"บางมด","เขตทุ่งครุ",104901,"เต็นท์ใกล้ศูนย์พัฒนาเด็กเล็กก่อนวัยเรียนชุมชนบลูไลท์(ซอยประชาอุทิศ 33)",14,156,256,298,554
6593,"บางมด","เขตทุ่งครุ",104901,"เต็นท์ใกล้ศูนย์พัฒนาเด็กเล็กก่อนวัยเรียนชุมชนบลูไลท์ (ซอยประชาอุทิศ 33)",15,158,263,319,582
6594,"บางมด","เขตทุ่งครุ",104901,"โรงเรียนฝึกอาชีพกรุงเทพมหานคร (อาทร สังขะวัฒนะ)",16,333,369,466,835
6595,"บางมด","เขตทุ่งครุ",104901,"โรงเรียนฝึกอาชีพกรุงเทพมหานคร (อาทร สังขะวัฒนะ)",17,467,283,433,716
6596,"บางมด","เขตทุ่งครุ",104901,"โรงเรียนฝึกอาชีพกรุงเทพมหานคร (อาทร สังขะวัฒนะ)",18,249,425,421,846
6597,"บางมด","เขตทุ่งครุ",104901,"โรงเรียนฝึกอาชีพกรุงเทพมหานคร (อาทร สังขะวัฒนะ)",19,157,342,348,690
6598,"บางมด","เขตทุ่งครุ",104901,"โรงเรียนฝึกอาชีพกรุงเทพมหานคร (อาทร สังขะวัฒนะ)",20,348,387,492,879
6599,"บางมด","เขตทุ่งครุ",104901,"เต็นท์บริเวณห้องสมุดเพื่อการเรียนรู้ เขตทุ่งครุ",21,274,292,391,683
6600,"บางมด","เขตทุ่งครุ",104901,"เต็นท์บริเวณห้องสมุดเพื่อการเรียนรู้ เขตทุ่งครุ",22,278,308,406,714
6601,"บางมด","เขตทุ่งครุ",104901,"เต็นท์บริเวณห้องสมุดเพื่อการเรียนรู้ เขตทุ่งครุ",23,217,316,362,678
6602,"บางมด","เขตทุ่งครุ",104901,"โรงเรียนวัดพุทธบูชา",24,312,418,453,871
6603,"บางมด","เขตทุ่งครุ",104901,"โรงเรียนวัดพุทธบูชา",25,290,374,447,821
6604,"บางมด","เขตทุ่งครุ",104901,"โรงเรียนวัดพุทธบูชา",26,385,431,516,947
6605,"บางมด","เขตทุ่งครุ",104901,"โรงเรียนวัดพุทธบูชา",27,358,416,500,916
6606,"บางมด","เขตทุ่งครุ",104901,"เต็นท์ในโรงเรียนวัดพุทธบูชา",28,248,366,386,752
6607,"บางมด","เขตทุ่งครุ",104901,"เต็นท์ในโรงเรียนวัดพุทธบูชา",29,353,408,467,875
6608,"บางมด","เขตทุ่งครุ",104901,"โรงเรียนสามัคคีบำรุง",30,260,390,454,844
6609,"บางมด","เขตทุ่งครุ",104901,"โรงเรียนสามัคคีบำรุง",31,436,432,546,978
6610,"บางมด","เขตทุ่งครุ",104901,"โรงเรียนสามัคคีบำรุง",32,246,394,427,821
6611,"บางมด","เขตทุ่งครุ",104901,"เต็นท์บริเวณหน้าอาคารศรีไทยคอนโดทาวน์ (ซอยประชาอุทิศ 33)",33,264,354,404,758
6612,"บางมด","เขตทุ่งครุ",104901,"เต็นท์บริเวณหน้าอาคารศรีไทยคอนโดทาวน์ (ซอยประชาอุทิศ 33)",34,324,378,467,845
6613,"บางมด","เขตทุ่งครุ",104901,"เต็นท์บริเวณหน้าอาคารศรีไทยคอนโดทาวน์ (ซอยประชาอุทิศ 33)",35,249,341,404,745
6614,"บางมด","เขตทุ่งครุ",104901,"เต็นท์บริเวณหน้าอาคารศรีไทยคอนโดทาวน์ (ซอยประชาอุทิศ 33)",36,347,339,467,806
6615,"บางมด","เขตทุ่งครุ",104901,"เต็นท์บริเวณหน้าอาคารศรีไทยคอนโดทาวน์ (ซอยประชาอุทิศ 33)",37,312,351,459,810
6616,"บางมด","เขตทุ่งครุ",104901,"เต็นท์บริเวณหน้าอาคารศรีไทยคอนโดทาวน์ (ซอยประชาอุทิศ 33)",38,223,304,389,693
6617,"บางมด","เขตทุ่งครุ",104901,"เต็นท์ปากทางเข้าหมู่บ้านสุขสวัสดิ์สวนธน (ซอยประชาอุทิศ 33)",39,248,335,401,736
6618,"บางมด","เขตทุ่งครุ",104901,"เต็นท์ปากทางเข้าหมู่บ้านสุขสวัสดิ์สวนธน (ซอยประชาอุทิศ 33)",40,276,321,406,727
6619,"บางมด","เขตทุ่งครุ",104901,"เต็นท์ปากทางเข้าหมู่บ้านสุขสวัสดิ์สวนธน (ซอยประชาอุทิศ 33)",41,282,324,413,737
6620,"บางมด","เขตทุ่งครุ",104901,"เต็นท์ในบริเวณวัดบางมดโสธราราม (วัดกลางนา)(ซอยประชาอุทิศ 33)",42,309,426,470,896
6621,"บางมด","เขตทุ่งครุ",104901,"เต็นท์ในบริเวณวัดบางมดโสธราราม (วัดกลางนา)(ซอยประชาอุทิศ 33)",43,269,415,479,894
6622,"บางมด","เขตทุ่งครุ",104901,"เต็นท์ในบริเวณวัดบางมดโสธราราม (วัดกลางนา)(ซอยประชาอุทิศ 33)",44,389,396,444,840
6623,"บางมด","เขตทุ่งครุ",104901,"เต็นท์ในบริเวณวัดบางมดโสธราราม(วัดกลางนา)(ซอยประชาอุทิศ 33)",45,353,425,493,918
6624,"บางมด","เขตทุ่งครุ",104901,"เต็นท์ในบริเวณอู่รถประจำทางสาย 75 (ซอยพุทธบูชา 36)",46,323,423,490,913
6625,"บางมด","เขตทุ่งครุ",104901,"เต็นท์ในบริเวณอู่รถประจำทางสาย 75 (ซอยพุทธบูชา 36)",47,390,434,499,933
6626,"บางมด","เขตทุ่งครุ",104901,"เต็นท์ในบริเวณอู่รถประจำทางสาย 75 (ซอยพุทธบูชา 36)",48,328,361,453,814
6627,"บางมด","เขตทุ่งครุ",104901,"เต็นท์ในบริเวณอู่รถประจำทางสาย 75 (ซอยพุทธบูชา 36)",49,312,336,420,756
6628,"บางมด","เขตทุ่งครุ",104901,"เต็นท์ในบริเวณอู่รถประจำทางสาย 75 (ซอยพุทธบูชา 36)",50,377,420,488,908
6629,"บางมด","เขตทุ่งครุ",104901,"เต็นท์ในบริเวณอู่รถประจำทางสาย 75 (ซอยพุทธบูชา 36)",51,458,413,569,982
6630,"บางมด","เขตทุ่งครุ",104901,"มัสยิดดาริลฮาซัน (สอนสมบูรณ์)(ซอยพุทธบูชา 36)",52,294,372,447,819
6631,"บางมด","เขตทุ่งครุ",104901,"เต็นท์บริเวณทางเข้าบริษัทสยามสมาร์ทแลนด์ จำกัด (กลางซอยประชาอุทิศ 54)",53,299,402,489,891
6632,"บางมด","เขตทุ่งครุ",104901,"เต็นท์บริเวณทางเข้าบริษัทสยามสมาร์ทแลนด์ จำกัด(กลางซอยประชาอุทิศ 54)",54,311,390,518,908
6633,"บางมด","เขตทุ่งครุ",104901,"เต็นท์บริเวณทางเข้าบริษัทสยามสมาร์ทแลนด์ จำกัด(กลางซอยประชาอุทิศ 54)",55,263,412,472,884
6634,"ทุ่งครุ","เขตทุ่งครุ",104902,"โรงเรียนราษฎร์บูรณะ",1,424,409,503,912
6635,"ทุ่งครุ","เขตทุ่งครุ",104902,"โรงเรียนราษฎร์บูรณะ",2,337,409,512,921
6636,"ทุ่งครุ","เขตทุ่งครุ",104902,"โรงเรียนราษฎร์บูรณะ",3,200,427,434,861
6637,"ทุ่งครุ","เขตทุ่งครุ",104902,"โรงเรียนราษฎร์บูรณะ",4,282,438,529,967
6638,"ทุ่งครุ","เขตทุ่งครุ",104902,"เต็นท์ในโรงเรียนราษฎร์บูรณะ",5,226,418,442,860
6639,"ทุ่งครุ","เขตทุ่งครุ",104902,"เต็นท์ในโรงเรียนราษฎร์บูรณะ",6,405,457,541,998
6640,"ทุ่งครุ","เขตทุ่งครุ",104902,"เต็นท์ในโรงเรียนราษฎร์บูรณะ",7,270,419,475,894
6641,"ทุ่งครุ","เขตทุ่งครุ",104902,"เต็นท์ในโรงเรียนราษฎร์บูรณะ",8,240,403,453,856
6642,"ทุ่งครุ","เขตทุ่งครุ",104902,"เต็นท์ในโรงเรียนราษฎร์บูรณะ",9,313,374,469,843
6643,"ทุ่งครุ","เขตทุ่งครุ",104902,"เต็นท์ทางเข้าหมู่บ้านวิเศษสุขนคร (ซอยประชาอุทิศ 79)",10,278,352,446,798
6644,"ทุ่งครุ","เขตทุ่งครุ",104902,"เต็นท์ทางเข้าหมู่บ้านวิเศษสุขนคร (ซอยประชาอุทิศ 79)",11,266,375,431,806
6645,"ทุ่งครุ","เขตทุ่งครุ",104902,"เต็นท์ทางเข้าหมู่บ้านวิเศษสุขนคร (ซอยประชาอุทิศ 79)",12,279,383,431,814
6646,"ทุ่งครุ","เขตทุ่งครุ",104902,"เต็นท์ทางเข้าหมู่บ้านวิเศษสุขนคร (ซอยประชาอุทิศ 79)",13,259,365,410,775
6647,"ทุ่งครุ","เขตทุ่งครุ",104902,"เต็นท์สวนหย่อมกลางหมู่บ้านวิเศษสุขนคร (ซอยประชาอุทิศ 79)",14,321,392,468,860
6648,"ทุ่งครุ","เขตทุ่งครุ",104902,"เต็นท์สวนหย่อมกลางหมู่บ้านวิเศษสุขนคร (ซอยประชาอุทิศ 79)",15,312,389,484,873
6649,"ทุ่งครุ","เขตทุ่งครุ",104902,"เต็นท์สวนหย่อมกลางหมู่บ้านวิเศษสุขนคร (ซอยประชาอุทิศ 79)",16,286,377,480,857
6650,"ทุ่งครุ","เขตทุ่งครุ",104902,"เต็นท์สวนหย่อมกลางหมู่บ้านวิเศษสุขนคร (ซอยประชาอุทิศ 79)",17,264,382,440,822
6651,"ทุ่งครุ","เขตทุ่งครุ",104902,"เต็นท์สวนหย่อมกลางหมู่บ้านวิเศษสุขนคร (ซอยประชาอุทิศ 79)",18,349,389,483,872
6652,"ทุ่งครุ","เขตทุ่งครุ",104902,"เต็นท์บริเวณมัสยิดอัลอิสติกอมะห์ (ปากซอยประชาอุทิศ 69)",19,269,365,427,792
6653,"ทุ่งครุ","เขตทุ่งครุ",104902,"เต็นท์บริเวณมัสยิดอัลอิสติกอมะห์ (ปากซอยประชาอุทิศ 69)",20,327,347,475,822
6654,"ทุ่งครุ","เขตทุ่งครุ",104902,"เต็นท์บริเวณมัสยิดอัลอิสติกอมะห์ (ปากซอยประชาอุทิศ 69)",21,199,347,402,749
6655,"ทุ่งครุ","เขตทุ่งครุ",104902,"เต็นท์บริเวณมัสยิดอัลอิสติกอมะห์ (ปากซอยประชาอุทิศ 69)",22,164,332,407,739
6656,"ทุ่งครุ","เขตทุ่งครุ",104902,"เต็นท์ปากทางเข้าหมู่บ้านสิริจันทร์ (กลางซอยประชาอุทิศ 69)",23,328,470,524,994
6657,"ทุ่งครุ","เขตทุ่งครุ",104902,"เต็นท์ปากทางเข้าหมู่บ้านสิริจันทร์ (กลางซอยประชาอุทิศ 69)",24,284,459,522,981
6658,"ทุ่งครุ","เขตทุ่งครุ",104902,"เต็นท์ในลานกีฬาชุมชนดารีซีน",25,226,396,417,813
6659,"ทุ่งครุ","เขตทุ่งครุ",104902,"เต็นท์ในบริเวณมัสยิดคอลีดิน (ซอยประชาอุทิศ 54)",26,180,305,352,657
6660,"ทุ่งครุ","เขตทุ่งครุ",104902,"เต็นท์ในบริเวณมัสยิดคอลีดิน (ซอยประชาอุทิศ 54)",27,256,436,474,910
6661,"ทุ่งครุ","เขตทุ่งครุ",104902,"เต็นท์ในบริเวณมัสยิดคอลีดิน (ซอยประชาอุทิศ 54)",28,271,348,396,744
6662,"ทุ่งครุ","เขตทุ่งครุ",104902,"เต็นท์ในบริเวณโรงเรียนบูรณะศึกษา (ซอยประชาอุทิศ 76)",29,294,357,429,786
6663,"ทุ่งครุ","เขตทุ่งครุ",104902,"เต็นท์ในบริเวณโรงเรียนบูรณะศึกษา (ซอยประชาอุทิศ 76)",30,272,372,413,785
6664,"ทุ่งครุ","เขตทุ่งครุ",104902,"เต็นท์ในบริเวณโรงเรียนบูรณะศึกษา (ซอยประชาอุทิศ 76)",31,281,377,451,828
6665,"ทุ่งครุ","เขตทุ่งครุ",104902,"เต็นท์ในบริเวณโรงเรียนบูรณะศึกษา (ซอยประชาอุทิศ 76)",32,300,344,470,814
6666,"ทุ่งครุ","เขตทุ่งครุ",104902,"เต็นท์ในบริเวณโรงเรียนบูรณะศึกษา (ซอยประชาอุทิศ 76)",33,285,369,416,785
6667,"ทุ่งครุ","เขตทุ่งครุ",104902,"เต็นท์ในบริเวณโรงเรียนบูรณะศึกษา (ซอยประชาอุทิศ 76)",34,223,357,398,755
6668,"ทุ่งครุ","เขตทุ่งครุ",104902,"อาคารสงเคราะห์ข้าราชการกรุงเทพมหานคร (ซอยประชาอุทิศ 76)",35,342,456,540,996
6669,"ทุ่งครุ","เขตทุ่งครุ",104902,"อาคารสงเคราะห์ข้าราชการกรุงเทพมหานคร (ซอยประชาอุทิศ 76)",36,259,343,398,741
6670,"ทุ่งครุ","เขตทุ่งครุ",104902,"อาคารสงเคราะห์ข้าราชการกรุงเทพมหานคร (ซอยประชาอุทิศ 76)",37,313,398,466,864
6671,"ทุ่งครุ","เขตทุ่งครุ",104902,"อาคารสงเคราะห์ข้าราชการกรุงเทพมหานคร (ซอยประชาอุทิศ 76)",38,324,395,503,898
6672,"ทุ่งครุ","เขตทุ่งครุ",104902,"เต็นท์ในบริเวณตลาดสุขรุ่งเรืองมาร์เก็ต",39,418,426,543,969
6673,"ทุ่งครุ","เขตทุ่งครุ",104902,"เต็นท์ในบริเวณตลาดสุขรุ่งเรืองมาร์เก็ต",40,535,493,582,1075
6674,"ทุ่งครุ","เขตทุ่งครุ",104902,"เต็นท์ในบริเวณตลาดสุขรุ่งเรืองมาร์เก็ต",41,310,427,498,925
6675,"ทุ่งครุ","เขตทุ่งครุ",104902,"เต็นท์ในโรงเรียนรางราชพฤกษ์นุชมีอุทิศ (ซอยประชาอุทิศ 72)",42,143,303,306,609
6676,"ทุ่งครุ","เขตทุ่งครุ",104902,"เต็นท์ในโรงเรียนรางราชพฤกษ์นุชมีอุทิศ (ซอยประชาอุทิศ 72)",43,198,223,314,537
6677,"ทุ่งครุ","เขตทุ่งครุ",104902,"มัสยิดเนียะมะตุลลอฮ์ (ซอยประชาอุทิศ 72)",44,342,391,421,812
6678,"ทุ่งครุ","เขตทุ่งครุ",104902,"เต็นท์ในบริเวณมัสยิดเนียะมะตุลลอฮ์ (ซอยประชาอุทิศ 72)",45,236,364,443,807
6679,"ทุ่งครุ","เขตทุ่งครุ",104902,"เต็นท์ในบริเวณมัสยิดเนียะมะตุลลอฮ์ (ซอยประชาอุทิศ 72)",46,262,353,402,755
6680,"ทุ่งครุ","เขตทุ่งครุ",104902,"เต็นท์ในบริเวณมัสยิดเนียะมะตุลลอฮ์ (ซอยประชาอุทิศ 72)",47,259,384,437,821
6681,"ทุ่งครุ","เขตทุ่งครุ",104902,"เต็นท์ในบริเวณวัดทุ่งครุ",48,498,419,574,993
6682,"ทุ่งครุ","เขตทุ่งครุ",104902,"เต็นท์ในบริเวณวัดทุ่งครุ",49,416,372,501,873
6683,"ทุ่งครุ","เขตทุ่งครุ",104902,"เต็นท์ในบริเวณวัดทุ่งครุ",50,292,490,537,1027
6684,"ทุ่งครุ","เขตทุ่งครุ",104902,"เต็นท์ในบริเวณวัดทุ่งครุ",51,240,389,479,868
6685,"ทุ่งครุ","เขตทุ่งครุ",104902,"เต็นท์ในบริเวณวัดทุ่งครุ",52,394,444,513,957
6686,"ทุ่งครุ","เขตทุ่งครุ",104902,"อาคารสงเคราะห์ข้าราชการกรุงเทพมหานคร (ซอยประชาอุทิศ 90)",53,368,364,494,858
6687,"ทุ่งครุ","เขตทุ่งครุ",104902,"อาคารสงเคราะห์ข้าราชการกรุงเทพมหานคร (ซอยประชาอุทิศ 90)",54,293,343,339,682
6688,"ทุ่งครุ","เขตทุ่งครุ",104902,"อาคารสงเคราะห์ข้าราชการกรุงเทพมหานคร (ซอยประชาอุทิศ 90)",55,195,364,428,792
6689,"ทุ่งครุ","เขตทุ่งครุ",104902,"อาคารสงเคราะห์ข้าราชการกรุงเทพมหานคร (ซอยประชาอุทิศ 90)",56,272,396,468,864
6690,"ทุ่งครุ","เขตทุ่งครุ",104902,"เต็นท์ในโรงเรียนวัดทุ่งครุ",57,309,383,458,841
6691,"ทุ่งครุ","เขตทุ่งครุ",104902,"เต็นท์ในโรงเรียนวัดทุ่งครุ",58,227,376,413,789
6692,"ทุ่งครุ","เขตทุ่งครุ",104902,"เต็นท์ในโรงเรียนวัดทุ่งครุ",59,192,445,476,921
6693,"ทุ่งครุ","เขตทุ่งครุ",104902,"เต็นท์ในโรงเรียนวัดทุ่งครุ",60,289,341,386,727
6694,"ทุ่งครุ","เขตทุ่งครุ",104902,"เต็นท์ในโรงเรียนวัดทุ่งครุ",61,335,395,461,856
6695,"ทุ่งครุ","เขตทุ่งครุ",104902,"เต็นท์ในโรงเรียนวัดทุ่งครุ",62,372,460,542,1002
6696,"ทุ่งครุ","เขตทุ่งครุ",104902,"เต็นท์ในโรงเรียนวัดทุ่งครุ",63,302,331,420,751
6697,"ทุ่งครุ","เขตทุ่งครุ",104902,"เต็นท์ในโรงเรียนวัดทุ่งครุ",64,399,444,545,989
6698,"บางบอนเหนือ","เขตบางบอน",105002,"เต็นท์บริเวณหน้าสำนักงานหมู่บ้านวรารมย์ ถนนบางบอน 5",1,267,293,327,620
6699,"บางบอนเหนือ","เขตบางบอน",105002,"เต็นท์บริเวณหน้าสำนักงานหมู่บ้านวรารมย์ ถนนบางบอน 5",2,248,260,327,587
6700,"บางบอนเหนือ","เขตบางบอน",105002,"เต็นท์บริเวณหลังป้อมยามทางเข้าหมู่บ้านวรารมย์ ถนนบางบอน 5",3,203,247,313,560
6701,"บางบอนเหนือ","เขตบางบอน",105002,"เต็นท์บริเวณหลังป้อมยามทางเข้าหมู่บ้านวรารมย์ ถนนบางบอน 5",4,217,270,302,572
6702,"บางบอนเหนือ","เขตบางบอน",105002,"เต็นท์บริเวณหลังป้อมยามทางเข้าหมู่บ้านวรารมย์ ถนนบางบอน 5",5,234,271,278,549
6703,"บางบอนเหนือ","เขตบางบอน",105002,"เต็นท์บริเวณร้านอาหารอิ่มปลาเผา ถนนบางบอน 5",6,246,333,358,691
6704,"บางบอนเหนือ","เขตบางบอน",105002,"เต็นท์บริเวณร้านอาหารอิ่มปลาเผา ถนนบางบอน 5",7,230,337,337,674
6705,"บางบอนเหนือ","เขตบางบอน",105002,"เต็นท์บริเวณร้านอาหารอิ่มปลาเผา ถนนบางบอน 5",8,226,314,355,669
6706,"บางบอนเหนือ","เขตบางบอน",105002,"เต็นท์บริเวณร้านอาหารอิ่มปลาเผา ถนนบางบอน 5",9,206,293,314,607
6707,"บางบอนเหนือ","เขตบางบอน",105002,"เต็นท์บริเวณร้านอาหารอิ่มปลาเผา ถนนบางบอน 5",10,228,261,349,610
6708,"บางบอนเหนือ","เขตบางบอน",105002,"วิทยาลัยเทคนิคราชสิทธาราม ซอยเอกชัย 116",11,321,410,414,824
6709,"บางบอนเหนือ","เขตบางบอน",105002,"วิทยาลัยเทคนิคราชสิทธาราม ซอยเอกชัย 116",12,247,393,402,795
6710,"บางบอนเหนือ","เขตบางบอน",105002,"เต็นท์บริเวณบึงบางบอน ถนนบางบอน 3",13,318,351,397,748
6711,"บางบอนเหนือ","เขตบางบอน",105002,"เต็นท์บริเวณบึงบางบอน ถนนบางบอน 3",14,271,334,422,756
6712,"บางบอนเหนือ","เขตบางบอน",105002,"เต้นท์บริเวณบึงบางบอน ถนนบางบอน 3",15,275,334,386,720
6713,"บางบอนเหนือ","เขตบางบอน",105002,"เต็นท์บริเวณบึงบางบอน ถนนบางบอน 3",16,235,285,390,675
6714,"บางบอนเหนือ","เขตบางบอน",105002,"เต็นท์บริเวณบึงบางบอน ถนนบางบอน 3",17,223,300,383,683
6715,"บางบอนเหนือ","เขตบางบอน",105002,"เต็นท์บริเวณบึงบางบอน ถนนบางบอน 3",18,303,340,409,749
6716,"บางบอนเหนือ","เขตบางบอน",105002,"เต็นท์บริเวณบึงบางบอน ถนนบางบอน 3",19,230,322,366,688
6717,"บางบอนเหนือ","เขตบางบอน",105002,"โรงเรียนบ้านนายเหรียญ",20,353,354,470,824
6718,"บางบอนเหนือ","เขตบางบอน",105002,"โรงเรียนบ้านนายเหรียญ",21,268,373,416,789
6719,"บางบอนเหนือ","เขตบางบอน",105002,"โรงเรียนบ้านนายเหรียญ",22,293,396,410,806
6720,"บางบอนเหนือ","เขตบางบอน",105002,"โรงเรียนบ้านนายสี",23,272,393,406,799
6721,"บางบอนเหนือ","เขตบางบอน",105002,"โรงเรียนวัดนินสุขาราม",24,302,322,380,702
6722,"บางบอนเหนือ","เขตบางบอน",105002,"โรงเรียนวัดนินสุขาราม",25,246,326,370,696
6723,"บางบอนเหนือ","เขตบางบอน",105002,"โรงเรียนวัดนินสุขาราม",26,327,321,360,681
6724,"บางบอนใต้","เขตบางบอน",105003,"เต็นท์บริเวณร้านอาหาร ส.สุขโภชนา ถนนกาญจนาภิเษก",1,424,397,489,886
6725,"บางบอนใต้","เขตบางบอน",105003,"โรงเรียนพรหมราษฎร์รังสรรค์",2,257,273,408,681
6726,"บางบอนใต้","เขตบางบอน",105003,"โรงเรียนพรหมราษฎร์รังสรรค์",3,233,314,392,706
6727,"บางบอนใต้","เขตบางบอน",105003,"โรงเรียนพรหมราษฎร์รังสรรค์",4,233,292,407,699
6728,"บางบอนใต้","เขตบางบอน",105003,"โรงเรียนพรหมราษฎร์รังสรรค์",5,229,318,363,681
6729,"บางบอนใต้","เขตบางบอน",105003,"โรงเรียนพรหมราษฎร์รังสรรค์",6,253,318,382,700
6730,"บางบอนใต้","เขตบางบอน",105003,"โรงเรียนพรหมราษฎร์รังสรรค์",7,213,337,395,732
6731,"บางบอนใต้","เขตบางบอน",105003,"โรงเรียนพรหมราษฎร์รังสรรค์",8,296,350,425,775
6732,"บางบอนใต้","เขตบางบอน",105003,"โรงเรียนพรหมราษฎร์รังสรรค์",9,230,339,407,746
6733,"บางบอนใต้","เขตบางบอน",105003,"เรือนจำพิเศษธนบุรี",10,281,340,339,679
6734,"บางบอนใต้","เขตบางบอน",105003,"เรือนจำพิเศษธนบุรี",11,221,320,279,599
6735,"บางบอนใต้","เขตบางบอน",105003,"เรือนจำพิเศษธนบุรี",12,330,274,414,688
6736,"บางบอนใต้","เขตบางบอน",105003,"เรือนจำพิเศษธนบุรี",13,174,317,334,651
6737,"บางบอนใต้","เขตบางบอน",105003,"โรงเรียนวัดบางบอน",14,244,323,395,718
6738,"บางบอนใต้","เขตบางบอน",105003,"โรงเรียนวัดบางบอน",15,232,316,352,668
6739,"บางบอนใต้","เขตบางบอน",105003,"โรงเรียนวัดบางบอน",16,275,356,398,754
6740,"บางบอนใต้","เขตบางบอน",105003,"โรงเรียนวัดบางบอน",17,265,349,393,742
6741,"บางบอนใต้","เขตบางบอน",105003,"โรงเรียนวัดบางบอน",18,205,341,335,676
6742,"บางบอนใต้","เขตบางบอน",105003,"โรงเรียนวัดบางบอน",19,210,300,344,644
6743,"บางบอนใต้","เขตบางบอน",105003,"โรงเรียนวัดบางบอน",20,221,304,361,665
6744,"บางบอนใต้","เขตบางบอน",105003,"โรงเรียนวัดบางบอน",21,189,292,335,627
6745,"บางบอนใต้","เขตบางบอน",105003,"โรงเรียนวัดบางบอน",22,215,283,342,625
6746,"บางบอนใต้","เขตบางบอน",105003,"โรงเรียนวัดบางบอน",23,198,326,373,699
6747,"บางบอนใต้","เขตบางบอน",105003,"โรงเรียนสถานีพรมแดน",24,154,264,283,547
6748,"บางบอนใต้","เขตบางบอน",105003,"โรงเรียนสถานีพรมแดน",25,180,295,308,603
6749,"บางบอนใต้","เขตบางบอน",105003,"โรงเรียนสถานีพรมแดน",26,202,281,306,587
6750,"คลองบางพราน","เขตบางบอน",105004,"เต็นท์บริเวณห้างแมคโคร สาขาบางบอน",1,321,302,372,674
6751,"คลองบางพราน","เขตบางบอน",105004,"เต็นท์บริเวณหน้าศาลเจ้าในหมู่บ้านวิเศษสุข ซอยเอกชัย 84",2,352,429,483,912
6752,"คลองบางพราน","เขตบางบอน",105004,"ตลาดหมู่บ้านเอสเค ซอยเอกชัย 76",3,240,316,331,647
6753,"คลองบางพราน","เขตบางบอน",105004,"ตลาดหมู่บ้านเอสเค ซอยเอกชัย 76",4,238,311,323,634
6754,"คลองบางพราน","เขตบางบอน",105004,"ตลาดหมู่บ้านเอสเค ซอยเอกชัย 76",5,293,365,366,731
6755,"คลองบางพราน","เขตบางบอน",105004,"ตลาดหมู่บ้านเอสเค ซอยเอกชัย 76",6,232,324,360,684
6756,"คลองบางพราน","เขตบางบอน",105004,"ศาลาอเนกประสงค์ตลาดสุขสวัสดี ปากซอยเอกชัย 66",7,265,281,330,611
6757,"คลองบางพราน","เขตบางบอน",105004,"ศาลาอเนกประสงค์ตลาดสุขสวัสดี ปากซอยเอกชัย 66",8,165,286,344,630
6758,"คลองบางพราน","เขตบางบอน",105004,"ศาลาอเนกประสงค์ตลาดสุขสวัสดี ปากซอยเอกชัย 66",9,229,298,352,650
6759,"คลองบางพราน","เขตบางบอน",105004,"ศาลาอเนกประสงค์ตลาดสุขสวัสดี ปากซอยเอกชัย 66",10,233,302,260,562
6760,"คลองบางพราน","เขตบางบอน",105004,"ศาลาอเนกประสงค์ตลาดสุขสวัสดี ปากซอยเอกชัย 66",11,214,257,302,559
6761,"คลองบางพราน","เขตบางบอน",105004,"เต็นท์บริเวณปากทางเข้าหมู่บ้านภาสกร ถนนบางบอน 1",12,200,267,322,589
6762,"คลองบางพราน","เขตบางบอน",105004,"เต็นท์บริเวณปากทางเข้าหมู่บ้านภาสกร ถนนบางบอน 1",13,250,306,347,653
6763,"คลองบางพราน","เขตบางบอน",105004,"เต็นท์บริเวณปากทางเข้าหมู่บ้านภาสกร ถนนบางบอน 1",14,223,280,352,632
6764,"คลองบางพราน","เขตบางบอน",105004,"เต็นท์บริเวณปากทางเข้าหมู่บ้านภาสกร ถนนบางบอน 1",15,263,318,367,685
6765,"คลองบางพราน","เขตบางบอน",105004,"เต็นท์บริเวณข้างหมู่บ้านตวงทอง 6 ซอยบางบอน 20",16,160,231,263,494
6766,"คลองบางพราน","เขตบางบอน",105004,"เต็นท์บริเวณข้างหมู่บ้านตวงทอง 6 ซอยบางบอน 20",17,132,243,261,504
6767,"คลองบางพราน","เขตบางบอน",105004,"เต็นท์บริเวณสำนักงานคณะกรรมการหมู่บ้านบางบอนวิลล่าซอยบางบอน 1 ซอย 16",18,187,278,285,563
6768,"คลองบางพราน","เขตบางบอน",105004,"เต็นท์บริเวณสำนักงานคณะกรรมการหมู่บ้านบางบอนวิลล่าซอยบางบอน 1 ซอย 16",19,170,268,283,551
6769,"คลองบางพราน","เขตบางบอน",105004,"เต็นท์บริเวณศาลาร่วมใจหมู่บ้านบางบอนวิลล่าซอยบางบอน 1 ซอย 16",20,196,244,289,533
6770,"คลองบางพราน","เขตบางบอน",105004,"เต็นท์บริเวณในซอยเอกชัย 64/2",21,407,439,510,949
6771,"คลองบางพราน","เขตบางบอน",105004,"โรงเรียนคงโครัดอุทิศ ซอยเอกชัย 50",22,176,227,322,549
6772,"คลองบางพราน","เขตบางบอน",105004,"โรงเรียนคงโครัดอุทิศ ซอยเอกชัย 50",23,213,257,313,570
6773,"คลองบางพราน","เขตบางบอน",105004,"โรงเรียนคงโครัดอุทิศ ซอยเอกชัย 50",24,182,258,289,547
6774,"คลองบางพราน","เขตบางบอน",105004,"เต็นท์บริเวณปั๊มน้ำมันเชลล์ ใกล้ซอยเอกชัย 46",25,296,386,466,852
6775,"คลองบางพราน","เขตบางบอน",105004,"เต็นท์บริเวณลานกีฬาหมู่บ้านสังสิทธิ์ ซอยเอกชัย 46",26,204,291,327,618
6776,"คลองบางพราน","เขตบางบอน",105004,"เต็นท์บริเวณลานกีฬาหมู่บ้านสังสิทธิ์ ซอยเอกชัย 46",27,199,301,347,648
6777,"คลองบางพราน","เขตบางบอน",105004,"เต็นท์บริเวณลานกีฬาหมู่บ้านสังสิทธิ์ ซอยเอกชัย 46",28,187,265,306,571
6778,"คลองบางพราน","เขตบางบอน",105004,"เต็นท์บริเวณลานกีฬาหมู่บ้านสังสิทธิ์ ซอยเอกชัย 46",29,190,247,327,574
6779,"คลองบางพราน","เขตบางบอน",105004,"เต็นท์บริเวณชุมชนหนทางใหม่ ตลาดปิ่นทอง ซอยเอกชัย 44",30,150,223,267,490
6780,"คลองบางพราน","เขตบางบอน",105004,"เต็นท์บริเวณชุมชนหนทางใหม่ ตลาดปิ่นทอง ซอยเอกชัย 44",31,167,217,302,519
6781,"คลองบางพราน","เขตบางบอน",105004,"เต็นท์บริเวณวิหารหลวงพ่อขาว ซอยเอกชัย 36/2",32,275,335,442,777
6782,"คลองบางพราน","เขตบางบอน",105004,"เต็นท์บริเวณวัดน้อยวิสุทธาราม ซอยกำนันแม้น 5",33,295,418,440,858
6783,"คลองบางพราน","เขตบางบอน",105004,"เต็นท์บริเวณสนามเด็กเล่นสมฤทัยคอนโด ซอยกำนันแม้น 7",34,203,261,297,558
6784,"คลองบางพราน","เขตบางบอน",105004,"เต็นท์บริเวณสนามเด็กเล่นสมฤทัยคอนโด ซอยกำนันแม้น 7",35,177,258,314,572
6785,"คลองบางพราน","เขตบางบอน",105004,"เต็นท์บริเวณลานจอดรถร้านสุริยาการช่าง ซอยกำนันแม้น 13 แยก 19",36,245,353,387,740
6786,"คลองบางพราน","เขตบางบอน",105004,"เต็นท์บริเวณลานกีฬาชุมชนซอยกำนันแม้น 13 ซอยกำนันแม้น 13 แยก 19",37,186,305,370,675
6787,"คลองบางพราน","เขตบางบอน",105004,"เต็นท์บริเวณลานกีฬาชุมชนซอยกำนันแม้น 13 ซอยกำนันแม้น 13 แยก 19",38,200,317,332,649
6788,"คลองบางพราน","เขตบางบอน",105004,"เต็นท์บริเวณลานกีฬาหมู่บ้านแม้นทอง ซอยกำนันแม้น 15",39,252,262,322,584
6789,"คลองบางพราน","เขตบางบอน",105004,"เต็นท์บริเวณลานกีฬาหมู่บ้านแม้นทอง ซอยกำนันแม้น 15",40,179,238,283,521
6790,"คลองบางบอน","เขตบางบอน",105005,"โรงเรียนดวงวิภา ซอยเอกชัย 43 แยก 2",1,151,243,296,539
6791,"คลองบางบอน","เขตบางบอน",105005,"โรงเรียนดวงวิภา ซอยเอกชัย 43 แยก 2",2,170,269,308,577
6792,"คลองบางบอน","เขตบางบอน",105005,"โรงเรียนดวงวิภา ซอยเอกชัย 43 แยก 2",3,171,272,335,607
6793,"คลองบางบอน","เขตบางบอน",105005,"เต็นท์บริเวณลานกีฬาศรีเทพพาร์ค ซอยเอกชัย 53",4,249,361,398,759
6794,"คลองบางบอน","เขตบางบอน",105005,"เต็นท์บริเวณลานกีฬาศรีเทพพาร์ค ซอยเอกชัย 53",5,264,356,386,742
6795,"คลองบางบอน","เขตบางบอน",105005,"เต็นท์บริเวณสนามเทนนิส นพรัตน์ สปอร์ตคลับ ซอยเอกชัย 83/1",6,272,340,403,743
6796,"คลองบางบอน","เขตบางบอน",105005,"เต็นท์บริเวณสนามเทนนิส นพรัตน์ สปอร์ตคลับ ซอยเอกชัย 83/1",7,228,348,376,724
6797,"คลองบางบอน","เขตบางบอน",105005,"เต็นท์บริเวณสนามเทนนิส นพรัตน์ สปอร์ตคลับ ซอยเอกชัย 83/1",8,257,361,406,767
6798,"คลองบางบอน","เขตบางบอน",105005,"เต็นท์บริเวณสนามเทนนิส นพรัตน์ สปอร์ตคลับ ซอยเอกชัย 83/1",9,236,332,387,719
6799,"คลองบางบอน","เขตบางบอน",105005,"โรงเรียนพระยามนธาตุราชศรีพิจิตร์",10,213,302,359,661
6800,"คลองบางบอน","เขตบางบอน",105005,"โรงเรียนพระยามนธาตุราชศรีพิจิตร์",11,237,321,358,679
6801,"คลองบางบอน","เขตบางบอน",105005,"โรงเรียนพระยามนธาตุราชศรีพิจิตร์",12,264,301,357,658
6802,"คลองบางบอน","เขตบางบอน",105005,"โรงเรียนพระยามนธาตุราชศรีพิจิตร์",13,288,344,356,700
6803,"คลองบางบอน","เขตบางบอน",105005,"โรงเรียนพระยามนธาตุราชศรีพิจิตร์",14,271,338,345,683
6804,"คลองบางบอน","เขตบางบอน",105005,"โรงเรียนพระยามนธาตุราชศรีพิจิตร์",15,261,302,351,653
6805,"คลองบางบอน","เขตบางบอน",105005,"โรงเรียนพระยามนธาตุราชศรีพิจิตร์",16,253,331,319,650
6806,"คลองบางบอน","เขตบางบอน",105005,"เต็นท์บริเวณศาลเจ้าพ่อปู่ ถนนบางขุนเทียน",17,150,209,235,444
6807,"คลองบางบอน","เขตบางบอน",105005,"เต็นท์บริเวณอาคารพาณิชย์ ปากซอยสุนทร 7ถนนเอกชัย (ข้างร้านอาหารองุ่น)",18,246,253,305,558
6808,"คลองบางบอน","เขตบางบอน",105005,"เต็นท์บริเวณอาคารพาณิชย์ ปากซอยสุนทร 7ถนนเอกชัย (ข้างร้านอาหารองุ่น)",19,164,241,288,529
6809,"คลองบางบอน","เขตบางบอน",105005,"เต็นท์บริเวณปั๊มน้ำมันซัสโก้ ข้างซอยเอกชัย 89/7",20,254,411,401,812
6810,"คลองบางบอน","เขตบางบอน",105005,"เต็นท์บริเวณปั๊มน้ำมันซัสโก้ ปากทางเข้าหมู่บ้านดี เค ถนนกาญจนาภิเษก",21,316,384,404,788
6811,"คลองบางบอน","เขตบางบอน",105005,"เต็นท์บริเวณลานกีฬาหมู่บ้านดี เค ซอยพระยามนธาตุฯแยก 35-13 (ซอยดี เค 6)",22,248,296,334,630
6812,"คลองบางบอน","เขตบางบอน",105005,"เต็นท์บริเวณลานกีฬาหมู่บ้านดี เค ซอยพระยามนธาตุฯแยก 35-13 (ซอยดี เค 6)",23,232,292,317,609
6813,"คลองบางบอน","เขตบางบอน",105005,"เต็นท์บริเวณลานกีฬาหมู่บ้านดี เค ซอยพระยามนธาตุฯแยก 35-13 (ซอยดี เค 6)",24,248,323,314,637
6814,"คลองบางบอน","เขตบางบอน",105005,"เต็นท์บริเวณลานกีฬาหมู่บ้านดี เค ซอยพระยามนธาตุฯแยก 35-13 (ซอยดี เค 6)",25,248,309,379,688
6815,"คลองบางบอน","เขตบางบอน",105005,"เต็นท์บริเวณลานกีฬาหมู่บ้านดี เค ซอยพระยามนธาตุฯแยก 35-13 (ซอยดี เค 6)",26,278,336,355,691
6816,"คลองบางบอน","เขตบางบอน",105005,"เต็นท์บริเวณลานกีฬาหมู่บ้านดี เค ซอยพระยามนธาตุฯแยก 35-13 (ซอยดี เค 6)",27,228,308,334,642
6817,"คลองบางบอน","เขตบางบอน",105005,"เต็นท์บริเวณลานกีฬาหมู่บ้านดี เค ซอยพระยามนธาตุฯแยก 35-13 (ซอยดี เค 6)",28,237,321,381,702
